region_id,Persons_85_years_and_over_Did_not_provide_child_care,Persons_85_years_and_over_Unpaid_child_care_not_stated,Persons_85_years_and_over_Total,Persons_Total_Cared_for_Own_child_children_only,Persons_Total_Cared_for_Other_child_children_only,Persons_Total_Cared_for_Own_child_children_and_other_child_children,Persons_Total_Cared_for_Total,Persons_Total_Did_not_provide_child_care,Persons_Total_Unpaid_child_care_not_stated,Persons_Total_Total
1100101,0,0,0,0,0,0,0,0,514,514
1100102,0,0,0,116,60,6,182,268,33,483
1100103,0,0,0,6,3,0,9,12,0,21
1100104,0,0,0,0,0,0,0,12,0,12
1100105,7,0,7,43,20,3,66,142,11,219
1100106,3,0,3,39,12,0,51,130,14,195
1100107,8,0,8,34,6,6,46,131,19,196
1100108,4,0,4,41,28,0,69,108,13,190
1100109,3,0,3,70,19,6,95,133,17,245
1100110,3,0,3,91,42,0,133,266,24,423
1100111,7,0,7,105,37,5,147,291,16,454
1100112,4,0,4,88,36,0,124,199,18,341
1100113,0,6,6,74,31,6,111,223,24,358
1100114,12,0,12,57,23,0,80,190,28,298
1100115,11,3,14,80,24,3,107,248,40,395
1100116,8,0,8,68,23,3,94,235,28,357
1100117,7,0,7,34,21,12,67,132,6,205
1100118,3,6,9,53,11,3,67,177,21,265
1100119,6,3,9,26,22,6,54,160,17,231
1100120,4,0,4,71,22,3,96,231,12,339
1100121,8,6,14,36,19,0,55,113,12,180
1100122,0,0,0,84,17,4,105,107,11,223
1100123,21,6,27,37,12,0,49,195,22,266
1100124,0,0,0,74,38,7,119,180,31,330
1100125,3,3,6,51,26,3,80,226,25,331
1100126,0,0,0,41,27,0,68,134,18,220
1100127,14,3,17,62,42,6,110,213,22,345
1100128,6,4,10,43,12,3,58,144,13,215
1100129,4,0,4,62,35,3,100,240,19,359
1100130,11,0,11,36,19,3,58,155,33,246
1100131,6,3,9,45,30,4,79,144,17,240
1100132,22,0,22,111,37,3,151,297,47,495
1100133,3,0,3,51,23,7,81,181,9,271
1100134,4,0,4,50,37,3,90,202,5,297
1100135,5,0,5,82,14,7,103,180,18,301
1100136,7,0,7,98,38,3,139,238,19,396
1100137,6,3,9,39,6,3,48,123,17,188
1100138,6,0,6,45,25,0,70,231,43,344
1100139,0,8,8,37,9,0,46,117,14,177
1100140,8,0,8,23,30,0,53,166,15,234
1100141,59,3,62,80,28,5,113,349,25,487
1100142,6,0,6,41,34,3,78,146,18,242
1100143,0,0,0,72,20,5,97,192,11,300
1100144,4,0,4,42,10,0,52,117,3,172
1100145,10,0,10,38,21,0,59,185,23,267
1100146,18,3,21,64,30,3,97,233,21,351
1100147,22,5,27,78,18,3,99,312,45,456
1100148,34,3,37,42,24,5,71,195,43,309
1100149,3,0,3,60,21,6,87,213,19,319
1100150,0,0,0,44,21,3,68,158,9,235
1100151,7,47,54,39,6,0,45,103,101,249
1100152,4,0,4,51,4,0,55,87,17,159
1100153,3,3,6,90,40,3,133,240,27,400
1100154,3,0,3,131,23,10,164,249,18,431
1100155,7,0,7,31,18,0,49,173,26,248
1100156,10,0,10,53,26,0,79,225,4,308
1100157,15,3,18,71,43,3,117,292,39,448
1100158,3,0,3,50,23,0,73,188,5,266
1100159,0,0,0,12,7,3,22,61,0,83
1100160,0,0,0,0,0,0,0,9,3,12
1100161,0,0,0,66,24,3,93,170,10,273
1100201,4,3,7,85,32,6,123,324,36,483
1100202,14,5,19,36,22,3,61,214,28,303
1100203,6,3,9,26,28,3,57,200,19,276
1100204,9,0,9,42,17,3,62,157,12,231
1100205,3,0,3,94,45,10,149,256,47,452
1100206,6,0,6,70,25,0,95,217,21,333
1100207,3,0,3,83,26,0,109,286,10,405
1100208,5,0,9,56,16,0,72,169,18,259
1100209,0,0,0,32,15,0,47,110,14,171
1100210,4,0,4,36,15,0,51,197,4,252
1100211,0,3,6,28,12,0,40,97,18,155
1100212,0,3,3,50,38,0,88,189,20,297
1100213,0,0,0,47,25,3,75,140,13,228
1100214,0,0,0,34,19,0,53,144,9,206
1100215,4,0,4,45,5,0,50,144,28,222
1100216,4,0,4,86,36,6,128,223,19,370
1100217,6,0,6,54,15,3,72,182,21,275
1100218,3,3,6,38,13,3,54,187,26,267
1100219,0,0,0,59,4,3,66,197,26,289
1100220,0,0,0,35,18,0,53,181,30,264
1100221,0,0,0,47,15,3,65,130,17,212
1100222,3,0,3,74,39,5,118,272,22,412
1100223,8,4,12,56,27,3,86,245,25,356
1100224,0,0,0,35,16,0,51,140,24,215
1100225,7,0,7,53,20,3,76,160,18,254
1100226,5,0,5,85,23,9,117,330,26,473
1100227,7,0,7,88,22,4,114,185,14,313
1100228,6,0,6,50,18,3,71,204,21,296
1100229,6,0,6,36,12,0,48,112,6,166
1100230,17,0,17,48,14,0,62,132,24,218
1100231,27,4,31,41,27,4,72,292,45,409
1100232,3,0,3,30,7,4,41,110,15,166
1100233,6,3,9,39,10,0,49,148,15,212
1100301,3,0,3,98,39,9,146,291,28,465
1100302,0,0,0,26,10,0,36,77,3,116
1100303,0,0,0,29,14,3,46,149,14,209
1100304,6,0,6,96,38,7,141,235,21,397
1100305,0,0,0,74,41,3,118,200,25,343
1100306,3,3,6,68,26,4,98,192,10,300
1100307,66,32,98,62,38,0,100,389,117,606
1100308,0,0,3,45,21,10,76,171,9,256
1100309,0,3,3,104,13,0,117,225,23,365
1100310,0,0,0,67,33,3,103,214,32,349
1100311,14,6,20,104,37,10,151,246,50,447
1100312,7,4,11,112,36,9,157,242,37,436
1100313,3,0,3,77,36,9,122,173,18,313
1100314,6,4,10,87,41,4,132,245,22,399
1100401,0,0,0,30,9,6,45,91,24,160
1100402,0,3,3,61,10,0,71,154,19,244
1100403,0,0,0,17,7,0,24,47,7,78
1100404,0,0,0,204,23,7,234,318,28,580
1100405,0,0,0,40,17,3,60,187,13,260
1100406,0,0,0,50,18,3,71,115,9,195
1100407,0,0,0,77,20,6,103,222,28,353
1100408,0,0,0,76,22,0,98,137,15,250
1100409,0,0,0,38,11,0,49,56,6,111
1100410,3,3,6,49,37,7,93,189,21,303
1100411,0,0,0,67,21,5,93,72,23,188
1100412,0,0,0,58,30,3,91,129,28,248
1100413,0,0,0,35,8,3,46,136,11,193
1100414,0,0,0,38,16,3,57,119,9,185
1100415,3,0,3,80,28,3,111,194,15,320
1100416,0,0,0,106,18,6,130,130,18,278
1100417,0,0,0,52,28,0,80,108,9,197
1100418,0,0,0,0,0,0,0,0,0,0
1100419,7,0,7,18,9,0,27,99,15,141
1100420,3,0,3,65,24,0,89,221,25,335
1100421,6,3,9,27,10,3,40,143,15,198
1100422,3,0,3,51,26,0,77,150,9,236
1100423,0,0,0,29,12,0,41,84,3,128
1100424,6,0,6,52,20,0,72,147,6,225
1100425,6,0,6,83,33,9,125,270,19,414
1100426,6,0,6,66,19,3,88,168,15,271
1100427,0,0,0,36,29,3,68,105,12,185
1100428,0,0,0,51,42,0,93,208,8,309
1100429,3,3,6,49,17,3,69,127,21,217
1100430,0,0,0,49,11,0,60,102,4,166
1100431,3,3,6,102,37,3,142,276,45,463
1100432,3,0,3,64,16,8,88,137,9,234
1100433,6,0,6,51,18,3,72,147,21,240
1100434,3,0,3,49,18,0,67,149,3,219
1100501,0,0,0,37,12,0,49,68,4,121
1100502,10,3,13,68,39,3,110,193,24,327
1100503,6,0,6,99,37,8,144,185,14,343
1100504,11,0,11,82,30,0,112,316,21,449
1100505,11,3,14,102,31,0,133,291,39,463
1100506,7,3,10,52,20,3,75,219,34,328
1100507,9,0,9,37,23,0,60,106,43,209
1100508,0,0,0,42,6,0,48,102,15,165
1100509,8,0,8,78,25,7,110,180,24,314
1100510,16,6,22,52,16,3,71,199,39,309
1100511,7,0,7,43,13,0,56,131,3,190
1100512,10,3,13,67,41,9,117,216,43,376
1100513,5,0,5,56,24,6,86,153,13,252
1100514,0,0,0,93,15,0,108,146,25,279
1100515,3,3,6,73,26,4,103,189,56,348
1100516,3,0,3,43,17,3,63,131,31,225
1100517,6,3,9,94,25,0,119,271,39,429
1100518,6,0,6,42,17,0,59,112,4,175
1100519,0,0,0,36,17,6,59,146,16,221
1100520,4,0,4,73,14,6,93,184,8,285
1100521,7,6,13,32,13,3,48,146,21,215
1100522,6,0,6,36,15,0,51,125,12,188
1100523,4,0,4,20,12,0,32,124,18,174
1100524,4,6,10,36,16,0,52,174,28,254
1100525,13,0,13,57,23,9,89,158,34,281
1100526,0,0,0,43,9,5,57,93,12,162
1100527,3,6,9,89,30,6,125,188,23,336
1100528,94,4,98,0,3,0,3,155,7,165
1100529,4,0,4,42,8,3,53,134,9,196
1100530,8,3,11,32,19,6,57,153,10,220
1100601,24,3,27,66,24,0,90,349,22,461
1100602,6,0,6,42,17,0,59,231,31,321
1100603,11,3,14,40,7,0,47,164,21,232
1100604,8,6,14,58,26,0,84,280,31,395
1100605,5,0,5,48,18,7,73,159,27,259
1100606,7,4,11,36,24,3,63,182,19,264
1100607,3,3,6,46,25,0,71,109,15,195
1100608,8,0,8,54,9,0,63,208,29,300
1100609,16,6,22,55,12,8,75,225,24,324
1100610,0,0,0,34,6,0,40,144,18,202
1100611,0,0,0,39,16,0,55,176,32,263
1100612,6,3,9,80,17,3,100,184,16,300
1100613,7,0,7,85,32,3,120,237,26,383
1100614,3,0,3,42,24,0,66,135,9,210
1100615,0,0,0,28,13,0,41,94,0,135
1100616,6,0,6,54,9,0,63,212,21,296
1100617,0,0,0,67,22,3,92,209,20,321
1100618,0,4,4,32,16,0,48,118,15,181
1100619,7,0,7,69,27,7,103,212,28,343
1100620,13,0,13,52,18,0,70,178,21,269
1100621,0,6,6,50,17,0,67,173,24,264
1100701,0,0,0,21,12,0,33,158,15,206
1100702,4,0,4,56,34,0,90,169,14,273
1100703,7,3,10,69,23,0,92,169,26,287
1100704,23,3,26,61,29,7,97,248,40,385
1100705,6,0,6,68,16,0,84,151,22,257
1100706,4,0,4,34,7,6,47,121,9,177
1100707,3,0,3,28,18,0,46,193,15,254
1100708,3,0,3,75,24,3,102,205,29,336
1100709,0,0,0,63,16,0,79,121,23,223
1100710,3,0,3,38,16,0,54,246,33,333
1100801,0,0,0,64,23,0,87,180,22,289
1100802,4,3,7,93,59,4,156,296,27,479
1100803,3,0,3,46,26,9,81,180,38,299
1100804,3,0,3,72,26,0,98,208,29,335
1100805,3,0,3,40,9,5,54,115,33,202
1100806,6,0,6,55,22,6,83,207,28,318
1100807,7,0,7,64,39,0,103,247,34,384
1100808,3,0,3,96,35,3,134,251,24,409
1100809,0,0,0,0,0,0,0,0,0,0
1100810,0,0,0,40,18,9,67,131,15,213
1100811,3,0,3,46,29,6,81,177,9,267
1100812,3,0,3,58,10,0,68,108,3,179
1100813,3,0,3,90,15,7,112,216,5,333
1100814,6,0,6,87,32,3,122,260,21,403
1100815,6,0,6,75,30,6,111,265,34,410
1100816,5,0,5,59,22,3,84,232,48,364
1100817,6,0,6,52,21,8,81,178,9,268
1100818,3,0,3,57,19,3,79,153,24,256
1100819,0,0,0,97,19,0,116,233,23,372
1100820,0,0,0,55,19,3,77,140,10,227
1100821,3,0,3,83,29,0,112,243,31,386
1100822,0,3,3,29,17,3,49,130,24,203
1100823,0,0,0,49,18,0,67,100,15,182
1100901,8,0,8,35,19,0,54,129,9,192
1100902,0,0,0,58,29,0,87,184,18,289
1100903,10,0,10,136,60,4,200,349,37,586
1100904,0,0,0,40,44,3,87,191,38,316
1100905,7,4,11,57,32,0,89,233,17,339
1100906,0,0,0,86,39,12,137,406,54,597
1100907,7,0,7,59,14,0,73,235,40,348
1100908,5,3,8,70,31,0,101,284,63,448
1100909,0,0,0,53,26,0,79,329,63,471
1100910,3,3,6,62,21,3,86,253,27,366
1100911,12,3,15,59,24,0,83,222,36,341
1100912,3,0,3,45,17,0,62,161,20,243
1100913,7,5,12,116,48,3,167,324,32,523
1100914,13,0,13,66,23,3,92,241,22,355
1100915,5,3,8,102,39,7,148,408,64,620
1100916,0,0,0,83,26,0,109,237,27,373
1100917,9,0,9,18,6,4,28,175,26,229
1100918,42,11,53,77,41,0,118,302,38,458
1100919,13,0,13,72,28,0,100,227,36,363
1100920,5,35,40,31,8,0,39,198,116,353
1100921,0,4,4,36,18,0,54,230,26,310
1100922,47,6,53,97,21,0,118,397,37,552
1101001,3,6,9,19,6,0,25,61,17,103
1101002,0,0,0,55,26,9,90,207,13,310
1101003,3,3,6,46,23,0,69,190,28,287
1101004,0,0,0,54,15,3,72,146,13,231
1101005,4,6,10,122,36,6,164,386,32,582
1101006,0,3,3,48,19,3,70,296,46,412
1101007,0,0,0,30,12,0,42,172,17,231
1101008,0,0,0,59,41,6,106,254,26,386
1101009,4,0,7,46,23,3,72,222,28,322
1101010,6,0,6,54,13,6,73,194,15,282
1101011,0,0,0,6,0,0,6,20,6,32
1101012,0,0,0,20,6,0,26,49,3,78
1101013,0,0,0,0,0,0,0,0,0,0
1101014,6,0,6,18,12,6,36,100,9,145
1101015,0,0,0,68,30,0,98,350,57,505
1101101,9,3,12,66,16,3,85,187,24,296
1101102,0,0,0,48,13,6,67,101,13,181
1101103,0,0,0,49,20,0,69,117,11,197
1101104,3,0,3,73,24,3,100,220,35,355
1101105,3,0,3,85,31,0,116,243,53,412
1101106,0,0,3,54,19,0,73,210,17,300
1101107,0,0,0,67,22,0,89,153,35,277
1101108,3,0,3,77,24,4,105,209,33,347
1101109,0,0,0,48,34,6,88,145,10,243
1101110,0,0,0,53,28,6,87,173,12,272
1101111,0,0,0,65,22,0,87,214,28,329
1101112,0,0,0,18,13,3,34,102,9,145
1101113,0,0,0,21,3,0,24,58,6,88
1101114,3,0,3,65,16,0,81,145,18,244
1101115,0,0,0,58,15,6,79,102,13,194
1101116,3,0,3,48,20,4,72,135,41,248
1101117,0,0,0,45,16,0,61,152,12,225
1101118,3,0,3,49,14,6,69,202,13,284
1101119,0,0,0,43,16,0,59,158,27,244
1101120,0,0,0,103,48,0,151,254,10,415
1101121,0,0,0,68,15,3,86,151,6,243
1101122,3,0,3,36,26,0,62,172,9,243
1101123,0,0,0,55,12,3,70,82,12,164
1101124,3,0,3,209,36,10,255,322,30,607
1101125,0,0,0,95,27,4,126,240,16,382
1101126,4,0,4,86,37,0,123,236,18,377
1101127,0,0,0,65,21,4,90,144,25,259
1101128,3,0,3,35,13,0,48,144,24,216
1101129,0,0,0,74,21,0,95,165,16,276
1101130,0,0,0,98,29,4,131,285,37,453
1101131,0,0,0,42,12,3,57,118,6,181
1101132,0,0,0,61,15,5,81,139,6,226
1101133,3,0,3,44,29,3,76,181,6,263
1101134,0,0,0,48,27,6,81,159,7,247
1101135,0,0,0,42,21,4,67,129,15,211
1101136,0,0,0,62,19,3,84,148,11,243
1101137,3,0,3,49,20,0,69,179,6,254
1101138,3,0,3,136,22,4,162,194,12,368
1101139,0,0,0,45,8,0,53,109,9,171
1101140,3,0,3,55,35,8,98,207,7,312
1101201,3,0,3,37,10,0,47,101,15,163
1101202,0,0,0,59,4,0,63,108,3,174
1101203,0,0,0,145,31,6,182,192,22,396
1101204,0,0,0,94,7,6,107,101,18,226
1101205,0,0,3,81,21,4,106,116,8,230
1101206,0,0,0,91,18,4,113,138,6,257
1101207,0,0,0,33,16,3,52,135,9,196
1101208,3,0,3,81,35,3,119,250,12,381
1101209,3,0,3,172,30,12,214,268,30,512
1101210,3,0,3,97,28,3,128,236,15,379
1101211,0,0,0,167,16,7,190,205,4,399
1101212,0,0,0,101,12,8,121,102,6,229
1101213,0,0,0,123,25,7,155,213,9,377
1101214,3,0,3,126,28,9,163,222,14,399
1101215,3,0,3,107,24,3,134,198,9,341
1101216,0,0,0,88,21,0,109,127,12,248
1101217,0,0,0,0,0,0,0,15,6,21
1101218,3,0,3,96,36,0,132,250,9,391
1101219,11,0,11,87,35,0,122,336,43,501
1101220,0,0,0,71,40,3,114,238,19,371
1101221,0,0,0,69,10,0,79,134,0,213
1101222,6,0,6,104,24,3,131,242,11,384
1101223,3,0,3,109,33,4,146,267,22,435
1101224,0,0,0,122,23,4,149,278,19,446
1101225,0,0,0,0,0,0,0,0,0,0
1101226,0,0,0,0,0,0,0,0,0,0
1101227,0,0,0,109,7,6,122,180,3,305
1101228,3,0,3,72,22,6,100,210,18,328
1101229,0,0,0,79,31,0,110,195,20,325
1101230,0,0,0,38,23,3,64,108,12,184
1101231,0,0,0,65,23,0,88,151,0,239
1101232,3,0,3,106,22,5,133,214,6,353
1101301,9,0,9,39,17,0,56,155,18,229
1101302,22,11,33,64,26,0,90,254,47,391
1101303,8,0,8,45,15,3,63,134,15,212
1101304,14,0,14,75,25,0,100,267,11,378
1101305,0,0,0,25,14,0,39,126,6,171
1101306,0,0,0,26,4,4,34,115,9,158
1101307,9,6,15,43,17,3,63,150,22,235
1101308,4,3,7,45,16,0,61,129,9,199
1101401,30,0,30,55,9,3,67,184,13,264
1101402,6,0,6,50,19,8,77,188,19,284
1101403,14,3,17,52,18,9,79,229,24,332
1101404,12,4,16,57,30,0,87,253,34,374
1101405,14,4,18,53,24,6,83,253,28,364
1101406,10,3,16,79,29,0,108,271,21,400
1101407,0,0,0,58,25,3,86,238,14,338
1101408,0,0,0,41,9,0,50,109,7,166
1101409,43,0,43,47,23,0,70,275,21,366
1101410,9,0,9,59,20,3,82,236,28,346
1101411,9,0,9,59,18,6,83,184,144,411
1101412,5,3,8,89,20,0,109,260,18,387
1101413,6,0,9,54,16,3,73,188,26,287
1101414,0,0,0,45,0,0,45,94,11,150
1101415,8,0,8,74,20,3,97,138,19,254
1101416,8,0,8,64,32,7,103,263,8,374
1101417,0,0,0,0,0,0,0,9,0,9
1101418,0,0,0,60,22,4,86,198,15,299
1101501,0,0,0,0,0,0,0,0,0,0
1101502,0,0,0,3,0,0,3,12,0,15
1101503,6,0,6,36,3,3,42,128,6,176
1101504,3,0,3,28,6,3,37,108,15,160
1101505,0,0,0,20,0,0,20,64,0,84
1101506,0,0,0,61,16,8,85,183,18,286
1101507,4,0,4,38,6,3,47,136,3,186
1101508,3,0,3,51,25,0,76,201,28,305
1101509,0,0,0,79,34,3,116,264,18,398
1101510,8,0,8,58,17,3,78,205,25,308
1101511,3,0,3,28,6,0,34,154,9,197
1101512,0,0,0,34,15,0,49,108,15,172
1101513,7,0,7,57,18,0,75,214,17,306
1101601,0,0,0,16,3,0,19,84,15,118
1101602,15,0,15,84,15,4,103,216,23,342
1101603,0,0,0,49,28,3,80,145,8,233
1101604,0,0,0,19,14,0,33,110,10,153
1101605,3,0,3,32,6,0,38,119,20,177
1101606,6,0,6,75,18,0,93,200,14,307
1101607,6,0,6,32,10,3,45,130,19,194
1101608,0,0,0,54,13,3,70,128,9,207
1101609,0,0,0,32,15,3,50,104,62,216
1101610,0,0,3,138,36,16,190,271,37,498
1101611,0,3,3,40,18,0,58,136,185,379
1101612,0,0,0,15,3,0,18,86,17,121
1101613,0,0,0,54,11,6,71,95,0,166
1101614,0,0,0,40,7,7,54,159,24,237
1101615,0,0,0,66,18,12,96,158,27,281
1101616,6,0,6,63,19,7,89,232,54,375
1101617,0,0,0,43,7,0,50,197,86,333
1101618,6,7,13,101,19,0,120,191,114,425
1101619,5,0,8,70,24,3,97,242,27,366
1101620,0,0,0,26,6,0,32,108,44,184
1101701,40,4,44,48,40,0,88,367,43,498
1101702,3,3,6,46,11,0,57,109,18,184
1101703,34,6,40,55,24,6,85,228,39,352
1101704,13,0,13,34,24,0,58,219,36,313
1101705,0,3,3,17,21,0,38,128,34,200
1101706,32,10,42,37,30,0,67,262,51,380
1101707,0,0,0,0,0,0,0,3,0,3
1101708,3,0,3,53,34,0,87,205,33,325
1101709,6,0,6,103,23,0,126,308,36,470
1101710,0,0,0,54,18,0,72,195,51,318
1101711,4,0,4,43,7,3,53,161,21,235
1101712,0,0,0,69,29,7,105,270,21,396
1101713,7,3,10,55,22,0,77,222,36,335
1101714,0,0,0,0,0,0,0,0,0,0
1101715,0,0,0,0,0,0,0,0,0,0
1101716,3,3,6,75,24,5,104,218,41,363
1101717,10,0,10,27,20,0,47,160,20,227
1101718,7,3,10,40,18,0,58,235,47,340
1101719,7,0,7,60,17,0,77,190,24,291
1101720,4,0,4,34,13,0,47,148,15,210
1101721,0,0,0,66,19,3,88,191,27,306
1101722,8,0,8,55,29,0,84,313,34,431
1101801,4,0,4,40,21,0,61,193,18,272
1101802,6,3,9,36,17,0,53,189,15,257
1101803,0,0,0,68,19,0,87,184,13,284
1101804,9,0,9,22,19,0,41,122,4,167
1101805,0,0,0,45,10,0,55,131,6,192
1101806,6,0,6,49,21,3,73,282,35,390
1101807,16,7,23,48,27,0,75,245,100,420
1101808,16,8,24,78,45,0,123,274,112,509
1101809,50,6,56,10,11,4,25,187,16,228
1101810,3,3,6,35,18,3,56,159,24,239
1101811,6,3,9,44,20,3,67,171,24,262
1101812,5,0,5,51,28,3,82,249,24,355
1101813,3,0,3,23,18,0,41,162,4,207
1101814,8,0,8,38,3,0,41,161,18,220
1101815,6,3,9,22,18,3,43,176,19,238
1101816,7,3,10,46,22,3,71,206,24,301
1101817,8,0,8,80,14,4,98,302,35,435
1101818,8,3,11,57,12,6,75,281,33,389
1101819,7,0,7,47,9,0,56,202,24,282
1101820,0,0,3,30,18,3,51,138,38,227
1101821,4,0,7,33,9,3,45,125,13,183
1101822,65,4,69,44,15,3,62,284,41,387
1101823,18,3,21,46,13,3,62,258,59,379
1101824,0,0,0,0,0,0,0,0,0,0
1101901,20,25,45,58,21,3,82,242,60,384
1101902,32,5,37,63,20,9,92,230,40,362
1101903,0,0,0,28,10,0,38,181,24,243
1101904,6,3,9,79,28,6,113,226,41,380
1101905,7,0,7,54,26,6,86,196,46,328
1101906,9,0,9,66,20,0,86,196,41,323
1101907,3,0,3,50,15,3,68,184,32,284
1101908,0,3,3,55,29,5,89,144,17,250
1101909,10,3,13,43,17,0,60,185,16,261
1101910,5,0,5,23,9,0,32,86,3,121
1101911,9,0,9,70,31,0,101,223,43,367
1101912,6,3,9,53,19,4,76,223,26,325
1101913,7,6,13,60,25,4,89,263,24,376
1101914,0,0,0,103,38,3,144,343,36,523
1101915,3,0,3,35,12,3,50,100,4,154
1101916,7,0,7,84,38,7,129,239,19,387
1101917,6,0,6,108,41,12,161,298,14,473
1101918,0,0,0,30,19,3,52,149,8,209
1101919,3,0,3,38,10,0,48,114,9,171
1101920,4,0,4,45,16,9,70,147,10,227
1101921,6,0,6,27,16,0,43,85,9,137
1101922,13,3,16,31,16,0,47,171,13,231
1102001,0,0,0,56,6,4,66,187,8,261
1102002,4,0,4,73,27,9,109,293,17,419
1102003,0,0,0,72,21,6,99,153,32,284
1102004,0,0,0,42,18,3,63,180,32,275
1102005,0,0,0,16,23,0,39,182,9,230
1102006,0,3,3,53,8,0,61,197,47,305
1102007,4,0,4,62,27,7,96,126,21,243
1102008,0,0,0,69,28,0,97,198,3,298
1102009,0,0,0,0,0,0,0,0,0,0
1102010,0,0,0,0,3,0,3,0,0,3
1102011,3,0,3,53,18,9,80,152,28,260
1102012,0,0,0,0,0,0,0,0,0,0
1102013,0,0,0,17,9,0,26,104,12,142
1102014,0,0,0,37,11,0,48,109,4,161
1102015,6,0,6,19,6,3,28,99,12,139
1102016,0,0,0,37,14,0,51,180,24,255
1102017,0,0,0,48,23,0,71,124,6,201
1102018,3,0,3,63,15,3,81,241,13,335
1102019,6,0,6,57,23,9,89,201,21,311
1102020,3,0,3,76,14,4,94,299,31,424
1102021,0,0,0,0,0,0,0,0,0,0
1102022,7,0,7,49,10,0,59,158,24,241
1102023,0,0,0,46,17,0,63,147,9,219
1102024,4,0,4,38,19,0,57,143,23,223
1102025,3,0,3,74,35,9,118,183,14,315
1102026,3,0,3,30,12,3,45,91,3,139
1102027,3,3,6,34,9,4,47,114,18,179
1102028,0,0,0,76,24,3,103,184,16,303
1102029,0,0,0,41,8,0,49,141,34,224
1102030,11,0,11,59,24,10,93,195,28,316
1102031,0,0,0,26,12,4,42,86,6,134
1102032,0,4,4,27,6,3,36,145,52,233
1102101,5,7,12,44,21,11,76,184,29,289
1102102,0,0,0,25,9,0,34,105,30,169
1102103,6,0,6,93,31,9,133,185,15,333
1102104,44,6,53,57,22,0,79,262,27,368
1102105,6,0,6,44,16,0,60,181,11,252
1102106,12,5,17,56,20,7,83,362,63,508
1102107,9,0,9,69,29,12,110,292,27,429
1102201,0,0,0,9,0,0,9,35,0,44
1102301,7,0,7,38,26,0,64,233,26,323
1102302,0,0,0,52,27,4,83,244,13,340
1102303,0,0,0,48,13,0,61,144,12,217
1102304,0,0,0,14,10,6,30,100,12,142
1102305,17,3,20,70,31,0,101,269,27,397
1102306,35,3,38,31,15,9,55,195,18,268
1102307,3,0,3,36,16,0,52,171,23,246
1102308,4,0,4,75,28,4,107,266,50,423
1102309,4,3,7,34,21,4,59,208,18,285
1102310,0,0,0,0,0,0,0,0,7,7
1102401,0,0,0,44,9,0,53,131,36,220
1102402,3,0,3,41,14,6,61,164,33,258
1102403,0,0,0,35,19,8,62,131,19,212
1102404,3,0,3,60,33,0,93,183,15,291
1102405,6,3,9,30,21,0,51,137,6,194
1102406,0,0,0,37,19,0,56,130,10,196
1102407,3,0,3,32,4,0,36,150,13,199
1102408,5,0,5,37,21,0,58,158,22,238
1102409,3,0,3,42,21,0,63,145,17,225
1102410,6,0,6,30,11,3,44,126,12,182
1102411,3,3,6,43,13,0,56,138,17,211
1102412,4,0,4,44,12,0,56,148,21,225
1102501,0,0,0,0,0,0,0,0,0,0
1102502,3,0,3,32,24,0,56,169,14,239
1102503,42,29,71,8,0,3,11,199,52,262
1102504,4,0,4,39,11,0,50,179,30,259
1102505,10,6,16,18,11,0,29,136,39,204
1102506,8,0,8,46,9,0,55,195,12,262
1102507,5,0,5,29,19,0,48,150,15,213
1102508,19,6,25,50,30,0,80,375,27,482
1102509,0,0,0,20,15,4,39,48,9,96
1102510,0,0,0,41,19,3,63,172,0,235
1102511,6,3,9,44,21,0,65,264,19,348
1102512,15,6,21,51,27,0,78,350,27,455
1102513,3,0,3,77,18,3,98,200,30,328
1102514,9,0,9,38,12,0,50,109,9,168
1102515,37,3,40,56,27,0,83,216,31,330
1102516,3,7,10,46,11,0,57,136,18,211
1102517,9,0,9,56,27,4,87,156,12,255
1102518,0,0,3,57,16,6,79,219,15,313
1102519,33,14,47,35,9,0,44,178,19,241
1102520,7,4,11,59,34,7,100,331,35,466
1102521,6,0,6,25,9,6,40,151,22,213
1102522,12,0,12,53,19,0,72,209,9,290
1102523,3,0,3,27,8,3,38,86,3,127
1102524,3,0,3,58,22,0,80,129,6,215
1102525,0,0,0,38,21,0,59,262,27,348
1102526,3,3,6,54,24,0,78,189,3,270
1102527,0,5,5,59,27,0,86,234,53,373
1102528,11,3,14,82,35,0,117,349,44,510
1102529,7,3,10,42,33,3,78,198,20,296
1102530,6,3,9,36,14,3,53,226,36,315
1102601,0,4,4,56,30,3,89,291,22,402
1102602,8,0,8,47,39,3,89,349,21,459
1102603,9,0,9,42,20,4,66,210,14,290
1102604,11,0,11,42,21,0,63,198,37,298
1102605,12,0,12,49,28,0,77,328,27,432
1102606,6,0,6,34,21,0,55,164,15,234
1102607,11,3,14,51,22,12,85,249,24,358
1102608,37,4,41,39,23,0,62,215,20,297
1102609,10,0,10,47,31,6,84,224,26,334
1102610,0,0,0,37,17,0,54,124,12,190
1102611,4,0,4,38,9,3,50,148,9,207
1102612,0,0,0,31,14,0,45,120,11,176
1102613,0,0,0,29,12,3,44,146,3,193
1102614,5,0,5,75,42,0,117,298,39,454
1102615,4,0,4,58,19,7,84,215,6,305
1102616,3,0,3,22,9,3,34,115,6,155
1102617,0,0,0,32,7,6,45,128,6,179
1102618,3,0,6,42,30,0,72,158,9,239
1102619,0,0,0,67,20,0,87,170,10,267
1102620,4,0,4,31,7,0,38,164,18,220
1102621,10,0,10,44,20,7,71,148,25,244
1102622,3,0,3,40,27,3,70,127,0,197
1102623,10,0,10,40,12,0,52,161,22,235
1102701,15,0,15,16,13,3,32,160,10,202
1102702,12,0,12,34,22,0,56,199,38,293
1102703,0,0,0,14,12,0,26,113,12,151
1102704,4,3,7,23,9,3,35,160,31,226
1102705,7,7,14,45,27,0,72,258,46,376
1102706,37,39,76,46,26,3,75,316,94,485
1102707,18,6,24,60,22,3,85,295,52,432
1102708,68,4,72,23,18,0,41,239,20,300
1102709,8,3,11,86,35,0,121,298,36,455
1102710,0,0,0,20,6,3,29,132,12,173
1102711,0,0,0,0,0,0,0,0,0,0
1102712,3,0,3,48,28,0,76,241,23,340
1102713,6,0,6,69,20,0,89,234,30,353
1102714,0,0,0,0,0,0,0,0,0,0
1102715,0,0,0,0,4,0,4,18,0,22
1102716,0,0,0,0,0,0,0,0,0,0
1102717,3,3,6,26,13,3,42,148,18,208
1102718,13,3,16,39,10,0,49,203,27,279
1102719,7,3,10,52,19,3,74,221,22,317
1102720,6,0,6,39,20,0,59,166,6,231
1102721,9,3,12,45,34,6,85,342,35,462
1102722,0,0,0,29,3,0,32,55,0,87
1102723,3,0,6,15,16,6,37,157,21,215
1102724,8,4,12,41,13,9,63,235,26,324
1102725,14,3,17,26,21,6,53,222,27,302
1102726,0,0,0,17,14,0,31,145,6,182
1102727,8,0,8,38,24,0,62,235,39,336
1102728,9,6,15,28,11,4,43,165,23,231
1102729,13,4,17,63,32,6,101,315,40,456
1102801,0,0,0,0,0,0,0,0,0,0
1102802,7,8,15,106,29,4,139,271,40,450
1102803,7,0,7,83,52,8,143,251,50,444
1102804,3,0,3,46,23,0,69,106,4,179
1102805,3,0,3,52,20,6,78,158,15,251
1102806,3,0,3,81,33,9,123,247,38,408
1102807,8,3,11,68,37,8,113,164,27,304
1102808,0,0,0,92,17,3,112,173,5,290
1102809,0,4,4,105,39,4,148,303,17,468
1102810,3,0,7,98,43,5,146,182,33,361
1102811,0,0,0,100,29,0,129,182,12,323
1102812,3,3,6,74,31,6,111,168,16,295
1102813,3,3,6,63,33,3,99,159,42,300
1102814,0,0,0,72,26,3,101,207,18,326
1102815,7,0,7,72,25,0,97,139,6,242
1102816,0,0,0,60,13,0,73,133,15,221
1102817,3,4,7,74,23,0,97,156,36,289
1102818,6,0,6,86,31,12,129,155,14,298
1102901,8,0,8,49,9,10,68,150,17,235
1102902,0,0,0,46,32,3,81,124,15,220
1102903,8,4,12,61,26,3,90,212,22,324
1102904,3,3,6,102,35,3,140,210,16,366
1102905,3,0,3,72,25,3,100,187,20,307
1102906,7,0,7,28,18,3,49,94,18,161
1102907,13,0,13,33,17,0,50,186,11,247
1102908,15,0,15,44,40,3,87,236,15,338
1102909,17,3,20,34,24,3,61,235,26,322
1102910,0,0,0,95,25,4,124,235,28,387
1102911,14,3,17,56,43,0,99,260,25,384
1102912,6,0,6,61,56,4,121,241,33,395
1102913,0,0,0,60,26,4,90,127,37,254
1102914,0,0,0,33,15,7,55,194,17,266
1102915,6,0,6,92,33,9,134,232,30,396
1102916,6,0,6,60,28,0,88,185,15,288
1102917,8,0,8,42,11,3,56,125,17,198
1102918,3,3,6,71,29,3,103,186,33,322
1102919,30,13,43,27,29,0,56,179,35,270
1102920,0,0,0,0,6,0,6,4,0,10
1102921,0,0,0,0,0,0,0,0,0,0
1102922,3,0,3,122,37,8,167,164,9,340
1102923,3,0,3,86,11,0,97,179,14,290
1102924,0,0,0,125,22,6,153,190,21,364
1102925,3,3,6,82,40,8,130,222,43,395
1102926,7,0,7,22,28,3,53,198,26,277
1102927,6,0,6,73,47,6,126,286,28,440
1102928,12,8,20,42,52,9,103,476,52,631
1103001,6,4,10,70,33,6,109,202,19,330
1103002,4,0,4,89,42,3,134,286,29,449
1103003,3,0,3,40,0,0,40,110,15,165
1103004,6,0,6,69,21,6,96,128,24,248
1103005,3,3,6,48,14,0,62,134,31,227
1103006,7,0,7,53,14,6,73,184,21,278
1103007,0,0,0,58,33,0,91,185,27,303
1103008,7,0,7,38,15,0,53,90,19,162
1103009,3,6,9,65,30,0,95,184,24,303
1103010,0,0,0,58,11,0,69,213,21,303
1103011,5,0,5,59,19,7,85,276,64,425
1103012,3,0,3,63,28,3,94,225,25,344
1103101,0,0,0,59,19,4,82,166,10,258
1103102,21,67,88,11,18,0,29,155,114,298
1103103,48,12,60,0,21,0,21,279,28,328
1103104,15,4,22,58,27,3,88,228,37,353
1103105,0,0,0,81,33,5,119,287,22,428
1103106,3,3,6,47,13,3,63,105,15,183
1103107,0,0,0,4,0,0,4,10,0,14
1103108,0,0,0,44,9,9,62,111,10,183
1103109,0,0,0,53,24,0,77,109,6,192
1103110,5,3,8,72,32,9,113,217,21,351
1103111,3,3,6,52,34,10,96,141,17,254
1103112,0,0,0,33,14,0,47,74,10,131
1103113,5,3,8,94,30,7,131,216,21,368
1103114,0,0,0,87,45,4,136,204,21,361
1103115,5,0,5,73,39,4,116,276,21,413
1103116,7,0,7,60,45,3,108,272,27,407
1103117,3,0,3,49,31,3,83,183,20,286
1103118,4,0,4,49,27,4,80,173,22,275
1103119,7,0,7,71,28,9,108,199,12,319
1103120,6,0,6,56,38,3,97,212,18,327
1103121,4,0,4,43,22,3,68,130,12,210
1103122,6,3,9,62,27,3,92,212,15,319
1103123,6,0,6,63,14,0,77,223,27,327
1103124,6,3,9,60,24,3,87,173,15,275
1103125,6,0,9,37,16,3,56,132,15,203
1103126,11,4,15,7,15,0,22,286,53,361
1103127,3,0,3,50,24,3,77,167,15,259
1103128,97,41,138,28,11,5,44,233,84,361
1103129,4,0,4,87,30,15,132,299,24,455
1103130,7,0,7,53,21,0,74,154,3,231
1103131,149,43,195,0,33,0,33,480,85,598
1103132,0,0,0,3,0,0,3,9,0,12
1103133,3,0,3,50,32,6,88,206,16,310
1103134,10,3,13,64,23,3,90,241,27,358
1103135,6,0,6,50,26,0,76,241,28,345
1103136,0,0,0,69,37,9,115,173,15,303
1103137,109,12,121,3,0,0,3,232,30,265
1103138,6,0,6,76,39,3,118,264,33,415
1103201,7,0,7,59,29,7,95,193,16,304
1103202,6,0,6,70,29,9,108,217,40,365
1103203,0,0,0,191,28,7,226,270,30,526
1103204,7,0,7,69,28,7,104,245,48,397
1103205,0,0,0,27,24,3,54,132,27,213
1103206,0,0,0,4,6,0,10,14,21,45
1103207,3,3,6,18,14,0,32,151,27,210
1103208,0,0,0,69,34,3,106,260,21,387
1103209,0,0,0,173,59,8,240,305,21,566
1103210,0,0,0,30,9,3,42,90,21,153
1103211,0,3,3,100,40,4,144,248,22,414
1103212,3,3,6,86,36,9,131,208,44,383
1103213,0,0,0,4,0,0,4,0,0,4
1103214,0,0,0,126,46,8,180,296,21,497
1103215,3,3,6,41,9,3,53,75,15,143
1103216,4,0,4,49,24,0,73,155,22,250
1103217,0,0,0,34,9,3,46,79,30,155
1103218,6,0,6,93,27,9,129,285,45,459
1103219,0,0,0,52,24,3,79,202,12,293
1103220,6,0,6,20,28,0,48,248,24,320
1103221,6,0,6,30,12,0,42,191,41,274
1103222,6,0,6,78,31,9,118,401,51,570
1103223,0,0,0,0,0,0,0,0,0,0
1103224,8,0,8,44,27,0,71,333,33,437
1103225,3,0,3,44,22,0,66,108,15,189
1103226,0,4,4,21,13,0,34,149,44,227
1103227,6,0,6,67,29,9,105,278,60,443
1103228,29,4,33,77,35,0,112,398,79,589
1103229,14,0,14,48,23,3,74,173,23,270
1103230,25,3,28,48,30,0,78,287,48,413
1103231,7,3,10,60,45,0,105,260,27,392
1103232,10,3,13,66,24,8,98,208,61,367
1103233,3,0,3,65,18,6,89,130,15,234
1103234,7,0,7,132,31,14,177,361,21,559
1103235,13,7,20,32,24,3,59,203,29,291
1103236,10,8,18,51,19,0,70,267,112,449
1103237,3,3,6,32,15,0,47,208,48,303
1103238,6,0,6,50,20,0,70,193,6,269
1103239,16,8,24,72,46,3,121,366,56,543
1103240,47,3,50,24,23,0,47,248,26,321
1103241,9,0,9,43,25,0,68,238,49,355
1103242,21,21,46,66,28,3,97,304,84,485
1103243,19,3,22,73,38,0,111,293,39,443
1103244,127,42,169,74,32,4,110,405,105,620
1103301,3,3,6,55,10,3,68,98,3,169
1103302,3,3,6,100,28,7,135,219,21,375
1103303,0,0,0,90,26,3,119,150,6,275
1103304,0,0,0,74,17,0,91,168,21,280
1103305,3,0,3,59,19,5,83,150,12,245
1103306,0,0,0,58,12,4,74,132,6,212
1103307,3,0,3,46,7,3,56,86,3,145
1103308,4,0,4,106,27,3,136,168,18,322
1103309,0,0,0,0,0,0,0,74,0,74
1103310,0,0,0,69,19,3,91,138,27,256
1103311,0,0,0,75,19,9,103,169,30,302
1103312,0,0,0,70,33,0,103,134,12,249
1103313,0,3,3,65,20,3,88,133,9,230
1103314,3,0,3,61,21,4,86,158,15,259
1103315,6,0,6,155,43,3,201,357,39,597
1103316,0,0,0,0,0,0,0,0,0,0
1103317,7,0,7,111,21,9,141,213,20,374
1103318,3,0,3,42,8,0,50,104,12,166
1103319,3,3,6,75,18,7,100,168,24,292
1103320,0,0,0,0,0,0,0,4,0,4
1103401,4,0,4,82,41,9,132,166,5,303
1103402,6,3,9,57,25,3,85,185,24,294
1103403,10,0,10,101,26,7,134,287,37,458
1103404,0,0,0,53,18,6,77,136,18,231
1103405,0,0,0,91,17,0,108,167,21,296
1103406,3,0,3,28,4,0,32,89,7,128
1103407,6,0,6,46,12,0,58,141,18,217
1103408,7,0,7,45,22,4,71,189,14,274
1103409,0,3,3,56,12,4,72,158,11,241
1103410,0,3,3,71,7,6,84,214,15,313
1103411,3,0,3,81,29,6,116,258,10,384
1103412,11,0,11,106,31,13,150,221,15,386
1103413,6,0,6,69,20,7,96,207,8,311
1103414,25,0,25,40,21,3,64,246,30,340
1103415,30,9,39,3,9,0,12,112,19,143
1103416,41,11,55,60,34,0,94,264,25,383
1103417,23,8,31,54,37,0,91,209,28,328
1103418,181,56,237,0,3,0,3,445,100,548
1103419,3,0,3,70,17,4,91,164,4,259
1103501,11,0,11,92,40,0,132,350,17,499
1103502,10,0,10,55,33,3,91,163,25,279
1103503,5,0,5,99,39,4,142,213,18,373
1103504,6,0,6,85,28,3,116,212,19,347
1103505,3,0,3,58,37,0,95,236,18,349
1103506,0,0,3,109,20,0,129,261,18,408
1103507,6,3,9,49,12,0,61,165,15,241
1103508,3,0,3,75,27,9,111,219,8,338
1103509,0,0,0,71,32,0,103,165,13,281
1103510,4,0,4,82,39,4,125,213,16,354
1103511,4,0,4,98,30,7,135,216,21,372
1103512,3,0,3,58,29,6,93,153,15,261
1103513,3,0,3,54,35,3,92,173,13,278
1103514,3,3,6,81,28,4,113,176,22,311
1103515,6,6,12,38,28,6,72,137,45,254
1103516,0,0,4,49,9,0,58,114,15,187
1103517,0,0,0,6,6,0,12,12,0,24
1103601,0,0,0,51,15,0,66,101,6,173
1103602,0,0,0,53,15,0,68,104,12,184
1103603,0,0,0,95,55,11,161,240,18,419
1103604,3,3,6,50,17,3,70,162,9,241
1103605,0,0,0,71,27,3,101,179,17,297
1103606,0,0,0,54,23,3,80,102,15,197
1103607,0,0,0,31,29,0,60,97,8,165
1103608,9,0,9,49,28,4,81,175,16,272
1103609,0,0,0,75,13,3,91,128,24,243
1103610,9,0,9,113,51,9,173,295,14,482
1103611,0,0,0,59,34,0,93,156,19,268
1103612,0,0,0,28,15,6,49,71,14,134
1103613,0,0,0,82,30,7,119,178,8,305
1103614,0,0,0,107,31,6,144,256,25,425
1103615,0,0,0,58,16,3,77,103,3,183
1103616,0,4,4,72,14,3,89,104,21,214
1103617,3,0,3,51,34,9,94,182,17,293
1103618,0,0,0,36,23,6,65,134,9,208
1103619,3,0,3,101,31,8,140,213,12,365
1103620,6,0,6,110,30,0,140,204,29,373
1103621,6,0,6,119,27,10,156,276,34,466
1103622,6,0,6,39,20,6,65,191,9,265
1103701,21,4,25,102,40,6,148,351,33,532
1103702,10,0,10,86,37,9,132,252,38,422
1103703,10,0,10,124,37,6,167,317,55,539
1103704,0,0,0,49,8,4,61,113,9,183
1103705,3,3,6,91,35,3,129,209,21,359
1103706,13,3,16,72,24,0,96,171,21,288
1103707,12,0,12,79,28,11,118,247,32,397
1103708,3,3,6,29,25,0,54,124,21,199
1103709,6,0,6,87,43,10,140,302,24,466
1103710,8,5,13,67,19,3,89,184,45,318
1103711,9,0,9,56,20,0,76,163,0,239
1103712,3,3,6,32,30,0,62,154,34,250
1103713,96,16,112,57,23,3,83,405,49,537
1103714,3,4,7,74,18,9,101,216,74,391
1103801,0,0,0,68,26,3,97,230,24,351
1103802,3,0,3,76,35,3,114,280,16,410
1103803,0,0,0,59,30,9,98,161,12,271
1103804,5,3,8,96,37,0,133,219,32,384
1103805,0,0,0,37,17,0,54,163,7,224
1103806,0,4,4,49,21,0,70,137,10,217
1103807,5,0,5,70,33,3,106,200,18,324
1103808,60,14,74,0,10,0,10,217,37,264
1103809,0,0,0,112,49,5,166,220,16,402
1103810,0,0,0,45,30,3,78,181,6,265
1103811,3,3,6,81,40,0,121,215,32,368
1103812,6,4,10,67,18,0,85,168,20,273
1103813,13,4,17,109,29,8,146,215,19,380
1103814,12,6,18,66,51,10,127,245,28,400
1103815,5,4,9,46,30,0,76,167,14,257
1103816,6,0,6,82,21,3,106,182,6,294
1103817,3,3,6,59,26,0,85,175,21,281
1103901,3,6,9,92,38,7,137,312,39,488
1103902,4,0,4,54,38,6,98,198,15,311
1103903,5,0,5,29,23,3,55,129,25,209
1103904,7,3,10,70,40,0,110,304,31,445
1103905,3,0,3,73,32,0,105,237,18,360
1103906,13,8,21,75,36,0,111,241,21,373
1103907,6,3,9,95,51,12,158,252,22,432
1103908,3,0,3,67,28,6,101,192,15,308
1103909,7,0,7,86,37,0,123,326,23,472
1103910,6,6,12,78,51,9,138,418,50,606
1103911,6,3,9,72,49,6,127,311,27,465
1103912,5,0,5,103,40,0,143,274,18,435
1103913,6,0,6,126,37,6,169,268,16,453
1103914,0,0,0,56,32,0,88,154,14,256
1103915,4,0,7,65,25,6,96,225,24,345
1103916,4,0,4,73,46,3,122,253,25,400
1103917,0,0,0,75,38,0,113,157,12,282
1103918,4,0,4,97,28,0,125,233,35,393
1103919,8,3,11,44,19,0,63,233,47,343
1103920,13,0,13,71,34,4,109,311,41,461
1103921,6,0,6,60,41,6,107,278,154,539
1103922,3,0,3,87,26,11,124,285,27,436
1103923,0,0,3,31,18,6,55,151,16,222
1103924,15,3,18,3,15,0,18,153,13,184
1103925,3,0,3,67,29,9,105,212,24,341
1103926,10,0,10,72,36,0,108,273,42,423
1103927,4,0,4,78,25,0,103,237,28,368
1104001,3,3,6,65,18,0,83,158,15,256
1104002,19,3,22,27,19,0,46,179,27,252
1104003,0,0,0,68,18,0,86,158,12,256
1104004,8,6,14,72,35,0,107,250,18,375
1104005,6,0,9,39,29,0,68,185,16,269
1104006,17,0,17,57,25,4,86,298,39,423
1104007,11,3,14,33,15,4,52,195,24,271
1104008,0,0,0,0,0,0,0,0,0,0
1104009,32,5,37,32,31,0,63,321,47,431
1104010,12,4,16,27,13,4,44,186,28,258
1104011,7,0,7,32,15,0,47,232,27,306
1104012,0,5,5,68,33,0,101,93,24,218
1104013,15,0,15,76,50,5,131,263,26,420
1104014,30,172,205,27,20,3,50,178,297,525
1104015,8,0,8,15,12,3,30,130,15,175
1104016,12,0,12,35,43,3,81,323,59,463
1104017,28,10,41,65,33,7,105,363,52,520
1104018,10,3,16,68,24,3,95,218,35,348
1104019,11,3,14,70,19,0,89,217,21,327
1104020,6,7,13,64,21,0,85,207,34,326
1104021,6,3,9,84,20,0,104,174,19,297
1104022,9,3,12,34,10,0,44,131,21,196
1104023,0,3,3,42,12,0,54,155,18,227
1104024,12,15,27,71,31,3,105,285,60,450
1104025,3,3,6,61,14,0,75,128,21,224
1104026,22,6,28,70,36,0,106,321,70,497
1104027,12,7,19,32,14,0,46,172,13,231
1104028,3,3,6,60,24,0,84,218,12,314
1104029,22,6,28,47,17,0,64,253,33,350
1104030,4,0,4,42,19,6,67,158,41,266
1104031,8,6,14,54,17,0,71,171,38,280
1104032,10,0,10,21,24,3,48,109,17,174
1104033,12,3,15,62,26,0,88,195,10,293
1104034,8,3,11,73,35,9,117,268,23,408
1104035,4,3,7,61,17,6,84,136,12,232
1104036,6,3,9,57,27,0,84,182,15,281
1104037,7,6,13,44,27,0,71,131,20,222
1104038,5,0,5,63,11,6,80,147,11,238
1104039,7,0,7,100,40,0,140,291,49,480
1104040,9,3,12,48,27,6,81,195,35,311
1104041,10,3,13,28,20,3,51,176,20,247
1104042,6,3,9,45,20,6,71,178,32,281
1104043,22,0,22,84,36,3,123,275,33,431
1104044,6,3,9,42,23,4,69,160,31,260
1104045,5,6,11,61,21,11,93,232,45,370
1104046,8,0,8,81,32,3,116,218,35,369
1104047,10,0,10,57,17,4,78,260,21,359
1104048,3,4,7,98,24,3,125,208,14,347
1104049,6,10,16,81,32,6,119,177,27,323
1104050,7,0,7,53,32,10,95,153,21,269
1104051,8,3,11,80,27,0,107,221,30,358
1104052,3,0,3,69,21,3,93,163,30,286
1104053,15,0,15,75,40,5,120,279,24,423
1104054,0,0,0,55,15,0,70,179,32,281
1104055,4,0,4,90,37,9,136,281,23,440
1104056,0,0,0,58,31,3,92,224,15,331
1104057,7,0,7,97,60,6,163,295,33,491
1104058,3,3,6,56,38,4,98,149,24,271
1104101,21,6,27,72,19,6,97,246,22,365
1104102,11,6,17,116,39,14,169,258,39,466
1104103,5,0,5,70,22,6,98,195,15,308
1104104,6,0,6,80,30,5,115,208,23,346
1104105,0,0,0,94,27,0,121,109,24,254
1104106,9,0,9,66,40,6,112,175,24,311
1104107,6,0,6,26,16,6,48,133,5,186
1104108,0,0,0,0,0,0,0,0,0,0
1104109,8,0,8,49,22,5,76,219,40,335
1104110,8,0,11,90,41,6,137,212,13,362
1104111,5,0,5,67,13,0,80,79,15,174
1104112,10,0,10,82,14,4,100,213,31,344
1104113,3,0,3,49,33,7,89,180,0,269
1104114,7,0,7,103,36,6,145,269,38,452
1104115,6,0,6,49,26,3,78,181,15,274
1104116,5,0,5,83,30,12,125,172,4,301
1104117,6,0,6,44,24,3,71,111,12,194
1104118,0,0,0,0,0,0,0,0,0,0
1104119,0,0,0,87,30,7,124,196,25,345
1104120,6,0,6,82,31,9,122,182,21,325
1104121,8,3,11,65,10,7,82,187,17,286
1104122,3,0,3,50,31,0,81,140,20,241
1104123,6,0,6,69,17,6,92,188,21,301
1104124,6,0,6,83,41,0,124,191,28,343
1104125,6,3,9,71,33,0,104,245,28,377
1104201,6,3,9,58,52,3,113,240,36,389
1104202,13,3,16,74,43,3,120,281,27,428
1104203,0,3,3,55,15,3,73,151,13,237
1104204,22,10,32,27,27,0,54,262,58,374
1104205,25,13,38,46,25,0,71,303,75,449
1104206,0,0,0,0,0,0,0,0,0,0
1104207,0,0,0,101,47,9,157,232,29,418
1104208,47,8,55,53,22,0,75,294,57,426
1104209,14,3,17,32,14,0,46,141,27,214
1104210,3,3,6,86,30,7,123,188,31,342
1104211,3,3,6,51,40,3,94,221,44,359
1104212,0,0,0,0,0,0,0,6,3,9
1104213,19,6,25,67,41,0,108,360,49,517
1104214,16,0,16,53,44,0,97,323,29,449
1104215,7,6,16,61,33,0,94,179,24,297
1104216,9,3,12,47,27,0,74,178,30,282
1104217,10,0,10,77,22,3,102,219,41,362
1104218,3,0,3,82,22,9,113,201,14,328
1104219,9,0,9,45,17,3,65,210,40,315
1104220,19,9,28,50,29,6,85,289,61,435
1104221,6,6,12,50,27,3,80,290,58,428
1104222,7,3,10,52,23,4,79,235,39,353
1104223,47,7,54,37,20,0,57,226,22,305
1104224,3,3,6,103,28,9,140,194,21,355
1104225,3,0,3,95,32,3,130,229,31,390
1104226,6,3,9,69,26,6,101,218,24,343
1104227,3,0,3,45,28,6,79,182,16,277
1104228,7,3,10,77,16,7,100,221,26,347
1104229,9,4,13,43,16,0,59,172,31,262
1104230,8,6,14,57,29,0,86,216,32,334
1104231,95,6,101,52,28,6,86,381,37,504
1104232,12,3,15,38,22,0,60,212,22,294
1104233,21,8,29,48,27,0,75,265,34,374
1104301,0,0,0,23,14,0,37,66,13,116
1104302,4,0,8,52,24,6,82,192,13,287
1104303,3,3,6,92,41,3,136,228,26,390
1104304,4,3,7,73,20,3,96,173,23,292
1104305,0,0,0,74,32,5,111,153,21,285
1104306,0,0,0,0,0,0,0,7,0,7
1104307,0,0,0,54,15,3,72,144,6,222
1104308,3,0,3,48,23,3,74,130,6,210
1104309,0,0,0,73,33,3,109,161,28,298
1104310,5,0,5,36,5,4,45,110,9,164
1104311,0,3,3,79,28,4,111,212,24,347
1104312,233,52,288,6,21,0,27,678,107,812
1104313,4,0,4,33,25,0,58,188,38,284
1104314,76,8,84,0,3,0,3,181,14,198
1104315,3,0,3,70,34,6,110,173,21,304
1104316,6,0,6,47,21,5,73,165,18,256
1104317,11,0,11,73,28,3,104,177,21,302
1104318,12,4,16,50,14,0,64,170,36,270
1104319,0,0,0,66,26,6,98,216,17,331
1104320,6,0,6,81,21,3,105,221,17,343
1104321,40,0,40,50,14,7,71,197,7,275
1104322,6,0,6,56,24,4,84,144,18,246
1104323,3,4,7,71,22,4,97,213,48,358
1104324,8,3,11,92,61,4,157,259,12,428
1104325,90,0,90,50,35,12,97,261,17,375
1104326,3,0,3,102,46,13,161,276,18,455
1104327,6,0,6,62,32,9,103,193,12,308
1104328,0,3,3,41,9,0,50,162,9,221
1104329,3,0,3,38,22,6,66,144,12,222
1104330,3,0,3,97,42,4,143,267,35,445
1104401,15,0,15,41,28,6,75,183,15,273
1104402,7,0,7,60,9,0,69,214,16,299
1104403,6,0,6,31,10,0,41,145,9,195
1104404,10,0,10,98,66,10,174,316,21,511
1104405,3,3,6,45,14,0,59,176,9,244
1104406,3,0,3,49,24,3,76,144,10,230
1104407,7,0,7,61,40,6,107,231,24,362
1104408,4,0,4,44,12,0,56,178,9,243
1104409,0,0,0,61,16,10,87,152,21,260
1104410,29,60,89,3,0,0,3,108,109,220
1104411,84,11,95,25,6,3,34,216,27,277
1104412,21,7,28,54,41,8,103,352,27,482
1104413,0,0,0,0,0,0,0,0,0,0
1104414,3,3,6,84,38,0,122,229,23,374
1104415,6,3,9,79,31,0,110,204,14,328
1104416,19,4,23,124,37,7,168,314,32,514
1104417,8,0,8,85,38,0,123,246,46,415
1104418,0,0,0,0,0,0,0,0,0,0
1104419,8,0,8,94,28,6,128,218,12,358
1104420,78,10,91,17,15,0,32,214,25,271
1104421,42,14,56,24,20,3,47,163,45,255
1104422,7,0,7,74,30,3,107,256,16,379
1104423,9,0,9,75,34,6,115,250,37,402
1104424,5,0,5,31,35,6,72,153,18,243
1104425,3,0,3,30,18,0,48,129,9,186
1104426,6,0,6,64,19,6,89,198,18,305
1104427,3,0,3,33,13,0,46,132,30,208
1104428,13,0,13,66,28,3,97,175,21,293
1104429,10,0,10,76,54,5,135,245,24,404
1104430,5,3,8,36,17,7,60,166,9,235
1104431,9,0,9,43,10,3,56,169,14,239
1104432,3,7,10,33,30,0,63,130,19,212
1104433,0,6,6,66,21,3,90,135,33,258
1104434,10,4,14,103,35,13,151,290,38,479
1104435,0,0,0,81,24,4,109,122,5,236
1104436,6,0,6,101,25,3,129,196,30,355
1104437,6,0,6,38,19,0,57,156,21,234
1104438,7,0,7,61,26,3,90,216,23,329
1104439,15,0,15,55,36,3,94,206,16,316
1104440,61,122,183,0,3,0,3,154,202,359
1104441,3,3,6,75,21,3,99,162,19,280
1104442,3,6,9,76,19,0,95,175,21,291
1104443,3,0,3,36,18,6,60,110,9,179
1104444,10,0,10,54,41,0,95,176,8,279
1104445,7,0,7,59,31,4,94,223,34,351
1104446,5,3,8,73,34,3,110,334,47,491
1104447,7,0,7,76,33,3,112,214,39,365
1104448,0,0,0,68,28,6,102,165,22,289
1104449,3,3,9,57,25,3,85,163,22,270
1104450,3,3,6,80,28,3,111,171,13,295
1104451,3,6,9,79,26,7,112,186,19,317
1104452,3,0,3,26,13,7,46,119,0,165
1104453,7,0,7,74,34,3,111,167,7,285
1104454,3,0,3,40,9,0,49,103,3,155
1104455,33,0,33,55,36,5,96,239,22,357
1104456,3,3,6,56,36,0,92,232,22,346
1104457,0,0,0,66,45,0,111,153,10,274
1104458,3,0,3,70,31,0,101,160,9,270
1104459,3,0,3,55,26,0,81,190,18,289
1104501,8,4,12,79,21,10,110,192,19,321
1104502,0,0,0,63,24,3,90,149,18,257
1104503,0,0,0,65,6,0,71,137,0,208
1104504,3,0,3,119,26,3,148,238,23,409
1104505,3,0,3,82,37,8,127,278,31,436
1104506,3,0,3,123,31,0,154,238,47,439
1104507,0,0,0,108,19,4,131,255,34,420
1104508,0,3,3,74,13,6,93,167,21,281
1104509,0,0,0,63,26,6,95,192,25,312
1104510,0,6,6,115,46,5,166,260,23,449
1104511,0,0,0,89,34,11,134,265,60,459
1104512,3,3,6,84,13,3,100,185,35,320
1104513,0,5,5,127,26,15,168,273,49,490
1104514,0,0,0,101,28,6,135,173,23,331
1104515,0,0,0,78,24,0,102,131,14,247
1104516,6,3,9,116,36,10,162,230,28,420
1104517,3,0,3,54,9,7,70,124,17,211
1104518,7,0,7,128,35,7,170,248,41,459
1104519,3,3,6,64,14,0,78,128,24,230
1104520,0,0,0,0,0,0,0,0,0,0
1104521,8,0,8,67,21,0,88,247,21,356
1104522,0,0,0,86,25,0,111,138,16,265
1104523,3,0,3,78,11,3,92,103,11,206
1104524,4,0,7,115,36,4,155,264,30,449
1104601,9,0,9,70,29,0,99,190,20,309
1104602,3,0,3,54,19,0,73,129,12,214
1104603,8,0,8,58,33,9,100,242,12,354
1104604,8,3,11,58,15,5,78,245,44,367
1104605,9,0,9,32,7,3,42,149,6,197
1104606,8,3,11,49,33,9,91,206,15,312
1104607,6,5,11,78,41,6,125,249,12,386
1104608,7,0,7,90,36,9,135,204,34,373
1104609,4,0,4,73,25,9,107,222,33,362
1104610,0,0,0,36,12,0,48,154,9,211
1104611,6,3,9,12,9,0,21,211,30,262
1104612,6,3,9,43,20,0,63,157,20,240
1104613,0,0,0,0,0,0,0,0,0,0
1104614,6,0,6,44,24,0,68,157,16,241
1104615,3,3,6,39,21,4,64,131,18,213
1104616,8,3,11,76,31,0,107,202,44,353
1104617,20,0,20,41,36,7,84,257,29,370
1104618,15,0,15,65,35,0,100,297,35,432
1104619,12,9,21,70,28,4,102,247,34,383
1104620,11,3,14,51,41,0,92,220,27,339
1104621,6,0,6,42,33,4,79,140,4,223
1104622,5,0,5,39,28,4,71,135,15,221
1104623,3,0,3,0,3,0,3,9,0,12
1104624,7,3,10,63,42,9,114,258,32,404
1104625,14,7,21,50,30,0,80,438,63,581
1104701,6,0,6,100,20,6,126,239,17,382
1104702,3,0,3,51,18,3,72,107,6,185
1104703,0,0,0,17,16,0,33,139,6,178
1104704,5,0,5,125,48,7,180,249,36,465
1104705,3,3,6,97,33,0,130,229,21,380
1104706,5,3,8,83,25,3,111,202,16,329
1104707,8,3,11,102,39,3,144,242,25,411
1104708,7,0,7,128,34,17,179,256,3,438
1104709,8,3,11,86,18,10,114,241,25,380
1104710,83,6,89,22,8,0,30,200,21,251
1104711,58,11,69,52,15,0,67,307,48,422
1104712,5,0,5,76,32,3,111,247,27,385
1104713,36,17,53,89,34,6,129,383,52,564
1104714,0,0,0,34,21,0,55,99,6,160
1104715,4,0,4,64,40,12,116,246,14,376
1104716,6,0,6,83,42,6,131,204,14,349
1104717,6,0,6,50,28,3,81,188,12,281
1104718,3,3,6,70,37,7,114,171,30,315
1104719,6,0,6,130,48,14,192,282,20,494
1104720,0,0,0,41,26,0,67,131,11,209
1104721,6,3,9,112,27,4,143,220,11,374
1104722,0,0,0,116,16,4,136,226,30,392
1104723,6,0,6,37,29,6,72,154,21,247
1104724,0,3,3,55,20,3,78,151,57,286
1104725,6,0,6,49,22,8,79,130,4,213
1104726,0,0,0,63,25,0,88,157,20,265
1104727,0,0,0,58,34,3,95,172,10,277
1104728,8,0,8,119,45,9,173,260,18,451
1104729,3,3,6,100,30,10,140,257,17,414
1104730,3,0,3,58,31,0,89,154,12,255
1104731,6,0,6,105,21,9,135,279,10,424
1104732,4,3,7,76,33,0,109,197,43,349
1104733,0,0,0,25,15,0,40,91,6,137
1104734,6,0,6,42,27,3,72,141,7,220
1104735,3,0,3,81,48,3,132,267,21,420
1104736,7,3,10,95,47,0,142,236,24,402
1104737,3,0,3,3,3,0,6,6,0,12
1104801,3,0,3,58,18,0,76,125,23,224
1104802,6,3,9,64,26,0,90,198,28,316
1104803,6,6,12,105,36,5,146,225,24,395
1104804,7,0,7,55,13,3,71,169,30,270
1104805,3,0,3,52,30,0,82,200,29,311
1104806,0,0,0,51,24,9,84,115,13,212
1104807,6,0,6,94,28,4,126,285,19,430
1104808,5,0,5,41,15,0,56,153,25,234
1104809,7,3,10,66,26,0,92,206,24,322
1104810,17,6,23,62,50,0,112,342,34,488
1104811,9,0,9,82,41,9,132,279,39,450
1104812,6,0,6,81,46,9,136,258,28,422
1104813,8,0,8,80,35,0,115,277,30,422
1104814,21,0,21,92,43,7,142,354,44,540
1104815,17,0,17,41,26,3,70,196,33,299
1104816,8,0,8,40,16,0,56,213,15,284
1104817,7,0,7,54,34,3,91,259,25,375
1104818,6,6,12,82,19,9,110,289,51,450
1104819,4,3,7,74,24,7,105,256,32,393
1104820,4,0,4,42,10,0,52,129,19,200
1104821,77,24,101,33,20,0,53,360,70,483
1104822,6,3,9,105,45,8,158,232,41,431
1104823,8,3,11,55,19,0,74,163,16,253
1104824,18,3,21,99,29,12,140,308,56,504
1104825,10,3,16,53,27,6,86,250,35,371
1104826,11,0,11,50,32,0,82,238,26,346
1104827,12,3,15,68,29,5,102,317,15,434
1104828,3,6,9,83,32,5,120,254,25,399
1104829,5,4,9,47,27,3,77,271,24,372
1104830,16,3,19,65,27,3,95,276,39,410
1104831,3,3,6,88,18,0,106,177,12,295
1104832,4,0,4,65,29,7,101,261,25,387
1104833,3,10,13,66,37,6,109,228,26,363
1104834,9,8,17,49,19,0,68,157,27,252
1104835,6,3,9,36,22,0,58,166,13,237
1104836,6,0,6,100,31,4,135,234,25,394
1104837,17,6,23,77,47,0,124,290,36,450
1104838,6,3,9,41,26,9,76,165,16,257
1104839,163,9,172,93,44,4,141,490,46,677
1104840,3,0,3,70,17,4,91,140,15,246
1104841,3,4,7,72,29,0,101,146,17,264
1104842,6,0,6,56,26,0,82,179,20,281
1104843,8,0,8,55,25,0,80,212,24,316
1104844,0,0,0,48,21,10,79,128,16,223
1104845,10,7,17,52,30,4,86,243,43,372
1104846,28,3,31,57,15,0,72,330,44,446
1104847,6,3,9,39,16,0,55,148,17,220
1104901,0,0,0,102,35,0,137,163,26,326
1104902,0,0,0,63,21,0,84,132,33,249
1104903,3,0,3,47,40,6,93,206,32,331
1104904,6,4,10,58,32,7,97,154,17,268
1104905,0,3,3,92,19,9,120,216,38,374
1104906,5,0,5,34,29,0,63,139,22,224
1104907,3,0,3,29,26,0,55,95,18,168
1104908,0,0,0,28,18,4,50,108,3,161
1104909,0,0,0,0,0,0,0,0,0,0
1104910,0,0,0,64,34,6,104,174,15,293
1105001,6,0,6,99,38,12,149,291,37,477
1105002,0,0,0,61,26,4,91,149,18,258
1105003,0,0,0,86,38,0,124,221,28,373
1105004,0,0,0,64,19,0,83,132,10,225
1105005,0,0,0,79,25,6,110,190,19,319
1105006,12,0,12,78,18,7,103,164,27,294
1105007,11,0,11,66,19,8,93,196,15,304
1105008,6,0,6,82,42,3,127,399,24,550
1105009,3,0,3,71,28,0,99,227,12,338
1105010,4,0,4,49,22,3,74,157,15,246
1105011,3,3,6,76,22,0,98,187,35,320
1105012,0,3,3,59,33,0,92,152,23,267
1105013,3,0,3,69,32,3,104,180,20,304
1105014,0,0,0,0,0,0,0,0,0,0
1105015,0,3,3,54,9,0,63,131,30,224
1105016,0,0,0,0,0,0,0,3,0,3
1105017,17,6,23,16,22,0,38,282,67,387
1105018,3,0,3,61,15,0,76,164,9,249
1105019,6,3,9,80,29,3,112,167,21,300
1105020,9,0,9,0,27,0,27,271,18,316
1105021,12,5,17,0,19,0,19,332,43,394
1105022,4,0,4,91,30,0,121,201,11,333
1105023,23,0,23,38,41,3,82,656,46,784
1105024,10,3,13,57,28,3,88,187,22,297
1105025,0,8,8,46,38,0,84,160,32,276
1105026,7,3,10,62,31,12,105,281,25,411
1105101,0,0,0,105,36,3,144,255,16,415
1105102,3,3,6,59,13,3,75,198,18,291
1105103,0,0,0,39,36,0,75,118,10,203
1105104,0,0,0,26,23,0,49,94,4,147
1105105,0,0,0,0,0,0,0,0,0,0
1105106,9,0,9,46,48,0,94,275,29,398
1105107,0,0,0,15,9,0,24,42,15,81
1105108,3,0,3,71,34,3,108,257,14,379
1105109,0,0,0,64,23,6,93,99,6,198
1105110,0,0,0,80,18,6,104,141,19,264
1105111,0,0,0,55,11,9,75,123,6,204
1105112,0,0,0,66,20,3,89,134,10,233
1105113,3,0,3,76,22,3,101,146,12,259
1105114,0,3,3,71,31,3,105,158,15,278
1105115,0,0,0,54,17,3,74,109,22,205
1105116,0,0,0,50,22,0,72,135,12,219
1105201,6,3,9,76,23,4,103,293,51,447
1105202,3,0,3,108,34,0,142,231,18,391
1105203,6,0,6,58,12,7,77,176,17,270
1105204,6,0,6,93,21,5,119,192,18,329
1105205,5,0,5,86,56,0,142,239,31,412
1105206,6,3,9,64,44,4,112,179,16,307
1105207,0,0,0,72,26,0,98,227,18,343
1105208,5,0,5,51,26,9,86,191,15,292
1105209,6,0,6,64,30,0,94,169,17,280
1105210,4,0,4,45,13,0,58,191,8,257
1105211,0,0,0,0,0,0,0,0,0,0
1105212,0,0,0,0,0,0,0,3,0,3
1105213,3,0,3,40,29,0,69,142,3,214
1105214,5,0,5,52,26,0,78,109,3,190
1105215,3,0,3,49,16,6,71,137,10,218
1105216,7,4,11,67,28,0,95,211,29,335
1105301,6,6,12,69,30,0,99,239,48,386
1105302,5,0,5,54,11,0,65,196,22,283
1105303,13,7,20,52,24,0,76,276,30,382
1105304,6,3,9,58,22,0,80,176,20,276
1105305,20,6,26,60,42,0,102,326,35,463
1105306,10,0,10,52,37,6,95,239,35,369
1105307,11,4,15,72,28,0,100,319,34,453
1105308,10,4,14,35,21,6,62,157,28,247
1105309,3,3,6,52,22,6,80,145,24,249
1105310,12,7,19,50,28,3,81,175,29,285
1105311,5,0,5,38,15,0,53,149,33,235
1105312,6,0,6,38,19,0,57,150,9,216
1105313,6,4,10,33,20,6,59,111,18,188
1105314,14,5,19,49,39,3,91,232,28,351
1105315,7,0,7,74,38,3,115,338,55,508
1105316,15,9,24,63,56,3,122,308,57,487
1105317,10,0,10,51,17,0,68,147,20,235
1105318,3,3,6,40,24,6,70,116,22,208
1105319,3,0,3,22,14,0,36,111,12,159
1105320,0,0,0,45,23,0,68,155,28,251
1105321,5,3,8,99,37,6,142,320,44,506
1105322,0,0,0,19,10,0,29,30,4,63
1105323,0,0,0,3,6,0,9,11,3,23
1105324,3,4,7,83,38,9,130,190,24,344
1105325,8,4,12,55,15,0,70,204,30,304
1105326,4,6,10,72,24,3,99,165,40,304
1105327,3,3,6,33,25,0,58,154,49,261
1105328,6,3,9,66,38,3,107,285,60,452
1105329,6,3,9,70,17,3,90,242,113,445
1105330,10,6,16,43,31,3,77,244,83,404
1105331,3,6,9,46,13,3,62,176,44,282
1105332,9,11,20,45,15,0,60,211,46,317
1105333,14,0,14,39,25,0,64,147,62,273
1105334,14,6,20,69,32,6,107,321,65,493
1105335,6,0,6,50,25,0,75,188,51,314
1105336,11,3,14,39,23,3,65,125,13,203
1105337,11,0,11,75,28,4,107,228,21,356
1105401,17,0,17,67,43,0,110,237,24,371
1105402,14,4,18,23,6,7,36,183,44,263
1105403,6,0,6,47,24,0,71,187,28,286
1105404,21,10,31,47,16,0,63,267,54,384
1105405,11,0,11,30,12,6,48,159,10,217
1105406,37,11,48,16,27,0,43,339,62,444
1105407,37,4,41,81,28,6,115,311,27,453
1105408,9,3,12,95,43,11,149,362,55,566
1105409,9,0,9,53,23,0,76,163,19,258
1105410,5,0,5,47,28,0,75,202,19,296
1105411,4,0,4,46,22,0,68,218,26,312
1105412,17,0,17,44,40,0,84,235,12,331
1105413,5,0,5,36,31,7,74,183,21,278
1105414,35,0,35,41,28,0,69,242,27,338
1105415,0,0,0,3,0,3,6,0,0,6
1105416,0,0,0,0,0,0,0,0,0,0
1105417,9,0,9,37,15,6,58,154,38,250
1105418,19,11,30,70,21,6,97,302,80,479
1105419,50,9,59,40,34,0,74,385,48,507
1105420,12,4,16,58,21,12,91,221,43,355
1105421,6,0,6,62,24,0,86,207,36,329
1105422,34,3,37,46,15,4,65,248,21,334
1105423,7,3,10,73,39,6,118,193,20,331
1105424,6,0,6,40,20,0,60,150,16,226
1105501,0,0,0,42,28,0,70,168,22,260
1105502,0,0,0,131,38,6,175,248,24,447
1105503,9,0,9,57,24,6,87,192,26,305
1105504,0,0,0,9,0,0,9,12,0,21
1105505,0,0,0,88,24,0,112,129,23,264
1105506,8,0,8,71,31,0,102,232,48,382
1105507,3,0,3,123,33,0,156,220,31,407
1105508,0,0,0,62,17,3,82,173,34,289
1105509,20,0,20,68,27,0,95,215,11,321
1105510,3,0,3,50,27,0,77,124,15,216
1105511,0,3,3,134,19,15,168,190,22,380
1105512,0,0,0,45,15,0,60,93,9,162
1105513,0,6,6,59,20,0,79,130,17,226
1105514,0,0,0,26,19,5,50,134,7,191
1105601,38,0,38,125,31,0,156,273,33,462
1105602,0,0,0,161,29,9,199,216,60,475
1105603,3,0,3,150,30,9,189,206,27,422
1105604,6,0,6,54,18,3,75,80,15,170
1105605,5,0,5,117,44,10,171,246,26,443
1105606,3,0,3,75,13,8,96,113,11,220
1105607,4,0,4,112,47,9,168,179,19,366
1105608,3,0,3,87,28,9,124,237,29,390
1105609,3,0,3,51,21,3,75,92,21,188
1105610,11,0,11,138,36,9,183,339,36,558
1105611,49,3,52,191,29,3,223,344,30,597
1105612,3,0,3,83,32,6,121,198,11,330
1105613,0,0,0,128,28,7,163,214,18,395
1105614,6,0,6,96,21,0,117,209,20,346
1105615,6,0,6,90,30,9,129,261,33,423
1105616,0,0,0,0,0,0,0,3,0,3
1105617,4,0,4,45,20,0,65,117,15,197
1105618,6,0,6,166,36,3,205,217,62,484
1105619,0,4,4,182,53,11,246,346,27,619
1105620,3,0,3,54,25,3,82,141,18,241
1105621,0,0,0,0,0,0,0,0,0,0
1105622,3,3,6,74,21,0,95,186,15,296
1105623,0,0,0,89,24,0,113,156,12,281
1105624,6,0,6,67,43,0,110,191,29,330
1105625,30,7,37,33,15,3,51,144,24,219
1105626,6,6,12,58,12,4,74,241,36,351
1105627,0,0,0,117,21,3,141,187,3,331
1105701,0,0,0,131,29,4,164,200,32,396
1105702,0,0,0,97,20,0,117,241,23,381
1105703,0,0,0,103,22,0,125,244,36,405
1105704,0,0,0,87,32,4,123,212,29,364
1105705,0,0,0,3,0,0,3,6,6,15
1105706,6,0,6,52,21,6,79,229,12,320
1105707,13,3,16,65,40,9,114,339,39,492
1105708,3,0,3,45,30,10,85,133,21,239
1105709,4,0,4,69,36,6,111,212,30,353
1105710,10,3,13,92,31,6,129,347,57,533
1105711,12,6,18,58,34,0,92,190,19,301
1105712,0,6,6,37,16,6,59,187,31,277
1105713,4,0,4,32,15,0,47,159,17,223
1105714,10,0,10,41,21,8,70,142,14,226
1105715,0,0,0,43,10,3,56,170,27,253
1105716,3,0,3,73,55,6,134,191,43,368
1105717,4,0,4,96,32,3,131,270,26,427
1105718,15,0,15,31,32,0,63,242,44,349
1105719,6,6,12,53,26,6,85,236,33,354
1105720,6,0,6,31,15,3,49,156,16,221
1105801,3,0,3,70,26,4,100,206,21,327
1105802,7,0,7,42,30,3,75,175,7,257
1105803,4,0,4,77,43,0,120,274,18,412
1105804,4,0,7,71,41,3,115,207,12,334
1105805,0,3,3,30,21,0,51,151,49,251
1105806,3,0,3,86,25,3,114,182,13,309
1105807,3,3,6,44,5,0,49,122,20,191
1105808,0,0,0,33,12,0,45,149,22,216
1105809,0,0,0,25,18,0,43,118,12,173
1105810,3,0,3,157,38,9,204,277,17,498
1105811,0,0,0,80,34,0,114,166,10,290
1105812,6,0,6,150,23,3,176,241,10,427
1105813,3,0,3,90,32,10,132,200,18,350
1105814,3,0,3,29,18,4,51,263,16,330
1105815,3,0,3,75,28,4,107,171,15,293
1105816,0,0,0,60,31,0,91,130,6,227
1105817,10,6,16,54,36,0,90,344,51,485
1105818,14,0,14,67,38,8,113,314,53,480
1105819,9,3,12,44,35,3,82,242,21,345
1105820,7,4,11,23,16,3,42,200,26,268
1105821,13,0,13,58,17,7,82,179,24,285
1105822,6,0,6,42,10,3,55,220,65,340
1105823,43,6,53,66,34,3,103,350,44,497
1105824,8,6,14,44,21,3,68,316,76,460
1105825,11,0,11,44,35,0,79,253,28,360
1105826,3,0,3,135,42,4,181,195,21,397
1105827,39,6,45,42,17,4,63,202,39,304
1105828,7,0,7,54,19,3,76,180,21,277
1105829,6,0,6,54,28,9,91,230,32,353
1105830,10,3,13,41,22,4,67,147,24,238
1105831,0,0,0,44,21,0,65,105,4,174
1105832,45,3,48,55,22,7,84,256,18,358
1105833,0,0,0,35,12,0,47,105,23,175
1105834,0,0,0,76,35,3,114,181,26,321
1105835,7,0,7,65,29,0,94,183,20,297
1105836,3,0,3,45,13,0,58,190,15,263
1105837,5,0,5,51,19,0,70,152,18,240
1105838,8,0,8,66,27,9,102,210,21,333
1105839,0,0,0,123,27,15,165,267,24,456
1105840,6,0,6,89,29,6,124,237,12,373
1105841,0,0,0,0,19,0,19,429,14,462
1105842,0,0,0,85,6,3,94,135,13,242
1105843,6,0,6,60,41,7,108,240,47,395
1105844,7,3,10,81,27,10,118,207,21,346
1105845,9,3,12,76,34,3,113,279,25,417
1105846,7,3,10,60,44,0,104,345,28,477
1105847,11,0,14,68,41,7,116,327,42,485
1105848,7,0,7,60,21,6,87,304,43,434
1105849,0,0,0,0,0,0,0,0,470,470
1105850,4,0,4,55,16,0,71,156,9,236
1105851,3,0,3,66,36,9,111,172,45,328
1105852,0,0,0,0,0,0,0,0,0,0
1105853,6,0,6,51,20,0,71,144,32,247
1105854,3,6,9,62,34,0,96,172,26,294
1105855,6,0,6,66,27,4,97,176,14,287
1105856,3,0,6,46,33,3,82,116,26,224
1105857,6,0,6,39,27,0,66,147,26,239
1105901,6,0,6,62,36,6,104,158,12,274
1105902,0,0,0,45,30,3,78,154,19,251
1105903,4,0,4,33,24,0,57,147,15,219
1105904,0,0,0,0,0,0,0,0,0,0
1105905,3,0,3,77,36,3,116,202,57,375
1105906,0,0,0,45,27,6,78,140,36,254
1105907,4,0,4,47,14,0,61,154,29,244
1105908,44,8,52,11,15,0,26,166,33,225
1105909,4,0,4,229,44,11,284,303,30,617
1105910,8,0,8,59,32,8,99,194,12,305
1105911,0,3,3,37,43,6,86,158,24,268
1105912,0,0,0,39,28,3,70,164,11,245
1105913,0,4,4,104,42,3,149,227,13,389
1105914,5,0,5,60,13,6,79,191,13,283
1105915,6,3,9,47,31,3,81,190,30,301
1105916,3,0,3,94,24,12,130,162,5,297
1105917,3,0,3,180,42,4,226,262,22,510
1105918,34,5,39,76,13,6,95,175,12,282
1105919,3,0,3,121,71,10,202,277,27,506
1105920,0,0,0,49,6,0,55,129,6,190
1105921,7,0,7,45,38,6,89,196,0,285
1105922,0,0,0,80,39,3,122,162,13,297
1105923,3,0,3,157,24,16,197,288,37,522
1106001,0,0,0,34,12,3,49,84,15,148
1106002,0,0,0,36,15,3,54,103,6,163
1106003,6,3,9,34,18,3,55,139,25,219
1106004,14,3,17,87,40,0,127,195,24,346
1106005,8,0,8,43,13,3,59,219,19,297
1106006,3,0,3,96,38,6,140,284,18,442
1106007,0,0,0,34,22,0,56,100,18,174
1106008,0,0,0,64,21,3,88,179,7,274
1106009,5,0,5,67,20,0,87,153,22,262
1106010,9,0,9,65,26,4,95,258,53,406
1106011,0,0,0,63,19,0,82,149,13,244
1106012,0,0,0,60,32,0,92,160,9,261
1106013,0,0,0,54,17,6,77,181,16,274
1106014,0,0,0,36,14,3,53,121,9,183
1106015,3,0,3,54,7,0,61,116,4,181
1106016,6,0,6,77,22,0,99,206,21,326
1106017,3,0,3,39,16,3,58,105,11,174
1106018,0,0,0,46,13,3,62,135,18,215
1106019,3,0,3,62,33,3,98,159,18,275
1106020,6,0,6,39,23,3,65,127,14,206
1106021,0,0,0,0,0,0,0,3,182,185
1106101,4,0,4,25,17,3,45,120,7,172
1106102,3,3,6,63,19,0,82,213,21,316
1106103,4,0,4,64,26,3,93,172,7,272
1106104,0,0,0,17,7,0,24,159,10,193
1106105,0,0,0,36,22,0,58,128,21,207
1106106,6,0,6,46,30,0,76,199,30,305
1106107,4,0,4,23,8,0,31,76,116,223
1106108,3,0,3,85,31,0,116,188,24,328
1106109,0,0,0,19,6,0,25,107,15,147
1106110,11,0,11,48,30,0,78,165,13,256
1106111,10,0,10,46,16,7,69,154,3,226
1106112,3,0,3,90,30,0,120,144,30,294
1106113,0,0,0,3,0,0,3,6,0,9
1106114,6,0,6,43,12,0,55,147,20,222
1106115,3,0,3,35,19,0,54,99,3,156
1106116,6,0,6,50,22,9,81,161,16,258
1106201,20,3,23,64,22,0,86,222,25,333
1106202,6,0,6,59,19,3,81,228,33,342
1106203,9,0,9,57,22,6,85,199,30,314
1106204,7,0,7,46,33,0,79,223,18,320
1106205,8,0,8,57,28,6,91,196,22,309
1106206,6,3,9,62,30,3,95,170,24,289
1106207,3,3,6,40,12,0,52,133,21,206
1106208,11,8,19,28,15,0,43,110,17,170
1106209,23,0,23,39,27,6,72,134,22,228
1106210,4,0,4,44,25,6,75,167,25,267
1106211,7,0,7,34,20,3,57,182,37,276
1106212,10,0,10,25,7,0,32,93,16,141
1106213,6,0,6,68,32,6,106,170,17,293
1106214,3,0,3,45,18,3,66,127,20,213
1106215,0,0,0,49,15,0,64,86,24,174
1106216,0,0,0,21,9,0,30,37,0,67
1106217,3,0,3,60,18,3,81,152,15,248
1106218,6,3,9,49,18,6,73,130,21,224
1106219,6,0,6,81,25,4,110,185,23,318
1106220,0,0,0,58,22,3,83,166,10,259
1106221,0,0,0,29,10,0,39,69,15,123
1106222,21,0,21,34,9,0,43,199,24,266
1106223,0,0,0,0,0,0,0,9,3,12
1106224,0,0,0,3,9,0,12,11,0,23
1106225,0,0,0,0,0,0,0,0,0,0
1106301,0,0,0,0,0,0,0,0,0,0
1106302,0,0,0,0,0,0,0,0,0,0
1106303,40,3,43,51,29,7,87,290,52,429
1106304,8,3,11,124,33,0,157,309,62,528
1106305,3,0,3,36,26,4,66,141,12,219
1106306,62,0,62,20,7,3,30,172,19,221
1106307,0,0,0,0,0,0,0,0,0,0
1106308,3,0,3,47,27,3,77,209,8,294
1106309,4,0,4,67,22,3,92,241,41,374
1106310,5,6,11,62,16,0,78,195,34,307
1106311,8,6,14,46,24,6,76,234,50,360
1106312,14,6,20,41,16,0,57,184,49,290
1106313,12,0,12,44,15,0,59,117,15,191
1106314,8,0,8,32,9,7,48,115,3,166
1106315,8,0,8,65,17,7,89,245,22,356
1106316,11,3,14,34,23,9,66,202,26,294
1106317,4,3,7,50,24,0,74,170,33,277
1106318,3,3,6,40,9,0,49,103,102,254
1106319,12,6,18,18,7,3,28,148,85,261
1106320,0,0,0,13,9,0,22,71,46,139
1106321,7,0,7,53,23,4,80,157,19,256
1106322,7,0,7,34,24,0,58,120,9,187
1106323,6,3,9,69,29,6,104,264,17,385
1106324,5,0,5,38,4,3,45,158,27,230
1106325,4,0,4,67,24,3,94,232,24,350
1106326,3,0,3,34,15,0,49,128,0,177
1106327,6,3,9,32,17,0,49,85,13,147
1106328,3,0,3,82,21,3,106,237,27,370
1106329,5,0,5,39,8,0,47,99,0,146
1106401,3,0,3,28,0,4,32,101,10,143
1106402,10,0,10,38,12,0,50,146,14,210
1106403,0,3,3,38,21,0,59,168,15,242
1106404,12,0,12,45,37,6,88,211,16,315
1106405,7,3,10,29,20,3,52,172,15,239
1106406,8,3,11,45,9,3,57,182,18,257
1106407,28,7,35,81,23,0,104,234,22,360
1106408,8,0,8,71,29,3,103,273,24,400
1106409,5,0,5,41,13,4,58,156,20,234
1106410,0,0,0,40,12,0,52,143,12,207
1106411,0,0,0,37,21,9,67,116,3,186
1106412,3,0,3,39,14,3,56,147,0,203
1106413,0,3,3,55,14,4,73,157,14,244
1106414,3,0,3,36,14,0,50,202,20,272
1106415,4,0,4,26,19,0,45,148,13,206
1106416,3,0,3,22,6,0,28,143,14,185
1106417,3,3,6,50,10,3,63,172,26,261
1106418,0,0,0,38,16,0,54,123,15,192
1106501,11,0,11,31,20,9,60,212,26,298
1106502,4,0,4,46,22,0,68,163,24,255
1106503,0,3,3,51,12,0,63,134,38,235
1106504,3,0,3,70,11,3,84,191,29,304
1106505,6,0,6,34,22,0,56,186,22,264
1106506,0,0,0,63,23,4,90,194,24,308
1106507,3,7,10,53,21,6,80,209,28,317
1106508,12,0,12,67,27,3,97,255,33,385
1106509,6,0,6,69,31,3,103,248,25,376
1106510,6,0,6,42,22,0,64,163,8,235
1106511,6,0,6,79,33,0,112,254,33,399
1106512,23,0,23,51,15,6,72,222,28,322
1106513,3,4,7,53,20,0,73,179,25,277
1106514,0,4,4,43,12,0,55,172,16,243
1106515,20,3,23,60,27,0,87,320,39,446
1106516,0,0,0,37,18,0,55,100,6,161
1106517,3,0,3,31,11,0,42,94,6,142
1106518,8,0,8,46,15,0,61,152,9,222
1106519,3,3,6,60,16,0,76,135,14,225
1106520,0,0,0,51,16,3,70,126,6,202
1106521,0,3,3,49,13,0,62,118,27,207
1106522,0,0,0,40,26,0,66,92,7,165
1106523,53,3,56,32,19,0,51,239,21,311
1106524,3,0,3,35,6,0,41,96,7,144
1106525,4,0,4,40,3,0,43,111,16,170
1106526,6,0,6,49,38,6,93,253,31,377
1106527,3,0,3,51,16,3,70,137,14,221
1106528,14,3,17,67,22,3,92,199,23,314
1106529,3,0,3,20,18,0,38,178,10,226
1106601,5,7,12,29,6,0,35,109,32,176
1106602,0,0,0,31,10,0,41,102,6,149
1106603,6,0,6,39,15,0,54,136,21,211
1106604,8,3,11,66,9,6,81,200,24,305
1106605,16,3,19,52,23,0,75,205,27,307
1106606,0,0,0,31,15,3,49,121,3,173
1106607,8,4,12,35,44,0,79,214,35,328
1106608,20,0,20,24,4,7,35,113,12,160
1106609,5,0,5,33,9,0,42,145,13,200
1106610,3,0,3,39,13,4,56,173,21,250
1106611,0,0,0,48,15,0,63,177,23,263
1106612,3,0,3,50,21,0,71,185,22,278
1106613,0,3,3,34,10,3,47,107,18,172
1106701,9,0,9,51,16,6,73,201,41,315
1106702,3,0,3,58,28,9,95,208,9,312
1106703,4,0,4,53,29,6,88,185,15,288
1106704,0,0,0,27,12,3,42,103,14,159
1106705,3,3,6,52,23,5,80,143,15,238
1106706,0,0,0,54,25,9,88,106,10,204
1106707,0,0,0,56,12,6,74,100,33,207
1106708,8,3,11,88,24,13,125,214,15,354
1106709,0,0,0,53,26,9,88,185,26,299
1106710,3,0,3,86,35,16,137,265,27,429
1106711,6,8,14,43,9,0,52,126,54,232
1106712,51,8,59,59,31,0,90,314,52,456
1106713,6,0,6,60,20,0,80,157,25,262
1106714,4,0,4,60,19,4,83,182,38,303
1106715,6,3,9,103,22,4,129,261,55,445
1106716,0,11,14,49,35,6,90,177,24,291
1106717,25,3,28,37,16,3,56,149,21,226
1106718,4,0,4,72,23,3,98,169,26,293
1106719,6,3,9,63,12,0,75,182,60,317
1106720,7,3,10,61,13,0,74,168,36,278
1106721,0,0,0,37,12,3,52,103,26,181
1106722,6,3,12,48,12,3,63,133,21,217
1106723,6,0,6,83,31,4,118,218,25,361
1106724,6,0,9,48,26,6,80,188,21,289
1106725,0,0,0,48,21,3,72,102,16,190
1106726,0,0,0,64,33,3,100,185,16,301
1106727,6,0,6,63,26,3,92,189,51,332
1106728,8,0,8,22,9,0,31,111,15,157
1106729,52,4,56,82,35,0,117,337,38,492
1106801,0,4,4,38,15,0,53,100,15,168
1106802,4,0,4,46,19,3,68,130,11,209
1106803,12,0,12,30,12,0,42,173,21,236
1106804,3,3,6,21,12,0,33,115,16,164
1106805,12,0,12,58,23,0,81,212,27,320
1106806,0,0,0,44,17,3,64,132,15,211
1106807,0,0,0,49,21,0,70,144,18,232
1106808,3,0,3,68,31,6,105,173,26,304
1106809,14,0,14,53,25,0,78,213,34,325
1106810,0,0,0,54,22,3,79,160,30,269
1106811,0,0,0,52,21,9,82,151,14,247
1106901,4,0,4,47,10,5,62,113,7,182
1106902,4,0,4,82,47,0,129,273,24,426
1106903,0,0,0,30,13,0,43,98,12,153
1106904,0,0,0,63,22,3,88,186,25,299
1106905,0,0,0,45,10,3,58,59,3,120
1106906,6,0,6,51,24,0,75,157,13,245
1106907,6,0,6,50,23,3,76,154,14,244
1106908,5,6,11,45,14,3,62,107,12,181
1106909,0,0,0,39,12,0,51,77,10,138
1106910,3,0,3,61,17,3,81,142,6,229
1106911,0,0,0,25,13,0,38,115,17,170
1106912,9,0,9,48,24,0,72,158,24,254
1106913,3,0,3,43,19,3,65,128,11,204
1106914,10,3,13,60,23,3,86,224,32,342
1106915,13,4,17,49,16,0,65,208,27,300
1106916,21,7,28,39,22,7,68,232,28,328
1106917,7,0,7,33,23,0,56,145,22,223
1106918,32,0,32,49,7,4,60,156,12,228
1106919,4,0,4,61,24,0,85,200,25,310
1107001,6,0,6,94,30,3,127,189,14,330
1107002,0,0,0,15,18,0,33,33,3,69
1107003,9,0,9,77,32,10,119,363,60,542
1107004,0,0,0,13,15,0,28,73,3,104
1107005,59,0,59,77,32,0,109,400,35,544
1107006,3,3,6,63,29,0,92,307,36,435
1107007,4,0,4,23,19,0,42,134,26,202
1107008,16,12,28,38,3,0,41,66,38,145
1107009,0,0,0,0,0,0,0,0,0,0
1107010,5,5,10,69,25,5,99,234,21,354
1107011,8,0,8,52,27,10,89,271,28,388
1107012,7,3,10,64,30,0,94,208,28,330
1107013,6,0,6,50,21,6,77,185,18,280
1107014,4,0,4,84,23,6,113,206,14,333
1107015,5,0,5,54,37,6,97,239,25,361
1107016,5,4,9,50,21,3,74,202,12,288
1107017,3,0,3,58,24,0,82,139,0,221
1107018,14,0,14,84,47,0,131,277,40,448
1107019,8,3,11,68,20,3,91,285,55,431
1107020,7,3,10,54,41,0,95,244,36,375
1107021,3,0,3,77,38,6,121,257,89,467
1107022,12,6,18,38,18,7,63,120,36,219
1107023,11,6,17,62,32,0,94,260,51,405
1107024,0,0,0,32,21,4,57,124,12,193
1107025,0,0,0,40,14,0,54,145,4,203
1107026,0,0,0,46,25,0,71,131,12,214
1107027,9,4,13,94,48,11,153,304,45,502
1107028,5,8,13,73,43,4,120,253,38,411
1107029,15,0,15,59,25,0,84,197,12,293
1107030,3,3,6,56,20,0,76,132,12,220
1107031,0,0,0,0,0,0,0,0,316,316
1107032,5,0,5,72,36,3,111,281,31,423
1107101,3,4,7,25,10,0,35,141,10,186
1107102,6,0,6,42,16,3,61,143,18,222
1107103,6,0,6,52,22,0,74,175,15,264
1107104,0,0,0,39,12,4,55,103,6,164
1107105,3,0,3,49,18,0,67,122,10,199
1107106,7,0,7,98,40,6,144,230,21,395
1107107,0,3,3,75,26,7,108,271,51,430
1107108,0,0,0,41,13,0,54,111,24,189
1107109,0,0,0,30,12,0,42,133,3,178
1107110,0,0,0,60,16,5,81,157,14,252
1107111,0,0,0,30,12,0,42,122,30,194
1107112,4,0,4,42,20,6,68,165,20,253
1107113,3,0,3,42,13,0,55,173,14,242
1107114,3,0,3,43,9,6,58,129,19,206
1107115,0,0,0,44,23,0,67,153,17,237
1107116,3,0,3,54,26,0,80,161,39,280
1107117,0,0,0,41,36,0,77,205,9,291
1107118,0,0,0,0,0,0,0,0,0,0
1107119,0,0,0,58,16,0,74,124,6,204
1107120,3,0,3,61,17,6,84,139,15,238
1107121,0,0,0,30,15,0,45,91,6,142
1107122,7,7,14,46,15,4,65,224,31,320
1107123,0,0,0,29,6,3,38,90,14,142
1107124,6,9,15,42,21,0,63,223,36,322
1107125,0,0,0,30,21,3,54,97,0,151
1107126,0,0,0,16,0,0,16,60,15,91
1107127,0,0,0,40,18,0,58,156,8,222
1107128,0,3,3,42,19,0,61,217,36,314
1107201,53,3,56,34,27,6,67,242,20,329
1107202,0,0,0,67,14,3,84,202,37,323
1107203,5,0,5,36,15,3,54,137,18,209
1107204,7,14,21,69,15,0,84,182,71,337
1107205,15,5,20,47,23,4,74,267,44,385
1107206,6,0,6,58,18,6,82,136,18,236
1107207,6,0,6,21,24,3,48,73,6,127
1107208,14,10,24,69,36,3,108,312,49,469
1107209,5,0,5,34,15,3,52,199,15,266
1107210,61,6,67,51,14,0,65,254,74,393
1107211,9,0,9,98,28,0,126,285,26,437
1107212,0,0,0,54,22,0,76,139,14,229
1107213,0,0,0,216,37,11,264,306,30,600
1107214,0,0,0,63,18,4,85,142,9,236
1107215,0,0,0,62,16,3,81,171,25,277
1107216,3,3,6,90,25,9,124,201,27,352
1107217,6,0,6,100,22,6,128,284,20,432
1107218,3,3,6,63,17,4,84,230,15,329
1107219,18,3,21,107,31,0,138,312,43,493
1107220,11,3,14,68,28,0,96,247,39,382
1107221,7,0,7,41,25,3,69,213,24,306
1107222,4,0,4,38,12,0,50,94,9,153
1107223,4,0,4,143,32,6,181,291,64,536
1107224,3,0,3,89,31,0,120,232,39,391
1107301,0,0,0,0,0,0,0,0,0,0
1107302,0,0,0,30,27,3,60,144,9,213
1107303,3,6,9,65,17,0,82,211,28,321
1107304,10,3,13,29,9,0,38,154,15,207
1107305,3,6,9,31,7,4,42,110,15,167
1107306,3,0,3,34,12,3,49,135,12,196
1107307,9,0,9,44,11,0,55,214,26,295
1107308,16,0,16,41,8,0,49,172,17,238
1107309,0,0,0,41,0,0,41,94,5,140
1107310,3,0,3,41,13,0,54,172,21,247
1107311,0,0,0,25,5,0,30,124,18,172
1107312,0,0,0,33,14,0,47,125,10,182
1107313,0,0,0,24,4,0,28,76,17,121
1107314,5,0,5,40,6,0,46,172,13,231
1107401,0,0,0,38,17,3,58,112,14,184
1107402,0,0,0,51,8,6,65,142,24,231
1107403,22,3,25,84,30,6,120,232,21,373
1107404,0,0,0,75,18,3,96,220,31,347
1107405,9,5,14,35,36,6,77,255,52,384
1107406,3,0,3,26,0,0,26,115,12,153
1107407,0,4,4,63,22,3,88,153,28,269
1107408,0,0,0,32,15,3,50,134,12,196
1107409,0,0,0,62,15,3,80,288,84,452
1107410,3,3,6,21,7,0,28,156,38,222
1107411,4,3,7,67,28,0,95,192,9,296
1107412,3,3,6,83,18,9,110,202,41,353
1107413,7,6,13,65,28,3,96,233,41,370
1107414,3,0,3,82,26,6,114,228,22,364
1107415,7,0,7,69,20,6,95,267,38,400
1107416,0,0,0,80,15,0,95,233,20,348
1107417,3,3,6,48,7,3,58,138,31,227
1107418,0,0,0,52,22,0,74,178,16,268
1107419,0,0,0,54,29,0,83,166,37,286
1107420,3,0,3,63,18,0,81,248,26,355
1107421,3,0,3,72,22,0,94,211,23,328
1107422,3,0,3,68,12,3,83,206,15,304
1107423,10,0,10,39,13,0,52,218,18,288
1107424,6,3,9,56,38,3,97,257,24,378
1107425,3,3,6,49,23,0,72,278,35,385
1107426,17,0,17,33,17,3,53,180,28,261
1107501,0,0,0,0,0,0,0,0,0,0
1107601,0,0,0,30,17,0,47,152,9,208
1107602,3,0,3,48,12,3,63,78,25,166
1107603,4,0,4,86,30,6,122,213,49,384
1107604,3,3,6,42,25,12,79,145,26,250
1107605,4,0,4,79,24,0,103,174,30,307
1107606,30,4,34,85,34,0,119,274,26,419
1107607,0,3,3,46,10,0,56,162,26,244
1107608,6,0,6,77,31,0,108,211,10,329
1107609,4,0,4,61,4,3,68,139,14,221
1107610,4,0,4,64,18,6,88,136,27,251
1107611,12,0,12,32,13,0,45,132,12,189
1107612,0,3,3,28,12,3,43,117,24,184
1107613,3,0,3,38,9,0,47,122,12,181
1107614,0,0,0,66,20,0,86,167,23,276
1107615,0,0,0,88,22,6,116,215,9,340
1107616,0,0,0,90,27,0,117,202,21,340
1107617,5,0,5,68,23,6,97,245,36,378
1107618,6,0,6,26,10,0,36,108,35,179
1107619,3,0,3,47,9,0,56,118,33,207
1107620,6,0,6,27,9,3,39,95,9,143
1107621,0,0,0,49,25,0,74,160,3,237
1107701,8,4,12,54,28,3,85,146,17,248
1107702,104,0,107,50,24,0,74,349,27,450
1107703,12,0,12,51,30,6,87,191,11,289
1107704,3,3,6,49,11,0,60,152,28,240
1107705,24,4,28,12,12,3,27,145,30,202
1107706,28,8,36,26,17,0,43,165,26,234
1107707,22,0,22,57,34,0,91,296,35,422
1107708,10,3,13,87,41,4,132,274,24,430
1107709,7,3,10,54,35,3,92,176,12,280
1107710,0,0,0,42,44,0,86,203,9,298
1107711,14,5,19,73,35,0,108,245,56,409
1107712,5,0,5,37,18,0,55,115,10,180
1107713,11,0,11,76,26,4,106,310,31,447
1107714,6,3,9,48,24,0,72,190,18,280
1107715,6,3,9,76,39,0,115,183,33,331
1107716,0,0,0,90,37,6,133,197,36,366
1107717,6,0,6,83,36,6,125,173,9,307
1107718,7,3,10,76,38,0,114,237,24,375
1107719,7,0,7,67,24,0,91,229,15,335
1107720,6,0,6,42,29,4,75,246,41,362
1107721,8,0,8,51,15,0,66,189,13,268
1107722,0,0,0,42,28,9,79,113,24,216
1107723,6,0,6,69,22,10,101,248,31,380
1107724,45,4,49,32,15,3,50,152,14,216
1107725,0,0,0,37,15,0,52,113,22,187
1107726,18,8,29,71,36,3,110,252,29,391
1107727,7,0,7,74,19,3,96,190,20,306
1107728,3,0,3,70,39,4,113,195,18,326
1107729,0,3,6,62,44,0,106,184,26,316
1107730,7,6,13,58,28,0,86,220,31,337
1107731,16,3,19,77,40,6,123,286,31,440
1107732,0,0,0,35,16,4,55,116,15,186
1107733,6,3,9,48,13,3,64,255,39,358
1107734,3,0,3,33,14,0,47,133,19,199
1107735,0,0,0,0,0,0,0,0,0,0
1107736,0,0,0,14,14,0,28,60,6,94
1107737,4,0,4,30,31,3,64,108,5,177
1107738,0,0,0,27,6,3,36,112,12,160
1107739,4,0,4,6,3,3,12,75,63,150
1107740,8,0,8,98,55,6,159,282,26,467
1107741,16,3,19,17,18,4,39,158,15,212
1107742,3,0,3,41,20,8,69,172,18,259
1107743,6,0,6,31,7,0,38,147,31,216
1107744,7,3,10,38,18,0,56,219,22,297
1107745,5,0,5,50,17,3,70,186,14,270
1107746,9,3,12,75,28,4,107,223,33,363
1107747,0,0,0,49,23,9,81,144,44,269
1107748,4,0,4,64,19,3,86,157,23,266
1107749,0,0,0,35,10,0,45,127,40,212
1107750,0,0,0,65,24,6,95,204,56,355
1107751,0,0,0,45,18,9,72,168,42,282
1107752,3,0,3,98,17,5,120,187,97,404
1107753,5,0,5,52,18,3,73,190,29,292
1107754,11,0,11,83,50,4,137,198,12,347
1107801,4,5,9,63,29,0,92,167,14,273
1107802,0,3,3,43,10,9,62,129,18,209
1107803,6,4,10,137,32,5,174,236,22,432
1107804,11,0,11,66,29,3,98,190,21,309
1107805,11,0,11,52,18,6,76,211,21,308
1107806,8,0,8,95,25,3,123,292,29,444
1107807,0,0,0,77,25,0,102,138,11,251
1107808,6,0,6,89,20,0,109,194,46,349
1107809,0,0,0,35,3,3,41,82,6,129
1107810,0,0,0,52,22,0,74,116,6,196
1107811,4,0,4,57,14,9,80,106,14,200
1107812,3,0,3,77,23,7,107,137,43,287
1107813,0,0,0,50,13,6,69,67,6,142
1107814,0,0,0,61,5,5,71,196,16,283
1107815,3,0,3,60,31,3,94,213,15,322
1107816,0,0,0,86,25,0,111,118,4,233
1107817,4,0,4,120,37,7,164,298,18,480
1107818,0,0,0,135,27,6,168,189,24,381
1107819,6,3,9,59,22,6,87,142,18,247
1107820,0,0,0,45,20,3,68,128,13,209
1107821,3,0,3,43,12,0,55,103,4,162
1107822,0,3,3,115,35,8,158,221,17,396
1107823,3,3,6,49,27,3,79,169,6,254
1107824,7,6,13,67,32,6,105,235,30,370
1107825,27,6,33,57,16,0,73,191,15,279
1107826,3,0,3,117,19,4,140,171,7,318
1107827,0,0,0,139,36,3,178,212,20,410
1107828,3,3,6,90,28,9,127,243,29,399
1107829,13,0,13,45,32,3,80,265,27,372
1107830,6,4,10,83,47,3,133,256,14,403
1107831,0,0,0,59,35,0,94,229,6,329
1107832,0,0,0,287,63,20,370,616,81,1067
1107833,3,0,3,126,25,14,165,185,15,365
1107834,0,0,0,137,33,10,180,224,12,416
1107835,6,0,6,72,37,0,109,231,12,352
1107836,0,0,0,88,21,9,118,124,15,257
1107837,3,0,3,47,13,0,60,187,93,340
1107838,0,0,0,47,23,0,70,114,29,213
1107839,6,0,6,58,19,0,77,169,27,273
1107901,3,0,3,42,11,0,53,141,21,215
1107902,0,0,0,56,12,3,71,181,8,260
1107903,3,0,3,54,18,6,78,150,7,235
1107904,21,4,25,71,23,6,100,212,22,334
1107905,4,0,4,31,20,0,51,158,24,233
1107906,0,0,0,27,12,3,42,84,6,132
1107907,0,0,0,53,13,6,72,164,13,249
1107908,3,3,6,57,21,0,78,160,18,256
1107909,6,6,12,47,14,6,67,124,6,197
1107910,3,3,6,29,18,0,47,94,11,152
1107911,0,0,0,52,25,3,80,129,12,221
1107912,4,0,4,55,15,0,70,110,12,192
1107913,0,0,0,73,20,0,93,232,8,333
1107914,6,0,6,53,18,0,71,176,20,267
1107915,0,0,0,47,19,4,70,167,10,247
1107916,0,0,0,42,15,4,61,109,12,182
1107917,3,0,3,52,10,4,66,100,14,180
1107918,3,3,6,52,20,0,72,110,25,207
1107919,6,3,9,58,32,3,93,152,6,251
1107920,4,0,4,35,11,4,50,123,10,183
1107921,12,0,12,44,14,3,61,170,13,244
1107922,0,0,0,58,35,3,96,188,12,296
1107923,0,0,0,30,5,3,38,81,0,119
1107924,4,0,4,107,39,3,149,230,24,403
1107925,3,0,3,98,30,10,138,289,10,437
1107926,3,0,3,29,4,6,39,63,6,108
1107927,0,0,0,59,27,5,91,178,14,283
1107928,0,0,0,77,10,6,93,129,18,240
1107929,0,3,3,82,27,3,112,245,19,376
1107930,0,0,0,76,46,0,122,219,7,348
1107931,0,0,0,35,6,3,44,75,4,123
1107932,3,0,3,39,17,0,56,117,9,182
1107933,0,0,0,26,3,0,29,43,0,72
1107934,3,0,3,66,24,0,90,155,13,258
1107935,0,0,0,42,16,0,58,120,12,190
1107936,7,0,7,58,34,0,92,200,14,306
1108001,8,0,8,61,14,7,82,186,16,284
1108002,0,0,0,12,0,0,12,28,3,43
1108003,27,0,27,40,21,3,64,170,18,252
1108004,0,0,0,0,0,0,0,22,6,28
1108005,6,4,10,35,15,0,50,131,36,217
1108006,0,3,3,73,18,0,91,166,16,273
1108007,0,4,4,69,34,0,103,243,43,389
1108008,4,3,7,33,12,0,45,155,53,253
1108009,6,0,6,60,11,6,77,176,28,281
1108010,15,4,19,69,36,0,105,260,27,392
1108011,9,0,9,59,23,0,82,199,37,318
1108012,14,0,14,69,26,0,95,290,42,427
1108013,0,0,0,16,4,3,23,64,9,96
1108014,4,0,4,57,24,0,81,145,53,279
1108015,6,0,6,80,41,3,124,257,18,399
1108016,0,3,6,58,29,0,87,158,7,252
1108017,4,3,7,77,41,0,118,249,28,395
1108018,37,3,40,38,17,0,55,241,31,327
1108019,4,0,4,66,47,6,119,240,45,404
1108020,12,7,19,55,35,3,93,187,29,309
1108021,4,0,4,62,17,4,83,134,19,236
1108022,0,5,5,41,19,7,67,163,20,250
1108023,21,10,31,29,31,9,69,197,39,305
1108024,16,6,22,37,13,0,50,166,23,239
1108025,11,0,11,55,39,3,97,257,21,375
1108026,0,0,0,0,0,0,0,0,240,240
1108027,11,0,11,66,29,6,101,187,20,308
1108028,7,0,7,48,21,9,78,202,7,287
1108029,3,0,3,76,43,9,128,235,17,380
1108030,5,0,5,90,41,6,137,215,14,366
1108031,19,0,19,42,31,3,76,252,29,357
1108032,16,0,16,25,18,3,46,187,18,251
1108033,6,3,9,51,47,0,98,218,12,328
1108034,5,6,11,40,26,4,70,212,18,300
1108035,3,0,3,58,24,0,82,199,14,295
1108036,0,0,0,27,5,0,32,85,12,129
1108037,9,3,12,56,23,15,94,175,39,308
1108038,5,0,5,31,26,3,60,153,13,226
1108039,7,0,7,86,33,6,125,188,14,327
1108040,6,0,6,95,44,4,143,251,19,413
1108041,82,3,85,53,29,0,82,291,30,403
1108042,7,0,7,47,18,9,74,159,19,252
1108043,4,3,7,65,28,6,99,220,17,336
1108044,6,4,10,100,30,6,136,249,20,405
1108045,4,3,7,96,36,6,138,333,48,519
1108046,42,0,42,41,6,0,47,221,20,288
1108047,10,3,13,48,19,3,70,126,20,216
1108048,10,4,14,57,26,3,86,184,13,283
1108049,0,0,0,27,15,0,42,110,16,168
1108050,19,0,19,46,24,0,70,239,17,326
1108051,0,0,0,0,0,0,0,0,0,0
1108101,0,0,0,39,16,0,55,156,25,236
1108102,17,0,17,47,18,9,74,257,32,363
1108103,0,3,3,30,0,0,30,158,15,203
1108104,3,0,3,26,9,0,35,90,21,146
1108105,0,0,0,57,20,6,83,148,23,254
1108106,3,0,3,45,3,0,48,182,16,246
1108107,0,0,0,39,10,0,49,133,11,193
1108108,6,0,6,64,14,4,82,188,23,293
1108109,0,0,0,47,8,6,61,160,20,241
1108110,0,0,0,34,23,0,57,140,22,219
1108111,0,0,0,0,0,0,0,0,0,0
1108112,0,3,3,45,12,3,60,160,13,233
1108113,5,0,5,41,28,0,69,208,18,295
1108114,6,0,6,85,9,0,94,240,21,355
1108115,0,0,0,34,29,6,69,132,14,215
1108116,0,0,0,40,18,0,58,108,6,172
1108117,5,4,9,59,23,6,88,161,4,253
1108118,0,0,0,54,12,3,69,154,6,229
1108119,0,0,0,23,6,3,32,109,16,157
1108120,3,4,7,48,21,6,75,225,32,332
1108121,3,3,6,29,15,3,47,228,23,298
1108122,0,0,0,39,13,0,52,149,15,216
1108123,0,0,0,36,16,0,52,173,25,250
1108124,0,4,4,53,27,6,86,209,20,315
1108125,0,0,0,27,14,0,41,123,12,176
1108126,0,0,0,39,9,6,54,82,9,145
1108127,4,0,4,26,15,0,41,99,4,144
1108128,0,0,0,45,21,0,66,170,7,243
1108129,0,0,0,39,17,9,65,153,8,226
1108130,7,3,10,45,26,3,74,190,26,290
1108131,3,0,3,41,17,8,66,196,20,282
1108132,6,0,6,43,25,0,68,203,7,278
1108133,0,0,0,36,22,0,58,149,18,225
1108134,3,0,3,104,36,0,140,255,36,431
1108135,6,0,6,100,32,9,141,250,20,411
1108136,0,4,4,60,21,3,84,228,34,346
1108137,0,0,0,24,10,8,42,142,18,202
1108138,0,0,0,33,14,4,51,138,6,195
1108139,0,0,0,46,23,0,69,151,9,229
1108140,3,0,3,46,20,0,66,126,7,199
1108141,0,0,0,44,18,0,62,92,0,154
1108142,0,3,3,60,31,9,100,165,10,275
1108143,3,0,3,62,29,0,91,186,6,283
1108144,0,0,0,51,16,0,67,185,20,272
1108145,4,0,4,45,20,6,71,169,37,277
1108146,6,4,10,53,31,0,84,225,18,327
1108147,3,0,3,52,10,0,62,207,15,284
1108148,7,0,7,9,12,0,21,99,9,129
1108149,4,3,7,27,13,0,40,117,9,166
1108150,0,0,0,23,18,0,41,138,3,182
1108201,0,0,0,13,0,0,13,15,3,31
1108202,7,8,15,37,11,5,53,176,28,257
1108203,15,0,15,85,26,0,111,330,38,479
1108204,61,15,76,85,32,5,122,454,54,630
1108205,13,0,13,42,19,4,65,218,20,303
1108206,0,0,0,6,6,0,12,31,0,43
1108207,0,0,0,91,28,5,124,324,25,473
1108208,4,0,4,26,8,0,34,113,12,159
1108209,0,0,0,20,17,3,40,122,14,176
1108210,0,0,0,0,3,0,3,6,0,9
1108211,7,0,7,45,20,0,65,261,23,349
1108212,4,0,4,48,13,6,67,197,18,282
1108213,3,0,3,63,21,6,90,188,10,288
1108214,4,0,4,43,25,4,72,203,8,283
1108215,74,6,80,49,36,6,91,343,29,463
1108216,37,3,40,39,31,0,70,234,28,332
1108217,8,0,8,23,18,0,41,123,13,177
1108218,5,0,5,40,17,3,60,130,6,196
1108219,5,0,5,51,22,0,73,201,10,284
1108220,7,0,7,25,7,0,32,119,21,172
1108221,12,3,18,38,29,3,70,302,46,418
1108222,19,8,27,23,18,9,50,323,38,411
1108223,3,0,3,43,10,0,53,78,6,137
1108224,6,0,6,54,14,3,71,199,18,288
1108225,3,3,6,28,15,6,49,96,23,168
1108226,10,0,10,36,30,0,66,165,19,250
1108227,5,0,5,34,28,3,65,204,17,286
1108228,3,5,8,28,12,0,40,212,33,285
1108229,0,0,0,34,22,0,56,206,18,280
1108230,0,0,0,58,28,11,97,197,18,312
1108231,7,3,10,54,33,0,87,172,18,277
1108232,12,0,12,59,35,0,94,307,22,423
1108233,11,0,11,86,18,0,104,368,36,508
1108234,6,0,6,92,30,6,128,217,16,361
1108235,0,0,0,53,21,3,77,152,18,247
1108236,0,0,0,0,0,0,0,11,0,11
1108237,12,3,15,52,26,0,78,303,21,402
1108238,5,3,8,83,18,4,105,239,36,380
1108239,0,0,0,43,17,4,64,109,3,176
1108240,7,0,7,77,24,6,107,236,31,374
1108241,8,3,11,59,28,0,87,279,18,384
1108242,10,3,13,37,18,0,55,188,21,264
1108243,16,0,16,34,23,0,57,301,37,395
1108244,8,6,14,36,23,0,59,392,62,513
1108245,0,4,4,77,30,4,111,198,23,332
1108301,4,0,4,99,37,4,140,214,12,366
1108302,0,0,0,32,9,7,48,111,10,169
1108303,0,3,3,93,25,9,127,187,9,323
1108304,3,0,3,60,25,3,88,105,10,203
1108305,17,5,22,64,24,12,100,208,12,320
1108306,5,0,5,30,24,6,60,78,0,138
1108307,11,0,11,63,20,6,89,161,11,261
1108308,3,0,3,46,29,3,78,151,4,233
1108309,0,0,0,58,26,4,88,159,16,263
1108310,3,0,3,68,24,4,96,189,9,294
1108311,0,3,3,41,11,4,56,110,12,178
1108312,3,0,3,49,22,6,77,143,13,233
1108313,36,0,36,55,23,9,87,183,16,286
1108314,3,0,3,61,31,3,95,245,13,353
1108315,4,0,4,51,21,7,79,183,7,269
1108316,18,5,23,46,14,0,60,185,22,267
1108317,3,0,3,84,15,3,102,158,15,275
1108401,0,0,0,59,12,0,71,104,12,187
1108402,0,0,0,0,0,0,0,0,0,0
1108403,0,0,0,53,17,3,73,253,59,385
1108404,6,0,6,53,32,3,88,238,27,353
1108405,0,0,0,43,5,6,54,113,21,188
1108406,6,0,6,68,24,0,92,126,6,224
1108407,5,3,8,66,26,0,92,221,23,336
1108408,9,0,9,34,21,6,61,165,12,238
1108409,6,0,6,81,27,0,108,269,30,407
1108410,7,3,10,45,33,3,81,190,12,283
1108411,6,0,6,22,7,3,32,108,3,143
1108412,6,0,6,47,10,4,61,110,8,179
1108413,0,0,0,88,19,0,107,235,26,368
1108414,10,4,14,68,35,6,109,269,38,416
1108415,6,0,6,65,23,3,91,269,27,387
1108416,8,3,11,77,24,6,107,157,21,285
1108417,4,0,4,46,27,4,77,167,4,248
1108418,8,0,8,56,22,0,78,184,33,295
1108419,7,0,7,61,36,3,100,201,18,319
1108420,0,0,0,21,5,0,26,104,12,142
1108421,0,0,0,62,24,3,89,211,21,321
1108422,4,0,4,28,13,0,41,101,13,155
1108423,6,3,9,21,17,0,38,119,15,172
1108424,0,0,0,26,14,0,40,133,21,194
1108425,6,3,9,50,8,6,64,149,12,225
1108426,8,0,8,66,26,3,95,244,35,374
1108427,0,5,5,98,30,9,137,222,36,395
1108428,24,0,24,49,10,0,59,166,15,240
1108429,8,3,11,42,22,0,64,191,53,308
1108430,0,0,0,98,43,3,144,183,6,333
1108431,11,0,11,69,38,6,113,269,26,408
1108432,3,6,9,35,17,3,55,166,25,246
1108433,11,4,15,61,34,4,99,369,34,502
1108434,9,6,15,28,18,0,46,158,26,230
1108435,5,0,5,41,21,0,62,207,39,308
1108436,9,3,12,66,21,3,90,300,63,453
1108437,8,6,14,81,24,0,105,426,64,595
1108438,5,0,5,72,25,8,105,204,16,325
1108439,0,0,0,99,31,6,136,263,22,421
1108440,7,3,10,67,37,8,112,201,24,337
1108441,28,39,67,40,10,0,50,156,76,282
1108442,8,0,8,22,16,4,42,161,13,216
1108443,7,3,10,76,31,10,117,219,26,362
1108444,19,5,24,92,29,11,132,260,26,418
1108501,0,0,0,0,0,0,0,0,0,0
1108502,14,65,79,59,17,4,80,197,104,381
1108503,0,0,0,3,0,0,3,18,3,24
1108504,6,0,6,56,26,0,82,185,14,281
1108505,3,0,3,65,25,0,90,178,25,293
1108506,8,0,8,47,28,3,78,174,18,270
1108507,37,5,42,41,19,3,63,243,42,348
1108508,9,8,17,35,19,0,54,178,51,283
1108509,3,0,3,23,23,0,46,111,11,168
1108510,41,3,44,75,32,3,110,307,38,455
1108511,32,33,65,43,16,0,59,133,65,257
1108512,68,5,73,55,20,0,75,299,42,416
1108513,3,0,3,61,20,3,84,139,6,229
1108514,4,0,4,69,15,0,84,179,16,279
1108515,11,4,15,26,21,3,50,164,14,228
1108516,4,0,4,38,16,3,57,159,15,231
1108517,8,0,8,73,32,6,111,244,16,371
1108518,5,0,5,50,37,3,90,191,17,298
1108519,6,3,9,60,13,6,79,150,21,250
1108520,3,0,3,3,3,0,6,62,8,76
1108521,0,0,0,0,0,0,0,15,3,18
1108522,0,0,0,6,0,0,6,9,0,15
1108523,4,0,4,36,8,0,44,136,19,199
1108524,64,3,67,34,17,4,55,355,18,428
1108525,0,0,0,39,24,6,69,238,16,323
1108526,3,4,7,27,18,0,45,138,17,200
1108527,6,0,6,63,39,0,102,350,40,492
1108528,11,3,14,55,28,0,83,246,38,367
1108529,6,0,9,78,31,3,112,289,20,421
1108530,13,4,17,25,19,3,47,208,44,299
1108531,8,4,12,49,30,4,83,235,31,349
1108601,3,0,3,51,22,6,79,214,18,311
1108602,3,0,3,40,25,6,71,101,6,178
1108603,0,0,0,54,22,3,79,120,16,215
1108604,6,0,6,40,14,6,60,143,9,212
1108605,0,0,0,47,12,0,59,126,16,201
1108606,0,0,0,26,12,0,38,81,0,119
1108607,0,0,0,36,7,0,43,108,16,167
1108608,0,3,3,68,18,5,91,144,15,250
1108609,3,0,3,73,21,0,94,207,12,313
1108610,0,0,0,46,17,0,63,82,6,151
1108611,0,0,0,57,4,0,61,171,21,253
1108612,3,0,3,40,6,0,46,134,26,206
1108613,0,0,0,61,18,6,85,158,20,263
1108701,0,0,0,27,10,0,37,100,15,152
1108702,0,0,0,37,8,3,48,126,32,206
1108703,0,0,0,40,23,3,66,157,32,255
1108704,6,3,9,37,9,4,50,107,11,168
1108705,3,3,6,30,21,3,54,97,18,169
1108706,6,0,6,29,16,9,54,111,9,174
1108707,26,0,26,28,13,4,45,144,12,201
1108708,6,0,6,30,9,6,45,107,8,160
1108709,7,0,7,62,34,0,96,243,36,375
1108710,7,0,7,42,19,5,66,126,12,204
1108711,3,0,3,46,8,3,57,130,4,191
1108712,0,0,0,21,13,3,37,113,0,150
1108713,5,0,5,60,16,0,76,146,24,246
1108801,0,0,0,0,0,0,0,0,0,0
1108802,6,3,9,136,23,3,162,309,21,492
1108803,3,0,3,73,15,0,88,191,16,295
1108804,0,0,0,53,12,0,65,149,3,217
1108805,0,0,0,45,10,4,59,89,12,160
1108806,3,0,3,80,25,9,114,181,8,303
1108807,0,0,0,0,0,0,0,0,0,0
1108808,6,0,6,75,22,6,103,231,19,353
1108809,3,0,3,46,8,3,57,204,30,291
1108810,4,3,7,44,27,6,77,169,18,264
1108811,8,0,8,78,26,0,104,309,26,439
1108812,6,0,9,83,28,0,111,282,22,415
1108813,0,0,0,83,28,3,114,184,27,325
1108814,6,0,6,53,14,11,78,189,16,283
1108815,0,7,7,78,14,12,104,267,19,390
1108816,0,0,0,59,24,0,83,198,18,299
1108817,3,0,3,97,18,6,121,231,6,358
1108818,3,0,3,101,31,6,138,259,9,406
1108819,6,0,6,59,17,4,80,178,32,290
1108820,3,3,6,97,32,6,135,343,57,535
1108901,3,0,3,58,19,6,83,156,19,258
1108902,3,6,9,94,39,9,142,301,28,471
1108903,0,0,0,33,19,3,55,134,15,204
1108904,3,0,3,63,21,9,93,249,21,363
1108905,0,0,0,98,37,3,138,256,27,421
1108906,5,0,5,40,28,4,72,148,30,250
1108907,0,0,0,27,17,0,44,85,0,129
1108908,7,0,7,117,38,10,165,360,24,549
1108909,87,16,103,12,7,0,19,262,50,331
1108910,7,6,13,47,11,3,61,159,30,250
1108911,4,0,4,95,37,9,141,278,23,442
1108912,4,3,7,77,15,6,98,219,21,338
1108913,0,0,0,0,0,0,0,4,0,4
1108914,6,3,9,119,25,11,155,226,24,405
1108915,3,3,6,68,22,9,99,206,15,320
1108916,0,0,0,64,24,0,88,159,6,253
1108917,10,0,10,72,9,11,92,208,23,323
1108918,3,0,3,59,17,3,79,133,0,212
1108919,9,6,15,46,25,0,71,193,32,296
1108920,4,0,4,37,12,3,52,103,6,161
1108921,3,3,6,76,29,0,105,149,28,282
1108922,0,0,0,42,17,4,63,155,6,224
1108923,0,0,0,72,34,5,111,241,43,395
1108924,3,0,3,101,26,0,127,223,28,378
1108925,3,0,3,31,12,3,46,133,14,193
1108926,32,3,35,30,28,0,58,270,35,363
1108927,0,0,0,0,0,0,0,0,0,0
1108928,3,0,3,64,29,0,93,191,13,297
1108929,5,3,8,68,23,6,97,208,21,326
1108930,6,3,9,61,24,4,89,170,25,284
1108931,11,0,11,46,24,6,76,100,12,188
1108932,7,0,10,56,33,6,95,253,9,357
1108933,5,0,5,80,24,0,104,220,23,347
1108934,4,0,4,72,21,6,99,222,29,350
1108935,3,4,7,85,21,0,106,207,18,331
1108936,3,3,6,0,3,0,3,34,14,51
1108937,0,0,0,24,11,0,35,117,20,172
1108938,0,0,0,0,0,0,0,16,0,16
1108939,12,0,12,70,17,0,87,159,25,271
1108940,6,5,11,39,16,0,55,214,26,295
1108941,8,3,11,39,8,4,51,155,21,227
1108942,0,3,3,0,0,0,0,6,3,9
1108943,5,0,5,60,22,3,85,215,24,324
1108944,5,0,5,51,21,3,75,221,27,323
1108945,12,0,12,56,29,6,91,186,9,286
1108946,12,3,15,80,41,8,129,293,43,465
1108947,5,3,8,41,28,0,69,203,15,287
1108948,6,0,6,66,33,6,105,254,33,392
1108949,12,0,12,54,18,3,75,228,5,308
1108950,0,0,0,54,24,0,78,250,7,335
1108951,4,0,4,71,25,7,103,166,0,269
1108952,0,0,0,25,12,4,41,59,6,106
1108953,0,0,0,0,0,0,0,0,0,0
1108954,4,0,4,50,24,9,83,164,7,254
1108955,3,0,3,47,10,4,61,172,13,246
1108956,0,0,0,40,23,6,69,170,9,248
1109001,11,3,14,48,25,0,73,192,18,283
1109002,0,0,0,0,0,0,0,0,0,0
1109003,5,0,5,43,7,8,58,166,18,242
1109004,6,0,6,38,16,7,61,158,11,230
1109005,4,0,4,21,6,0,27,78,6,111
1109006,4,3,7,44,5,4,53,257,21,331
1109007,14,0,14,36,20,6,62,234,14,310
1109008,20,3,26,31,29,3,63,274,35,372
1109009,0,0,0,59,37,0,96,149,19,264
1109010,6,0,6,45,7,0,52,201,29,282
1109011,8,0,8,38,10,0,48,187,13,248
1109012,0,3,3,39,18,3,60,99,10,169
1109013,9,0,9,44,25,6,75,272,19,366
1109014,4,3,7,35,21,5,61,168,15,244
1109015,4,0,4,68,43,0,111,219,9,339
1109101,6,0,6,110,41,4,155,301,31,487
1109102,3,0,3,60,24,0,84,203,22,309
1109103,5,0,5,52,26,0,78,187,15,280
1109104,0,7,7,108,35,0,143,287,29,459
1109105,9,0,9,52,34,5,91,251,25,367
1109106,7,0,7,40,20,6,66,201,15,282
1109107,6,0,6,71,21,6,98,257,12,367
1109108,6,0,6,51,11,6,68,181,12,261
1109109,0,0,0,61,16,4,81,203,19,303
1109110,0,0,0,74,9,7,90,146,24,260
1109111,9,0,9,70,32,6,108,224,15,347
1109112,9,0,9,114,28,6,148,300,13,461
1109113,0,0,0,54,15,6,75,141,34,250
1109114,6,0,6,15,9,0,24,162,18,204
1109115,3,0,3,35,9,3,47,121,15,183
1109116,0,0,0,57,13,0,70,112,13,195
1109117,0,0,0,0,0,0,0,0,0,0
1109118,5,0,5,25,12,6,43,200,21,264
1109119,0,3,3,183,37,9,229,384,54,667
1109120,22,10,32,56,33,0,89,365,57,511
1109121,0,3,3,41,9,6,56,160,18,234
1109122,16,4,20,20,40,0,60,367,48,475
1109123,6,0,6,73,21,3,97,241,34,372
1109124,6,0,6,97,37,6,140,248,38,426
1109125,3,3,6,52,9,0,61,166,18,245
1109126,57,5,62,49,19,4,72,295,27,394
1109127,14,0,14,60,26,3,89,245,29,363
1109128,9,3,12,30,9,6,45,211,24,280
1109201,6,0,6,74,20,3,97,256,94,447
1109202,4,0,4,74,29,3,106,233,39,378
1109203,3,0,3,32,3,3,38,82,24,144
1109204,0,5,5,79,17,3,99,160,57,316
1109205,0,0,0,43,0,0,43,93,11,147
1109206,0,0,0,0,0,0,0,50,0,50
1109207,3,0,3,60,18,3,81,242,30,353
1109208,4,3,7,59,13,0,72,177,31,280
1109209,3,3,6,41,15,0,56,162,36,254
1109210,3,0,3,33,6,3,42,70,3,115
1109211,0,0,3,41,18,0,59,113,52,224
1109212,0,0,0,42,15,8,65,132,56,253
1109213,0,3,3,23,24,3,50,134,48,232
1109301,0,0,0,11,5,0,16,42,0,58
1109302,3,0,3,73,26,0,99,162,17,278
1109303,0,0,0,54,23,4,81,148,29,258
1109304,6,3,9,72,14,3,89,291,37,417
1109305,0,0,0,62,20,0,82,188,24,294
1109306,3,0,3,28,19,0,47,136,43,226
1109307,7,3,10,57,10,0,67,174,24,265
1109308,0,0,0,46,7,9,62,103,21,186
1109309,4,0,4,91,31,0,122,167,32,321
1109310,0,0,0,86,12,3,101,182,40,323
1109311,18,0,18,41,19,4,64,182,24,270
1109312,0,0,0,21,12,0,33,78,12,123
1109313,3,3,6,57,27,0,84,181,33,298
1109314,0,0,0,69,13,0,82,227,30,339
1109401,0,0,0,46,16,0,62,140,33,235
1109402,19,0,19,26,10,3,39,146,24,209
1109403,5,0,5,38,16,0,54,203,27,284
1109404,4,0,4,32,13,0,45,149,8,202
1109405,3,3,6,22,3,3,28,120,3,151
1109406,3,0,3,64,18,0,82,129,10,221
1109407,0,0,0,51,7,3,61,108,23,192
1109408,0,0,0,48,15,0,63,120,12,195
1109409,0,0,0,27,6,0,33,133,12,178
1109410,3,4,7,52,10,6,68,221,22,311
1109411,3,0,3,44,15,0,59,204,50,313
1109412,9,3,15,55,19,0,74,200,28,302
1109413,6,0,6,48,12,0,60,132,22,214
1109414,7,0,7,43,23,0,66,242,23,331
1109501,3,0,3,40,23,0,63,142,22,227
1109502,3,0,3,39,7,0,46,110,26,182
1109503,8,0,8,106,21,4,131,265,39,435
1109504,3,0,3,59,13,3,75,146,27,248
1109505,8,0,8,104,34,0,138,276,18,432
1109506,3,0,3,31,19,6,56,108,6,170
1109507,3,0,3,41,15,3,59,120,50,229
1109508,23,3,26,94,35,6,135,272,52,459
1109509,4,0,4,36,25,6,67,126,12,205
1109510,0,0,0,50,19,3,72,153,28,253
1109511,18,0,18,43,27,6,76,271,28,375
1109512,3,0,3,25,25,3,53,146,23,222
1109513,3,0,3,75,25,5,105,274,38,417
1109514,5,3,8,27,21,0,48,125,18,191
1109515,0,0,0,0,0,0,0,0,0,0
1109601,0,0,0,20,5,0,25,230,55,310
1109602,5,0,5,64,24,4,92,192,22,306
1109603,0,3,3,20,9,0,29,60,10,99
1109604,0,0,0,24,8,0,32,106,6,144
1109605,0,0,0,12,4,0,16,77,5,98
1109606,0,0,0,29,9,3,41,68,36,145
1109607,0,0,0,26,6,0,32,97,33,162
1109608,0,0,0,9,4,0,13,21,8,42
1109609,0,0,0,15,5,0,20,46,3,69
1109610,0,0,0,51,15,3,69,90,20,179
1109611,0,0,0,50,24,3,77,142,43,262
1109612,0,3,6,45,22,0,67,149,47,263
1109613,6,0,6,31,27,0,58,106,22,186
1109614,0,0,0,57,11,0,68,138,21,227
1109615,7,0,7,85,32,9,126,226,27,379
1109616,0,0,0,23,3,0,26,119,3,148
1109617,0,0,0,27,13,0,40,115,3,158
1109618,6,3,9,52,15,3,70,228,33,331
1109619,3,0,3,12,15,0,27,180,70,277
1109620,3,3,6,37,9,4,50,125,36,211
1109621,9,0,9,26,22,8,56,198,48,302
1109622,6,3,9,44,15,7,66,300,67,433
1109623,0,0,0,57,14,5,76,212,36,324
1109624,6,6,12,43,28,0,71,213,18,302
1109701,0,0,0,34,9,3,46,155,29,230
1109702,3,0,3,33,14,0,47,114,22,183
1109703,7,3,10,32,25,0,57,173,29,259
1109704,3,12,15,5,12,0,17,109,135,261
1109705,41,0,41,44,13,0,57,238,39,334
1109706,14,3,17,47,23,3,73,228,27,328
1109707,0,4,4,51,16,3,70,161,24,255
1109708,3,6,9,30,18,6,54,144,33,231
1109709,6,3,9,50,19,0,69,149,21,239
1109710,0,0,0,7,7,0,14,24,0,38
1109711,6,0,6,23,11,0,34,144,10,188
1109712,6,3,9,48,26,0,74,204,37,315
1109713,6,0,9,69,35,3,107,237,32,376
1109714,8,0,8,70,22,5,97,223,37,357
1109715,6,0,6,45,31,0,76,192,16,284
1109716,0,0,0,28,11,0,39,132,33,204
1109717,3,4,7,54,37,0,91,205,19,315
1109718,6,0,6,49,25,3,77,179,19,275
1109719,4,3,7,60,26,9,95,282,26,403
1109720,8,3,11,47,14,5,66,204,26,296
1109721,8,3,11,48,24,0,72,223,29,324
1109722,6,0,6,44,30,0,74,183,25,282
1109723,3,3,6,58,27,9,94,208,25,327
1109724,13,0,13,78,35,6,119,258,21,398
1109725,5,3,8,71,28,0,99,230,20,349
1109726,0,0,0,38,13,0,51,109,29,189
1109727,0,3,3,24,16,3,43,102,33,178
1109728,8,0,8,70,23,6,99,207,35,341
1109729,3,3,6,45,27,0,72,219,37,328
1109730,0,0,0,77,21,3,101,219,20,340
1109731,3,3,6,31,11,0,42,115,24,181
1109732,3,4,7,29,12,0,41,106,19,166
1109733,4,0,4,44,30,0,74,164,39,277
1109734,8,3,11,65,31,3,99,249,23,371
1109735,7,26,33,53,25,0,78,174,82,334
1109736,0,0,0,38,13,0,51,97,24,172
1109737,9,3,12,72,24,9,105,175,39,319
1109738,3,13,16,63,26,6,95,232,64,391
1109739,3,3,6,49,6,3,58,184,40,282
1109740,7,0,7,67,37,0,104,237,87,428
1109741,4,0,4,52,18,0,70,177,31,278
1109742,13,6,19,50,28,3,81,254,69,404
1109743,7,0,7,40,31,4,75,198,31,304
1109744,82,0,82,43,31,0,74,323,36,433
1109745,0,3,3,64,23,0,87,241,31,359
1109746,0,3,3,56,28,0,84,210,41,335
1109747,8,6,14,73,31,3,107,258,53,418
1109748,5,3,8,53,29,3,85,181,25,291
1109749,3,6,9,48,19,0,67,187,33,287
1109750,0,0,0,72,26,3,101,182,7,290
1109751,6,0,6,65,37,0,102,221,46,369
1109752,0,0,0,9,6,0,15,47,9,71
1109801,0,0,0,9,4,0,13,67,12,92
1109802,3,3,6,45,21,0,66,258,49,373
1109803,0,0,0,44,14,0,58,107,12,177
1109804,0,0,0,52,18,3,73,124,12,209
1109805,0,0,0,38,3,0,41,87,9,137
1109806,3,0,3,46,9,0,55,154,11,220
1109807,0,0,0,58,9,0,67,252,25,344
1109808,4,0,4,27,10,5,42,91,0,133
1109809,0,0,0,24,18,0,42,107,0,149
1109810,0,0,0,26,18,0,44,73,47,164
1109811,0,0,0,48,21,6,75,78,0,153
1109901,0,3,3,38,15,3,56,143,25,224
1109902,16,0,16,68,11,6,85,247,46,378
1109903,9,3,12,60,29,3,92,257,64,413
1109904,54,10,64,58,23,6,87,290,59,436
1109905,8,0,8,33,18,3,54,146,12,212
1109906,0,0,0,29,22,0,51,122,11,184
1109907,8,0,12,23,16,0,39,176,15,230
1109908,6,0,6,41,12,0,53,143,21,217
1109909,6,0,6,23,7,3,33,79,15,127
1109910,7,0,7,41,13,0,54,152,22,228
1109911,5,0,5,16,13,0,29,98,4,131
1109912,5,0,5,44,6,9,59,124,13,196
1109913,13,0,13,51,18,0,69,135,15,219
1109914,11,0,11,38,11,0,49,141,10,200
1109915,3,0,3,26,15,0,41,144,13,198
1109916,6,3,9,95,38,9,142,287,29,458
1109917,6,0,6,19,6,0,25,67,6,98
1109918,0,0,0,14,10,0,24,85,21,130
1109919,5,0,5,48,15,0,63,105,14,182
1109920,3,3,6,74,24,0,98,204,22,324
1109921,0,0,0,39,16,0,55,150,18,223
1109922,6,0,6,33,0,4,37,75,6,118
1109923,4,3,7,45,12,0,57,186,15,258
1109924,0,0,0,53,21,0,74,124,22,220
1109925,0,0,0,51,3,3,57,76,8,141
1109926,7,0,7,38,16,3,57,161,12,230
1109927,0,0,0,16,6,3,25,72,6,103
1109928,7,3,10,52,18,0,70,173,49,292
1109929,3,0,3,20,9,9,38,79,19,136
1110001,3,0,3,58,46,6,110,239,23,372
1110002,3,0,3,46,26,9,81,124,25,230
1110003,0,0,0,42,19,3,64,165,9,238
1110004,0,0,0,66,26,12,104,217,27,348
1110005,0,3,3,112,31,4,147,204,15,366
1110006,3,0,3,130,30,7,167,229,34,430
1110007,0,0,0,74,35,3,112,186,9,307
1110008,0,0,0,53,18,0,71,123,29,223
1110009,3,0,3,65,27,18,110,146,22,278
1110010,4,0,4,37,16,16,69,71,13,153
1110011,3,3,6,53,22,4,79,230,59,368
1110012,3,3,9,43,22,7,72,136,24,232
1110013,4,0,4,42,28,3,73,167,27,267
1110014,36,0,36,34,15,4,53,201,29,283
1110015,56,9,65,65,47,3,115,350,46,511
1110016,0,0,0,58,45,0,103,181,12,296
1110017,0,0,0,118,20,10,148,250,38,436
1110018,11,0,11,67,40,0,107,252,22,381
1110019,3,0,3,44,20,4,68,145,16,229
1110020,3,0,3,97,22,6,125,144,7,276
1110021,0,0,0,24,15,6,45,78,10,133
1110022,7,3,10,75,50,9,134,248,35,417
1110023,0,0,0,62,10,0,72,134,12,218
1110024,3,0,3,65,27,6,98,242,17,357
1110025,3,5,8,61,29,4,94,208,8,310
1110026,5,0,5,68,31,3,102,252,8,362
1110027,0,0,0,103,28,3,134,183,27,344
1110101,121,6,130,16,13,0,29,364,34,427
1110102,8,0,8,74,51,6,131,285,16,432
1110103,7,0,7,82,39,6,127,238,15,380
1110104,6,0,6,71,27,0,98,167,9,274
1110105,3,0,3,150,38,9,197,232,23,452
1110106,0,0,0,46,11,9,66,120,9,195
1110107,0,0,0,100,44,6,150,265,29,444
1110108,8,6,14,51,18,6,75,218,23,316
1110109,9,0,9,65,35,6,106,179,17,302
1110110,6,3,9,43,12,6,61,210,32,303
1110111,0,0,0,50,27,0,77,167,24,268
1110112,3,0,3,67,21,7,95,144,14,253
1110113,6,3,9,58,22,9,89,146,12,247
1110114,6,0,6,70,27,3,100,159,4,263
1110115,7,3,10,92,17,5,114,247,40,401
1110116,0,0,0,45,13,5,63,102,14,179
1110117,28,5,33,59,20,0,79,165,19,263
1110118,19,7,26,78,43,3,124,277,50,451
1110119,7,0,7,90,38,3,131,293,30,454
1110120,10,0,10,77,27,4,108,292,14,414
1110121,4,0,4,121,38,9,168,240,23,431
1110122,12,0,12,17,24,6,47,147,18,212
1110123,0,0,0,86,49,6,141,247,23,411
1110124,24,5,29,60,7,3,70,198,15,283
1110125,8,0,8,70,22,3,95,177,14,286
1110126,0,0,0,51,15,0,66,150,9,225
1110127,6,0,6,72,33,0,105,212,19,336
1110128,11,3,14,66,45,3,114,248,30,392
1110129,7,3,10,89,46,8,143,233,14,390
1110130,7,3,10,42,37,6,85,250,30,365
1110131,0,3,3,179,46,10,235,226,18,479
1110132,4,3,7,83,27,3,113,193,18,324
1110133,4,6,10,58,26,4,88,118,21,227
1110134,7,0,7,74,53,6,133,330,14,477
1110135,7,5,12,59,25,0,84,197,39,320
1110136,3,0,3,41,24,5,70,248,42,360
1110137,3,0,3,16,10,0,26,90,37,153
1110201,0,3,3,82,29,0,111,192,21,324
1110202,4,3,7,54,20,0,74,178,21,273
1110203,6,0,6,48,15,0,63,148,19,230
1110204,0,0,0,58,21,6,85,196,27,308
1110205,3,0,3,108,29,0,137,205,13,355
1110206,3,0,3,65,18,0,83,165,18,266
1110207,6,0,6,52,20,6,78,193,18,289
1110208,0,0,0,57,29,0,86,184,24,294
1110209,3,3,6,47,22,0,69,144,29,242
1110210,0,0,0,47,7,3,57,81,9,147
1110211,3,0,3,46,24,6,76,176,24,276
1110212,3,3,6,130,42,9,181,275,38,494
1110213,4,0,4,88,38,6,132,243,19,394
1110214,3,0,3,54,41,0,95,235,21,351
1110215,0,4,4,156,49,9,214,291,33,538
1110216,7,0,10,171,59,7,237,320,27,584
1110217,0,3,3,24,14,0,38,88,13,139
1110218,0,0,0,9,6,3,18,18,3,39
1110301,3,0,6,41,29,6,76,110,12,198
1110302,6,0,6,40,21,6,67,89,15,171
1110303,0,0,0,53,29,0,82,180,15,277
1110304,0,0,0,72,10,0,82,157,21,260
1110305,6,0,6,43,20,0,63,127,18,208
1110306,4,0,4,70,11,0,81,143,10,234
1110307,0,0,0,61,23,3,87,214,15,316
1110308,0,0,0,25,11,0,36,39,9,84
1110309,0,0,0,40,18,6,64,111,19,194
1110310,0,0,0,51,16,0,67,102,22,191
1110311,0,0,0,100,43,3,146,173,48,367
1110312,0,0,0,38,15,0,53,86,5,144
1110313,6,0,6,37,14,3,54,128,15,197
1110314,6,0,6,31,13,0,44,117,22,183
1110315,0,0,0,27,9,0,36,90,21,147
1110316,6,0,6,40,31,4,75,225,56,356
1110317,3,0,3,65,43,0,108,254,41,403
1110318,0,3,3,22,23,4,49,94,12,155
1110401,4,5,9,65,27,4,96,263,17,376
1110402,8,0,8,70,30,0,100,300,37,437
1110403,5,0,5,37,3,0,40,127,6,173
1110404,0,0,0,23,10,0,33,104,0,137
1110405,0,0,0,64,9,0,73,125,15,213
1110406,3,0,3,61,24,4,89,169,41,299
1110407,0,0,0,42,18,0,60,142,33,235
1110408,3,0,3,27,3,0,30,54,9,93
1110409,8,3,11,51,22,3,76,198,34,308
1110410,6,0,6,42,27,6,75,135,28,238
1110411,33,26,59,36,19,0,55,201,46,302
1110412,5,0,5,44,17,0,61,156,15,232
1110413,0,0,0,49,19,6,74,143,25,242
1110414,0,0,0,0,0,0,0,0,0,0
1110415,3,0,3,6,5,0,11,62,0,73
1110416,3,0,3,46,21,0,67,146,15,228
1110501,4,0,4,37,25,6,68,135,22,225
1110502,0,0,0,53,34,4,91,168,27,286
1110503,3,10,13,41,16,6,63,162,43,268
1110504,14,3,17,59,28,3,90,271,24,385
1110505,3,0,3,85,32,12,129,210,19,358
1110506,0,0,0,55,24,0,79,148,20,247
1110507,20,0,20,39,20,0,59,170,18,247
1110508,7,0,10,54,32,9,95,154,19,268
1110509,6,3,9,72,35,5,112,278,64,454
1110510,6,3,9,35,20,4,59,126,22,207
1110511,0,0,0,22,11,3,36,75,18,129
1110512,3,0,3,56,27,6,89,248,29,366
1110513,9,0,9,78,19,8,105,240,28,373
1110514,0,0,0,20,9,0,29,81,0,110
1110515,6,0,6,132,48,0,180,259,33,472
1110516,0,0,0,43,23,0,66,186,21,273
1110517,0,3,3,68,26,9,103,180,18,301
1110518,0,0,0,36,9,0,45,65,9,119
1110601,0,0,0,11,4,0,15,28,0,43
1110602,0,0,0,12,18,0,30,43,3,76
1110603,0,0,0,12,3,0,15,15,3,33
1110604,0,0,0,25,4,0,29,90,29,148
1110605,35,0,38,51,24,0,75,249,41,365
1110606,6,0,6,52,32,3,87,243,37,367
1110607,6,0,10,51,28,3,82,248,44,374
1110608,3,3,9,31,20,0,51,160,24,235
1110609,0,3,3,76,34,0,110,259,41,410
1110610,0,0,0,38,15,3,56,95,21,172
1110611,3,0,3,72,22,6,100,166,9,275
1110612,18,0,18,34,12,0,46,169,18,233
1110613,6,0,6,18,9,0,27,65,6,98
1110614,6,0,6,83,36,0,119,244,15,378
1110615,4,0,4,77,31,0,108,200,29,337
1110616,3,0,3,75,20,6,101,142,476,719
1110617,3,3,6,73,34,4,111,206,32,349
1110618,6,3,9,78,25,0,103,256,19,378
1110619,6,3,9,60,22,5,87,191,34,312
1110620,5,0,5,46,21,0,67,164,9,240
1110621,28,3,31,47,42,0,89,235,25,349
1110622,0,0,0,30,5,0,35,150,32,217
1110623,11,3,14,71,21,3,95,274,60,429
1110624,6,0,6,61,31,0,92,195,25,312
1110701,0,0,0,119,23,0,142,206,39,387
1110702,4,0,4,101,33,0,134,241,10,385
1110703,4,0,4,73,33,0,106,163,12,281
1110704,3,0,3,61,27,3,91,193,24,308
1110705,0,0,0,51,20,0,71,171,23,265
1110706,4,0,4,40,44,3,87,159,13,259
1110707,0,0,0,41,33,0,74,217,28,319
1110708,0,0,0,53,41,6,100,169,8,277
1110709,6,0,6,39,20,3,62,157,12,231
1110710,3,0,3,65,15,6,86,122,21,229
1110711,0,0,0,64,19,6,89,136,19,244
1110712,3,0,3,93,17,3,113,178,17,308
1110713,5,0,5,48,24,3,75,119,14,208
1110714,3,0,3,111,21,7,139,214,26,379
1110715,6,0,6,72,19,4,95,266,16,377
1110716,0,0,0,129,36,4,169,251,24,444
1110717,3,0,3,30,20,3,53,119,12,184
1110718,0,0,0,48,16,0,64,103,6,173
1110719,0,0,0,38,23,4,65,100,3,168
1110720,3,0,3,101,36,0,137,178,27,342
1110721,0,0,0,205,46,18,269,254,19,542
1110722,3,0,3,65,27,6,98,189,11,298
1110723,4,0,4,127,41,8,176,274,30,480
1110801,8,4,12,66,42,0,108,286,58,452
1110802,6,0,6,161,41,11,213,320,67,600
1110803,0,0,0,27,0,0,27,61,12,100
1110804,0,0,0,0,0,0,0,0,466,466
1110805,3,0,3,103,40,12,155,257,17,429
1110806,3,5,8,37,24,9,70,167,22,259
1110807,3,0,3,93,25,4,122,186,49,357
1110808,7,3,10,68,34,0,102,192,32,326
1110809,3,0,3,52,25,3,80,98,6,184
1110810,6,0,6,77,29,0,106,172,28,306
1110811,4,0,4,48,36,3,87,211,28,326
1110812,23,0,23,52,34,6,92,240,45,377
1110813,60,6,66,52,21,6,79,268,27,374
1110814,3,0,3,26,14,0,40,95,15,150
1110815,3,0,3,43,23,3,69,125,12,206
1110816,7,3,10,66,32,12,110,212,32,354
1110817,0,0,0,61,46,8,115,205,15,335
1110818,112,3,115,0,0,0,0,305,12,317
1110819,0,3,3,77,44,3,124,209,20,353
1110820,0,4,4,72,36,0,108,215,29,352
1110821,12,0,12,55,36,0,91,184,21,296
1110822,3,0,3,113,28,0,141,247,34,422
1110823,0,0,0,31,16,3,50,78,9,137
1110824,6,0,6,34,10,0,44,89,12,145
1110825,0,0,0,92,37,3,132,230,28,390
1110826,3,0,3,37,14,0,51,93,10,154
1110827,0,0,0,6,6,3,15,29,4,48
1110828,0,0,0,0,0,0,0,0,0,0
1110829,3,0,3,66,28,6,100,172,32,304
1110830,6,6,12,112,59,7,178,292,53,523
1110831,3,0,3,40,21,0,61,111,15,187
1110832,3,0,3,59,34,0,93,170,37,300
1110833,8,0,8,50,26,0,76,152,14,242
1110834,4,3,7,48,34,0,82,226,59,367
1110835,3,0,3,22,26,3,51,96,24,171
1110836,8,0,8,114,39,6,159,282,29,470
1110837,16,7,23,75,43,7,125,346,39,510
1110838,6,0,6,51,28,0,79,159,6,244
1110839,6,0,6,62,33,4,99,135,17,251
1110840,0,0,0,59,23,0,82,147,21,250
1110841,0,0,0,66,13,8,87,169,36,292
1110842,3,0,3,75,35,0,110,149,23,282
1110843,0,0,0,47,35,0,82,208,11,301
1110844,9,3,12,65,28,3,96,165,25,286
1110845,66,15,81,49,34,3,86,312,47,445
1110846,3,0,3,67,20,0,87,127,34,248
1110847,3,6,9,128,59,7,194,259,67,520
1110848,3,0,3,40,0,3,43,110,15,168
1110849,6,0,6,62,35,3,100,259,35,394
1110850,4,0,4,65,44,3,112,205,24,341
1110851,0,0,0,55,26,9,90,187,35,312
1110852,0,0,0,52,14,0,66,100,24,190
1110853,5,3,8,78,21,3,102,218,26,346
1110901,0,0,0,66,18,0,84,124,6,214
1110902,3,0,3,52,8,0,60,125,6,191
1110903,3,0,3,53,18,3,74,168,21,263
1110904,3,4,7,50,8,0,58,86,12,156
1110905,4,0,4,64,34,0,98,175,12,285
1110906,0,0,0,49,38,12,99,154,14,267
1110907,0,0,0,55,18,3,76,95,6,177
1110908,3,0,3,66,14,0,80,154,24,258
1110909,5,0,5,83,24,6,113,222,36,371
1110910,0,0,0,80,19,9,108,131,19,258
1110911,0,0,0,45,11,4,60,121,3,184
1110912,3,0,3,50,25,4,79,175,23,277
1110913,0,0,0,40,27,0,67,139,15,221
1110914,4,0,4,60,56,0,116,192,12,320
1110915,6,3,9,35,33,0,68,165,6,239
1110916,0,0,0,86,25,0,111,215,27,353
1110917,3,0,3,30,26,6,62,134,6,202
1110918,3,0,3,36,21,0,57,119,7,183
1110919,0,0,0,40,27,3,70,114,29,213
1110920,3,0,3,40,21,3,64,223,22,309
1110921,0,0,0,20,8,0,28,91,15,134
1110922,7,0,7,61,26,0,87,212,20,319
1110923,4,0,4,31,10,5,46,106,3,155
1111001,0,0,0,31,11,0,42,107,3,152
1111002,6,0,6,95,29,6,130,267,25,422
1111003,0,0,0,59,25,4,88,138,15,241
1111004,30,0,30,17,12,6,35,146,17,198
1111005,3,0,3,49,17,3,69,131,4,204
1111006,8,0,8,37,31,3,71,153,9,233
1111007,19,3,22,60,35,6,101,268,24,393
1111008,8,0,8,24,28,0,52,146,15,213
1111009,7,0,7,48,27,6,81,183,33,297
1111010,11,3,14,43,21,0,64,138,18,220
1111011,3,0,3,77,29,0,106,217,12,335
1111012,0,0,0,52,28,9,89,173,15,277
1111013,3,0,3,24,9,3,36,95,9,140
1111014,8,0,8,37,21,0,58,174,30,262
1111015,3,0,3,32,18,0,50,132,10,192
1111016,0,0,0,29,13,3,45,130,3,178
1111017,0,0,0,53,15,3,71,123,21,215
1111018,6,3,9,36,19,0,55,122,18,195
1111019,6,0,6,36,24,3,63,172,3,238
1111020,4,0,4,55,17,0,72,174,19,265
1111021,0,0,0,55,24,0,79,182,4,265
1111022,9,0,9,40,17,5,62,176,18,256
1111023,3,0,3,67,16,6,89,196,11,296
1111024,0,0,0,58,8,6,72,148,7,227
1111025,3,0,3,23,16,6,45,150,8,203
1111026,3,0,3,31,26,3,60,126,4,190
1111027,4,0,4,87,34,0,121,258,63,442
1111101,3,6,9,80,44,5,129,244,27,400
1111102,8,0,8,33,24,7,64,137,11,212
1111103,0,3,3,39,11,0,50,108,23,181
1111104,3,3,6,30,7,0,37,107,28,172
1111105,3,0,3,66,19,9,94,187,32,313
1111106,3,0,3,54,17,0,71,148,13,232
1111107,0,0,0,32,15,6,53,107,15,175
1111108,8,0,8,62,28,3,93,228,26,347
1111109,8,3,11,54,21,0,75,151,11,237
1111110,3,3,6,61,30,3,94,202,36,332
1111111,6,0,6,106,34,6,146,222,51,419
1111112,0,0,0,63,18,4,85,118,3,206
1111113,4,3,7,86,54,3,143,285,30,458
1111114,3,3,6,66,37,3,106,235,40,381
1111115,8,0,8,92,48,9,149,244,30,423
1111116,57,3,60,70,43,6,119,292,21,432
1111117,4,0,4,63,26,3,92,156,8,256
1111118,0,0,0,51,23,0,74,103,6,183
1111119,0,3,3,108,48,3,159,179,15,353
1111120,0,0,0,122,41,3,166,166,18,350
1111121,4,0,4,56,18,12,86,151,3,240
1111122,0,0,0,60,22,0,82,124,8,214
1111123,0,0,0,62,35,0,97,192,26,315
1111124,4,0,4,96,32,0,128,196,34,358
1111125,7,4,11,42,49,0,91,246,29,366
1111126,7,0,7,91,71,3,165,242,18,425
1111127,9,7,16,83,46,0,129,236,35,400
1111128,6,0,6,90,30,0,120,206,41,367
1111129,12,0,12,60,25,3,88,183,37,308
1111130,6,3,9,82,48,8,138,244,34,416
1111131,4,0,4,58,30,0,88,138,24,250
1111132,3,0,3,38,35,6,79,173,14,266
1111133,4,0,4,65,13,0,78,156,29,263
1111134,6,3,9,59,16,3,78,163,16,257
1111135,6,0,6,56,44,0,100,117,21,238
1111136,0,0,0,59,23,3,85,167,24,276
1111137,0,0,0,0,0,0,0,0,0,0
1111138,0,0,0,47,18,0,65,101,6,172
1111139,0,0,0,0,0,0,0,0,0,0
1111140,3,3,6,65,30,3,98,168,27,293
1111141,0,0,0,61,24,0,85,122,0,207
1111142,0,0,0,0,3,0,3,15,9,27
1111143,0,0,0,39,15,0,54,109,8,171
1111144,3,0,3,37,15,0,52,115,18,185
1111145,0,0,0,26,25,0,51,85,10,146
1111146,0,0,0,0,0,0,0,0,0,0
1111147,0,0,0,73,40,3,116,273,56,445
1111201,0,0,0,73,16,6,95,154,14,263
1111202,0,0,0,87,22,6,115,112,13,240
1111203,9,0,12,75,27,3,105,313,20,438
1111204,0,0,0,39,38,5,82,165,12,259
1111205,6,3,9,37,22,0,59,166,28,253
1111206,3,0,3,46,22,3,71,160,24,255
1111207,4,0,4,58,12,0,70,170,21,261
1111208,0,0,0,34,9,3,46,106,16,168
1111209,29,3,32,70,30,3,103,264,34,401
1111210,0,4,4,72,43,0,115,359,29,503
1111211,6,0,6,25,6,3,34,97,9,140
1111212,3,3,6,85,32,6,123,139,16,278
1111213,7,3,10,50,33,4,87,231,32,350
1111214,4,0,4,88,25,3,116,217,35,368
1111215,8,0,8,43,11,0,54,170,22,246
1111216,3,3,6,62,15,0,77,144,24,245
1111217,0,0,0,77,22,0,99,122,9,230
1111218,11,3,17,52,27,0,79,177,24,280
1111219,10,0,10,76,16,4,96,237,24,357
1111220,0,0,0,16,12,0,28,58,10,96
1111221,0,4,4,50,16,4,70,133,19,222
1111222,0,0,0,70,21,0,91,140,48,279
1111223,0,0,0,42,21,6,69,111,18,198
1111224,0,0,0,107,17,12,136,130,6,272
1111225,0,0,0,56,6,3,65,109,9,183
1111226,0,0,0,68,13,4,85,116,5,206
1111227,3,0,3,100,24,6,130,203,18,351
1111228,0,0,0,48,16,0,64,95,12,171
1111229,3,0,6,43,24,0,67,176,15,258
1111230,7,0,7,73,45,3,121,212,39,372
1111231,0,0,0,74,29,3,106,247,23,376
1111232,27,0,27,54,20,3,77,167,6,250
1111233,3,0,3,93,39,5,137,247,18,402
1111234,0,0,0,81,15,0,96,153,9,258
1111235,0,0,0,86,35,12,133,216,13,362
1111236,0,0,0,160,33,11,204,223,24,451
1111237,0,0,0,89,20,0,109,114,9,232
1111238,0,0,0,57,13,3,73,148,14,235
1111239,3,0,3,124,51,13,188,254,24,466
1111240,39,3,42,42,26,0,68,197,15,280
1111241,0,0,0,31,9,3,43,85,15,143
1111242,6,0,6,73,20,0,93,228,15,336
1111243,0,0,0,212,35,6,253,282,40,575
1111301,0,0,0,46,25,0,71,108,24,203
1111302,0,0,0,69,20,4,93,191,20,304
1111303,0,3,3,33,6,3,42,93,12,147
1111304,0,0,0,40,14,0,54,166,45,265
1111305,3,3,6,61,30,0,91,167,27,285
1111306,0,0,0,64,21,6,91,194,15,300
1111307,0,0,0,33,11,0,44,76,3,123
1111308,0,0,0,32,4,6,42,88,21,151
1111309,0,0,0,76,27,6,109,198,12,319
1111310,0,0,0,33,15,6,54,121,17,192
1111311,0,0,0,74,30,6,110,182,20,312
1111312,6,0,6,84,28,9,121,237,25,383
1111313,3,0,3,75,19,4,98,118,3,219
1111314,3,3,6,87,31,3,121,205,21,347
1111315,0,0,0,57,20,0,77,132,16,225
1111401,9,3,12,41,16,3,60,151,36,247
1111402,10,3,13,72,39,3,114,264,53,431
1111403,3,0,3,36,16,0,52,111,10,173
1111404,0,0,0,137,25,0,162,192,4,358
1111405,17,3,20,76,38,3,117,328,44,489
1111406,0,0,0,16,9,0,25,83,6,114
1111407,4,0,4,119,52,0,171,261,12,444
1111408,7,0,7,65,19,6,90,189,41,320
1111409,6,0,6,49,20,3,72,171,35,278
1111410,4,3,7,70,33,14,117,258,65,440
1111411,39,3,42,39,25,0,64,198,41,303
1111412,40,8,51,41,26,0,67,212,18,297
1111501,0,0,0,70,40,3,113,192,3,308
1111502,5,3,8,55,29,0,84,202,49,335
1111503,6,3,9,42,23,3,68,171,40,279
1111504,8,0,8,23,14,6,43,144,13,200
1111505,6,3,9,78,36,5,119,295,23,437
1111506,17,6,23,71,41,3,115,270,32,417
1111507,6,3,9,63,25,0,88,160,22,270
1111508,17,0,17,73,27,3,103,262,36,401
1111509,0,0,0,113,34,3,150,295,22,467
1111510,3,0,3,40,36,0,76,150,6,232
1111511,6,3,9,82,36,0,118,193,12,323
1111512,0,0,0,78,25,6,109,165,20,294
1111513,3,0,3,52,19,3,74,165,44,283
1111514,3,3,6,121,48,0,169,237,21,427
1111515,7,0,7,81,44,0,125,247,22,394
1111516,7,0,7,91,23,3,117,203,12,332
1111517,3,0,3,101,25,11,137,177,25,339
1111518,3,0,3,46,26,3,75,140,18,233
1111519,3,0,3,73,31,3,107,228,11,346
1111520,0,0,0,125,28,7,160,197,12,369
1111521,0,0,0,31,7,4,42,93,7,142
1111522,4,0,4,175,33,8,216,293,55,564
1111523,0,0,0,74,32,3,109,246,13,368
1111524,0,0,0,69,13,10,92,94,12,198
1111525,0,0,0,19,6,3,28,38,0,66
1111526,0,0,0,98,64,0,162,320,21,503
1111527,4,0,4,93,32,3,128,151,10,289
1111528,7,3,10,46,56,0,102,192,30,324
1111529,9,3,12,93,49,6,148,293,32,473
1111530,4,0,4,67,37,6,110,186,20,316
1111531,7,0,7,47,12,3,62,185,19,266
1111532,10,3,13,42,45,6,93,203,31,327
1111533,6,0,6,81,46,3,130,272,47,449
1111534,6,0,6,50,24,0,74,185,26,285
1111535,8,0,8,71,39,6,116,243,18,377
1111536,87,10,97,18,15,0,33,234,33,300
1111537,0,0,0,50,10,9,69,92,12,173
1111538,0,0,0,122,41,4,167,210,3,380
1111539,0,0,0,104,30,3,137,139,4,280
1111540,3,3,6,109,31,6,146,310,55,511
1111541,5,0,5,85,58,3,146,311,21,478
1111542,12,0,12,52,28,0,80,180,26,286
1111543,21,5,26,64,47,11,122,294,38,454
1111544,9,6,15,60,37,3,100,187,30,317
1111545,15,0,15,52,37,0,89,176,19,284
1111546,3,7,10,74,21,6,101,250,13,364
1111547,15,3,18,72,43,7,122,272,28,422
1111548,3,0,3,42,24,3,69,193,15,277
1111549,6,0,6,34,12,4,50,111,9,170
1111550,9,0,9,65,29,0,94,177,22,293
1111551,6,0,6,47,30,0,77,164,12,253
1111552,6,0,6,91,31,6,128,160,25,313
1111553,0,0,0,80,16,3,99,180,17,296
1111554,0,5,5,67,56,0,123,290,41,454
1111555,0,0,0,140,21,3,164,121,9,294
1111556,0,0,0,125,26,4,155,175,8,338
1111557,3,0,3,74,13,0,87,121,8,216
1111558,0,0,0,75,34,3,112,104,5,221
1111559,3,0,3,55,32,6,93,181,14,288
1111560,3,0,3,56,27,6,89,167,8,264
1111561,0,3,3,65,36,6,107,156,12,275
1111562,0,0,0,0,0,0,0,0,0,0
1111563,6,0,6,28,9,3,40,106,24,170
1111564,0,0,0,7,0,0,7,28,0,35
1111565,0,0,0,107,28,14,149,139,12,300
1111601,3,0,3,83,35,12,130,217,9,356
1111602,6,0,6,70,55,9,134,240,19,393
1111603,7,0,7,61,18,0,79,121,12,212
1111604,7,0,7,112,35,4,151,256,27,434
1111605,6,0,6,97,38,3,138,198,13,349
1111606,4,0,4,191,31,7,229,248,20,497
1111607,5,3,8,27,18,0,45,80,18,143
1111608,10,0,10,63,34,7,104,180,12,296
1111609,7,0,7,38,12,6,56,135,18,209
1111610,5,0,5,67,37,13,117,221,13,351
1111611,3,0,3,49,23,0,72,122,9,203
1111612,34,4,38,157,32,9,198,244,16,458
1111613,0,0,0,51,48,0,99,163,6,268
1111614,10,0,10,67,46,0,113,248,15,376
1111615,4,0,4,63,49,0,112,209,15,336
1111616,9,0,9,52,27,0,79,176,10,265
1111701,8,7,15,23,21,0,44,144,30,218
1111702,5,0,5,80,34,3,117,227,15,359
1111703,0,0,3,99,40,9,148,281,31,460
1111704,0,5,5,99,22,7,128,142,18,288
1111705,0,0,0,119,17,0,136,113,9,258
1111706,0,0,0,49,9,0,58,141,10,209
1111707,0,0,0,35,16,0,51,80,3,134
1111708,9,0,9,57,45,6,108,271,14,393
1111709,5,0,5,37,27,6,70,126,12,208
1111710,41,0,41,70,30,3,103,221,12,336
1111711,7,0,7,75,33,6,114,269,23,406
1111712,3,0,3,185,34,9,228,228,20,476
1111713,0,0,0,99,34,3,136,270,15,421
1111714,7,0,7,142,28,4,174,229,26,429
1111715,3,0,3,58,23,0,81,141,9,231
1111716,3,0,3,120,30,6,156,185,32,373
1111717,3,0,3,98,16,0,114,207,12,333
1111718,0,0,0,116,24,9,149,163,12,324
1111719,6,0,6,112,46,11,169,217,23,409
1111720,3,0,3,66,28,6,100,165,12,277
1111721,0,0,0,54,30,7,91,168,35,294
1111722,4,0,4,84,28,0,112,201,22,335
1111723,0,0,0,113,23,9,145,273,12,430
1111724,3,0,3,99,27,0,126,197,15,338
1111725,6,3,9,41,36,6,83,229,56,368
1111726,3,3,6,41,16,0,57,122,16,195
1111727,3,0,3,28,16,0,44,134,11,189
1111728,4,0,4,53,12,0,65,85,18,168
1111729,0,0,0,151,49,7,207,252,31,490
1111730,3,3,6,33,17,0,50,130,27,207
1111731,7,0,7,78,31,0,109,256,16,381
1111732,0,0,0,123,40,10,173,286,10,469
1111733,7,6,13,67,36,6,109,229,20,358
1111734,10,0,10,59,38,0,97,180,13,290
1111735,9,5,14,56,12,5,73,129,40,242
1111736,12,3,18,72,36,8,116,257,35,408
1111737,10,0,10,83,41,3,127,211,24,362
1111738,3,3,6,88,48,0,136,232,35,403
1111739,8,0,8,151,41,6,198,310,51,559
1111740,0,3,3,58,14,5,77,155,15,247
1111741,4,0,4,90,15,7,112,126,18,256
1111742,3,0,3,48,9,6,63,139,16,218
1111743,12,0,12,39,48,0,87,209,24,320
1111744,0,0,0,4,0,0,4,3,3,10
1111801,3,0,3,112,48,0,160,265,19,444
1111802,4,0,4,52,39,3,94,169,20,283
1111803,3,3,6,71,17,4,92,122,9,223
1111804,0,0,0,125,23,12,160,207,30,397
1111805,0,0,0,114,30,0,144,222,18,384
1111806,0,0,0,113,31,3,147,212,18,377
1111807,0,0,0,99,37,9,145,141,9,295
1111808,0,0,0,86,24,6,116,208,21,345
1111809,3,0,3,64,23,3,90,160,15,265
1111810,5,0,5,93,29,8,130,229,15,374
1111811,4,0,4,77,21,0,98,155,9,262
1111812,0,0,0,107,29,3,139,247,12,398
1111813,0,0,0,59,15,0,74,88,6,168
1111814,0,0,0,14,15,3,32,117,9,158
1111815,0,0,0,0,0,0,0,0,0,0
1111816,0,0,0,126,45,8,179,237,13,429
1111817,9,0,9,36,34,0,70,196,7,273
1111818,0,3,3,52,31,6,89,183,21,293
1111819,0,0,0,95,52,4,151,234,13,398
1111820,5,0,5,47,30,0,77,106,28,211
1111821,4,0,4,77,17,6,100,250,24,374
1111822,0,0,0,132,22,9,163,184,20,367
1111901,6,0,6,37,18,3,58,154,13,225
1111902,0,0,0,75,34,6,115,167,19,301
1111903,6,3,9,82,52,0,134,235,59,428
1111904,0,3,3,67,18,0,85,180,33,298
1111905,12,0,12,52,36,0,88,383,33,504
1111906,0,0,0,39,18,7,64,132,12,208
1111907,0,0,0,17,12,3,32,44,9,85
1111908,0,0,0,0,0,0,0,0,0,0
1111909,9,0,9,3,4,0,7,159,8,174
1111910,3,0,3,34,24,0,58,128,15,201
1111911,0,0,0,45,22,0,67,135,12,214
1111912,0,0,0,43,25,0,68,129,30,227
1111913,0,0,0,83,15,9,107,192,10,309
1111914,5,0,5,72,31,3,106,151,10,267
1111915,6,4,10,85,28,6,119,232,28,379
1111916,3,0,3,71,32,4,107,178,18,303
1111917,0,0,0,0,0,0,0,0,0,0
1111918,0,0,0,65,10,4,79,116,9,204
1112001,0,0,0,0,4,0,4,4,0,8
1112002,6,0,6,47,33,0,80,192,25,297
1112003,3,0,3,27,29,3,59,184,12,255
1112004,3,3,6,69,36,9,114,220,16,350
1112005,0,0,0,3,0,0,3,6,0,9
1112006,10,3,13,92,34,6,132,304,38,474
1112007,4,0,4,33,15,0,48,141,9,198
1112008,13,3,16,68,38,0,106,298,34,438
1112009,4,0,4,111,23,3,137,199,15,351
1112010,4,6,10,91,46,5,142,330,25,497
1112011,0,0,0,33,17,5,55,153,11,219
1112012,6,0,6,47,22,6,75,170,18,263
1112013,8,0,8,50,28,0,78,239,10,327
1112014,5,0,5,71,42,6,119,244,12,375
1112015,3,0,3,14,16,3,33,132,21,186
1112016,4,0,4,84,42,3,129,262,27,418
1112017,0,0,0,0,0,0,0,0,0,0
1112018,33,6,39,69,36,0,105,294,34,433
1112101,6,0,6,54,51,6,111,294,103,508
1112102,13,0,13,49,41,3,93,266,19,378
1112103,4,0,4,41,27,0,68,169,29,266
1112104,3,3,6,31,18,3,52,150,12,214
1112105,0,0,0,43,24,0,67,161,13,241
1112106,35,3,38,24,26,0,50,294,52,396
1112107,3,0,3,34,17,0,51,113,10,174
1112108,23,0,23,53,24,5,82,305,26,413
1112109,3,0,3,65,21,9,95,194,32,321
1112110,0,0,0,45,16,6,67,103,21,191
1112111,0,0,0,0,0,0,0,0,0,0
1112112,0,0,0,0,0,0,0,0,0,0
1112113,0,0,0,3,0,0,3,0,3,6
1112114,0,0,0,6,3,3,12,6,0,18
1112115,8,3,11,60,23,3,86,255,36,377
1112116,13,3,16,49,30,0,79,220,24,323
1112117,0,0,0,0,0,0,0,44,3,47
1112118,9,4,13,41,24,0,65,221,21,307
1112119,66,7,73,55,26,0,81,297,21,399
1112120,0,0,0,52,22,6,80,108,20,208
1112121,0,0,0,9,7,0,16,44,13,73
1112122,10,0,10,22,19,0,41,122,13,176
1112123,47,37,84,22,19,0,41,328,96,465
1112124,4,0,4,63,20,0,83,243,27,353
1112125,11,0,11,30,25,0,55,209,70,334
1112126,0,0,0,44,5,0,49,111,27,187
1112127,6,0,6,53,45,4,102,266,28,396
1112128,3,0,3,66,26,3,95,170,3,268
1112129,3,0,3,49,19,4,72,125,7,204
1112130,8,3,11,56,22,3,81,215,15,311
1112131,9,5,14,56,52,4,112,286,83,481
1112132,13,0,13,106,44,6,156,438,65,659
1112133,10,0,10,43,34,0,77,207,15,299
1112134,82,3,85,84,26,6,116,396,18,530
1112135,0,0,0,10,0,3,13,25,12,50
1112136,0,0,0,86,22,4,112,187,34,333
1112137,3,3,6,70,26,0,96,185,35,316
1112138,7,0,7,100,56,0,156,319,22,497
1112139,4,0,4,55,26,6,87,184,18,289
1112140,7,3,10,46,24,0,70,158,18,246
1112141,7,10,17,65,33,7,105,230,45,380
1112142,14,0,14,39,32,9,80,214,8,302
1112143,14,3,17,61,42,3,106,265,52,423
1112144,4,0,4,41,24,9,74,145,19,238
1112145,7,3,10,59,30,7,96,266,77,439
1112146,58,92,150,25,12,0,37,248,208,493
1112147,6,0,6,42,13,3,58,159,17,234
1112148,14,3,17,51,28,0,79,248,28,355
1112149,15,9,24,43,22,6,71,256,61,388
1112150,6,0,6,36,13,3,52,178,12,242
1112151,3,6,9,67,20,3,90,257,40,387
1112152,7,0,11,55,25,6,86,174,14,274
1112153,0,0,0,55,22,9,86,171,18,275
1112154,0,0,0,76,27,0,103,214,18,335
1112155,6,0,6,66,20,4,90,170,6,266
1112156,0,0,0,32,30,4,66,189,21,276
1112201,3,0,3,122,53,9,184,306,30,520
1112202,6,0,6,28,15,0,43,178,27,248
1112203,0,0,0,0,0,0,0,0,0,0
1112204,6,7,13,59,21,3,83,182,23,288
1112205,3,3,6,71,26,6,103,192,25,320
1112206,3,3,6,71,37,3,111,205,23,339
1112207,5,0,5,62,24,3,89,248,38,375
1112208,9,6,15,45,28,0,73,171,27,271
1112209,18,7,25,41,42,6,89,234,34,357
1112210,17,4,21,74,41,4,119,326,41,486
1112211,58,3,61,19,26,0,45,231,35,311
1112212,6,0,6,95,42,0,137,253,50,440
1112213,0,0,0,34,17,0,51,138,8,197
1112214,3,0,3,65,18,3,86,161,18,265
1112215,3,0,3,83,35,6,124,170,24,318
1112216,4,4,8,52,28,8,88,169,16,273
1112217,0,0,0,113,39,9,161,156,11,328
1112218,0,0,0,79,27,6,112,149,6,267
1112219,5,0,5,72,37,3,112,235,17,364
1112220,8,0,8,40,36,4,80,168,30,278
1112221,3,3,6,102,36,7,145,248,24,417
1112222,0,0,0,75,22,6,103,220,23,346
1112223,0,0,0,98,30,5,133,192,33,358
1112224,7,0,7,54,16,0,70,153,35,258
1112225,6,0,6,66,24,6,96,243,13,352
1112226,0,0,0,72,39,3,114,277,27,418
1112227,3,0,3,111,43,9,163,283,15,461
1112228,0,4,4,90,29,18,137,240,22,399
1112229,3,0,3,114,38,4,156,271,32,459
1112230,3,0,3,46,32,4,82,303,55,440
1112231,0,0,0,31,25,0,56,112,15,183
1112232,0,0,0,0,3,0,3,0,0,3
1112233,0,0,0,26,19,3,48,117,3,168
1112234,4,0,4,41,26,0,67,136,11,214
1112301,0,0,0,41,22,3,66,79,12,157
1112302,3,0,3,45,19,0,64,160,0,224
1112303,6,0,6,78,35,3,116,176,25,317
1112304,0,0,0,95,23,6,124,179,13,316
1112305,3,0,3,123,37,6,166,200,17,383
1112306,0,0,0,46,18,0,64,56,15,135
1112307,0,0,0,33,29,3,65,130,3,198
1112308,0,4,4,67,32,3,102,241,8,351
1112309,3,0,3,60,25,4,89,135,18,242
1112310,5,0,5,95,31,10,136,307,35,478
1112311,3,0,3,69,29,0,98,172,23,293
1112312,0,0,0,58,22,0,80,150,15,245
1112313,0,0,0,77,26,0,103,190,23,316
1112314,6,0,6,44,27,3,74,167,18,259
1112315,0,0,0,35,26,3,64,114,18,196
1112401,0,0,0,21,22,0,43,169,11,223
1112402,3,3,6,31,16,0,47,140,21,208
1112403,4,0,4,42,20,6,68,209,16,293
1112404,6,0,6,42,29,3,74,223,21,318
1112405,27,6,33,28,32,0,60,409,43,512
1112406,9,0,9,41,11,3,55,179,22,256
1112407,4,0,4,23,11,3,37,137,7,181
1112408,6,0,6,30,24,3,57,197,19,273
1112409,6,0,9,21,21,0,42,152,29,223
1112410,8,3,11,46,25,4,75,258,23,356
1112411,29,6,35,43,39,6,88,281,35,404
1112412,0,0,0,27,10,0,37,154,15,206
1112413,5,4,9,53,43,0,96,239,32,367
1112414,0,0,0,13,6,0,19,55,0,74
1112415,0,0,0,0,0,0,0,0,0,0
1112416,0,0,0,0,0,0,0,0,0,0
1112501,0,0,0,28,9,0,37,99,11,147
1112502,7,3,10,60,26,0,86,229,21,336
1112503,3,0,3,33,28,3,64,169,12,245
1112504,3,0,3,76,16,3,95,116,19,230
1112505,0,0,0,0,0,0,0,0,0,0
1112506,4,0,4,87,36,5,128,275,34,437
1112507,8,0,8,82,40,9,131,291,40,462
1112508,0,0,0,0,0,0,0,0,0,0
1112509,0,0,0,7,8,0,15,123,28,166
1112510,3,0,3,45,9,0,54,143,21,218
1112511,8,0,8,64,36,6,106,201,31,338
1112512,0,5,5,46,33,3,82,163,26,271
1112513,3,0,3,102,33,0,135,243,24,402
1112514,0,0,0,10,9,0,19,53,4,76
1112515,6,0,6,22,25,0,47,245,54,346
1112516,3,0,3,61,25,0,86,189,19,294
1112517,17,5,22,15,25,0,40,254,38,332
1112518,3,0,3,86,37,4,127,267,4,398
1112519,0,0,0,52,29,3,84,211,7,302
1112520,0,0,0,52,30,0,82,168,16,266
1112521,0,0,0,125,26,9,160,200,14,374
1112522,0,0,0,87,20,9,116,128,12,256
1112523,0,0,0,86,28,6,120,113,12,245
1112524,0,0,0,127,22,12,161,180,14,355
1112525,0,0,0,87,37,6,130,215,25,370
1112526,0,0,0,70,15,7,92,130,5,227
1112527,0,0,0,139,32,5,176,228,22,426
1112528,0,3,3,104,32,0,136,212,15,363
1112529,6,0,6,76,32,5,113,129,12,254
1112530,0,0,0,141,20,12,173,183,26,382
1112531,0,3,3,62,17,4,83,125,15,223
1112532,0,0,0,53,10,0,63,107,19,189
1112533,0,0,0,0,0,0,0,0,0,0
1112534,3,0,3,34,21,0,55,97,10,162
1112535,0,0,0,82,18,3,103,121,12,236
1112536,0,0,0,60,16,0,76,102,7,185
1112537,0,0,0,59,29,0,88,193,7,288
1112601,3,0,3,17,18,0,35,78,21,134
1112602,0,0,0,12,4,0,16,61,285,362
1112603,6,3,9,54,32,3,89,202,21,312
1112604,12,4,16,73,30,0,103,187,15,305
1112605,0,3,3,64,15,6,85,123,15,223
1112606,6,0,6,39,22,0,61,123,12,196
1112607,5,5,10,60,20,0,80,155,37,272
1112608,0,0,0,27,12,3,42,101,16,159
1112609,0,0,0,83,43,10,136,183,15,334
1112610,0,0,0,111,29,10,150,176,26,352
1112611,0,0,0,45,15,0,60,98,7,165
1112612,3,0,3,36,19,6,61,155,22,238
1112613,0,0,0,76,32,0,108,226,16,350
1112614,5,0,5,66,28,3,97,222,31,350
1112615,0,0,0,6,7,5,18,54,30,102
1112616,0,0,0,38,15,0,53,116,15,184
1112617,3,0,3,100,22,6,128,196,61,385
1112618,3,0,3,82,13,3,98,134,9,241
1112619,0,0,0,34,16,6,56,84,3,143
1112620,0,0,0,81,39,6,126,167,12,305
1112621,0,0,0,70,17,10,97,151,78,326
1112622,3,0,3,87,26,0,113,201,50,364
1112623,4,0,4,81,26,0,107,219,18,344
1112624,7,3,10,61,17,0,78,182,37,297
1112625,0,0,0,48,34,0,82,172,31,285
1112626,0,0,0,62,9,6,77,97,12,186
1112627,0,0,0,103,15,0,118,157,4,279
1112628,0,0,0,26,16,0,42,115,6,163
1112629,0,0,0,75,26,0,101,144,30,275
1112630,3,0,3,135,17,3,155,222,13,390
1112631,18,0,18,133,24,0,157,307,51,515
1112632,3,0,3,31,18,6,55,101,15,171
1112633,0,3,3,43,24,3,70,119,6,195
1112634,4,0,4,38,13,3,54,132,24,210
1112635,0,0,0,0,0,0,0,0,0,0
1112701,23,3,26,59,21,5,85,232,26,343
1112702,3,0,3,69,11,0,80,150,15,245
1112703,3,0,3,84,29,0,113,164,26,303
1112704,0,0,0,0,0,0,0,0,0,0
1112705,3,0,3,28,3,0,31,96,33,160
1112706,0,0,0,73,28,7,108,204,33,345
1112707,3,0,3,37,12,8,57,111,0,168
1112708,0,0,0,55,19,0,74,157,28,259
1112709,0,0,0,72,28,3,103,167,27,297
1112710,5,0,5,116,31,3,150,203,34,387
1112711,0,0,0,50,19,6,75,115,22,212
1112712,6,0,6,57,43,4,104,246,30,380
1112801,53,0,53,70,34,6,110,286,12,408
1112802,13,0,13,71,31,0,102,255,37,394
1112803,4,3,7,50,24,12,86,185,21,292
1112804,23,0,23,74,37,6,117,287,67,471
1112805,3,0,3,78,21,0,99,192,12,303
1112806,6,0,6,92,10,8,110,145,6,261
1112807,0,3,3,66,23,0,89,93,15,197
1112808,3,0,3,52,23,9,84,198,21,303
1112809,7,0,7,110,36,6,152,241,22,415
1112810,6,0,6,145,27,6,178,226,15,419
1112811,3,4,7,84,30,0,114,280,42,436
1112812,17,0,17,85,25,5,115,223,16,354
1112813,10,6,16,70,23,0,93,220,33,346
1112901,11,0,11,44,29,0,73,231,28,332
1112902,0,0,0,111,53,4,168,210,18,396
1112903,3,3,6,92,36,11,139,222,15,376
1112904,4,0,4,76,26,0,102,194,24,320
1112905,4,3,7,29,9,3,41,113,12,166
1112906,0,0,0,49,15,3,67,169,21,257
1112907,0,3,3,61,17,0,78,162,9,249
1112908,3,3,6,50,12,3,65,174,36,275
1112909,0,0,0,61,19,0,80,113,9,202
1112910,4,0,4,60,21,3,84,132,22,238
1112911,3,0,3,34,15,3,52,100,3,155
1112912,0,0,0,34,24,3,61,169,12,242
1112913,0,0,0,75,10,0,85,189,11,285
1112914,13,4,17,29,4,0,33,143,32,208
1112915,0,0,0,39,15,4,58,125,24,207
1112916,12,3,15,58,27,3,88,232,33,353
1112917,3,0,3,51,14,3,68,182,22,272
1112918,0,0,0,46,16,4,66,120,24,210
1112919,3,0,3,29,13,3,45,115,12,172
1112920,3,0,3,53,18,6,77,121,8,206
1112921,6,4,10,40,3,5,48,237,33,318
1112922,23,3,26,63,24,0,87,265,46,398
1112923,6,0,6,108,28,0,136,251,36,423
1113001,30,3,33,38,22,0,60,223,13,296
1113002,0,0,0,74,46,6,126,290,42,458
1113003,0,0,0,44,24,0,68,174,29,271
1113004,15,0,15,66,38,0,104,266,45,415
1113005,11,0,11,76,58,3,137,318,42,497
1113006,11,0,11,83,52,3,138,341,31,510
1113007,14,0,14,68,47,0,115,258,30,403
1113008,18,0,18,78,47,13,138,295,23,456
1113009,8,3,14,61,26,8,95,170,9,274
1113010,18,5,23,56,30,3,89,329,49,467
1113011,10,0,10,32,21,0,53,170,44,267
1113012,11,3,14,42,23,3,68,194,41,303
1113013,3,0,3,94,31,4,129,200,19,348
1113014,3,0,3,74,26,3,103,241,19,363
1113015,6,0,6,40,29,0,69,246,41,356
1113016,8,0,8,56,22,0,78,254,26,358
1113017,9,0,9,67,22,0,89,221,44,354
1113018,0,0,0,0,0,0,0,19,0,19
1113019,12,0,12,54,27,0,81,274,41,396
1113020,6,0,6,45,32,0,77,143,51,271
1113021,5,5,10,65,52,6,123,301,37,461
1113022,8,0,8,59,28,3,90,243,12,345
1113023,6,0,6,47,26,8,81,192,19,292
1113024,8,4,12,66,16,0,82,228,65,375
1113025,4,3,7,66,35,4,105,215,31,351
1113026,8,0,8,49,20,0,69,216,36,321
1113027,3,0,3,54,36,0,90,216,17,323
1113028,6,0,6,66,14,10,90,235,33,358
1113029,6,0,6,60,24,3,87,180,46,313
1113030,3,0,3,45,27,0,72,248,40,360
1113031,4,3,7,67,41,6,114,243,53,410
1113032,6,0,6,37,11,3,51,154,19,224
1113033,6,3,9,66,25,0,91,245,33,369
1113034,9,6,15,55,22,0,77,182,36,295
1113035,0,0,0,0,0,0,0,7,3,10
1113036,9,3,12,31,18,0,49,197,39,285
1113037,0,0,0,0,0,0,0,0,0,0
1113038,4,4,8,55,20,0,75,272,33,380
1113039,0,0,0,0,0,0,0,0,0,0
1113040,0,0,0,57,12,3,72,110,12,194
1113041,0,0,0,100,43,3,146,334,25,505
1113042,6,0,6,57,30,0,87,219,17,323
1113043,0,0,0,74,17,5,96,206,67,369
1113044,10,0,10,50,34,0,84,269,35,388
1113045,3,0,3,42,28,0,70,158,9,237
1113046,35,3,38,87,41,3,131,301,46,478
1113047,6,0,6,33,23,0,56,146,32,234
1113048,18,0,18,55,24,7,86,340,31,457
1113049,14,3,17,79,47,3,129,292,54,475
1113050,0,4,4,61,24,9,94,228,33,355
1113051,0,0,0,0,0,0,0,0,0,0
1113052,7,0,7,30,13,3,46,163,27,236
1113053,5,4,9,62,26,6,94,272,60,426
1113054,3,3,6,42,11,0,53,113,14,180
1113055,9,3,12,70,33,4,107,257,56,420
1113056,3,0,3,6,6,0,12,99,12,123
1113057,24,6,30,88,69,3,160,601,82,843
1113058,0,0,0,28,6,4,38,137,19,194
1113059,7,3,10,70,28,0,98,261,23,382
1113060,3,3,6,53,17,0,70,178,25,273
1113061,3,3,6,67,27,5,99,225,50,374
1113062,5,4,9,73,35,4,112,211,28,351
1113063,6,0,6,93,54,3,150,310,35,495
1113064,0,6,6,32,23,0,55,145,24,224
1113065,3,0,3,57,24,0,81,232,27,340
1113066,30,8,38,44,22,0,66,236,24,326
1113067,3,0,3,16,21,3,40,100,12,152
1113101,3,3,6,49,19,5,73,145,27,245
1113102,3,0,3,50,29,3,82,177,14,273
1113103,0,0,0,47,40,0,87,174,14,275
1113104,6,0,6,50,9,3,62,128,21,211
1113105,4,0,4,70,45,0,115,267,53,435
1113106,6,3,9,51,35,3,89,164,18,271
1113107,5,0,5,46,31,6,83,208,19,310
1113108,0,0,0,58,19,7,84,147,18,249
1113109,6,0,6,82,71,0,153,280,23,456
1113110,0,0,0,41,8,0,49,109,15,173
1113111,0,3,3,59,22,3,84,173,12,269
1113112,0,0,0,3,0,0,3,0,0,3
1113113,4,0,4,62,33,0,95,192,6,293
1113114,0,0,0,148,55,10,213,284,21,518
1113115,0,0,0,71,39,4,114,174,26,314
1113116,5,0,5,46,11,0,57,100,7,164
1113117,11,4,15,97,36,11,144,275,36,455
1113118,6,0,6,83,55,0,138,243,27,408
1113119,3,0,3,81,51,3,135,206,17,358
1113120,6,0,6,68,37,4,109,194,26,329
1113121,0,0,0,39,34,0,73,100,4,177
1113122,0,0,0,32,25,0,57,110,29,196
1113123,0,0,0,55,28,0,83,165,13,261
1113124,0,0,0,53,26,4,83,215,19,317
1113125,0,0,0,47,12,3,62,112,9,183
1113126,0,0,0,80,38,0,118,220,34,372
1113127,3,0,3,113,27,9,149,151,16,316
1113128,3,0,3,88,37,6,131,294,37,462
1113129,7,0,7,76,38,3,117,208,13,338
1113130,0,0,0,60,20,0,80,146,15,241
1113131,3,4,7,60,41,7,108,199,19,326
1113132,0,0,0,52,32,3,87,157,15,259
1113133,0,0,0,44,15,0,59,132,13,204
1113134,30,38,68,50,22,6,78,272,104,454
1113135,0,0,0,45,28,3,76,144,12,232
1113136,4,0,4,39,31,0,70,113,18,201
1113137,3,3,6,122,57,0,179,255,39,473
1113138,88,29,117,50,38,0,88,384,88,560
1113139,12,4,16,42,84,0,126,353,46,525
1113140,0,0,0,49,49,0,98,173,18,289
1113141,3,0,3,33,18,0,51,122,7,180
1113142,0,0,0,33,24,0,57,107,4,168
1113143,3,0,3,95,25,3,123,271,15,409
1113144,4,0,4,63,28,8,99,206,12,317
1113145,8,3,11,42,14,4,60,156,26,242
1113146,4,0,4,70,68,7,145,215,20,380
1113147,0,0,0,66,36,0,102,193,27,322
1113148,7,0,7,67,45,10,122,235,29,386
1113149,0,0,0,41,28,3,72,175,24,271
1113150,7,0,7,99,53,9,161,260,44,465
1113151,7,0,7,49,21,3,73,135,9,217
1113152,8,0,8,77,50,0,127,243,25,395
1113153,3,0,3,38,27,0,65,103,15,183
1113154,12,3,15,74,42,0,116,232,27,375
1113155,8,3,11,53,17,9,79,240,39,358
1113156,8,0,8,37,20,0,57,97,15,169
1113157,11,0,11,67,37,0,104,336,24,464
1113158,3,3,6,75,48,6,129,212,33,374
1113201,0,0,0,71,18,0,89,167,9,265
1113202,3,3,6,46,27,6,79,174,21,274
1113203,4,0,4,56,18,6,80,143,26,249
1113204,3,0,3,122,38,8,168,243,0,411
1113205,3,0,3,72,28,0,100,174,18,292
1113206,6,0,6,84,34,9,127,157,12,296
1113207,0,0,0,90,12,11,113,119,6,238
1113208,0,0,0,16,17,3,36,116,5,157
1113209,0,0,0,28,16,0,44,101,12,157
1113210,0,0,0,71,15,6,92,155,6,253
1113211,3,0,3,144,34,8,186,232,13,431
1113212,0,0,0,56,15,0,71,132,0,203
1113213,6,0,6,102,23,3,128,176,9,313
1113214,4,0,4,133,36,3,172,176,6,354
1113215,30,0,30,164,34,5,203,241,0,444
1113216,6,0,6,62,42,7,111,182,9,302
1113217,3,0,3,117,33,9,159,241,21,421
1113218,0,0,0,62,23,0,85,119,3,207
1113219,3,0,3,56,37,4,97,191,6,294
1113301,0,0,0,0,4,0,4,20,3,27
1113401,0,0,0,0,0,0,0,0,0,0
1113402,0,0,0,78,22,3,103,222,12,337
1113403,3,0,3,84,31,3,118,214,8,340
1113404,8,0,8,89,44,6,139,215,0,354
1113405,4,0,4,39,13,3,55,110,9,174
1113406,9,6,15,79,39,7,125,281,28,434
1113407,0,0,0,61,18,6,85,139,15,239
1113408,0,0,0,65,29,0,94,134,4,232
1113409,0,0,0,35,9,0,44,139,0,183
1113410,0,0,0,65,21,3,89,118,15,222
1113411,0,0,0,67,25,0,92,133,6,231
1113412,0,0,0,47,23,6,76,113,3,192
1113413,0,0,0,45,9,0,54,142,9,205
1113414,4,0,4,65,27,3,95,168,12,275
1113415,6,0,6,74,43,5,122,232,22,376
1113416,0,0,0,55,21,6,82,182,8,272
1113417,107,10,117,35,22,3,60,315,31,406
1113418,0,0,0,59,19,6,84,136,11,231
1113419,6,0,6,86,33,0,119,218,24,361
1113420,3,3,6,82,41,0,123,260,27,410
1113421,10,0,10,60,30,0,90,216,23,329
1113422,0,0,0,117,32,4,153,245,17,415
1113423,3,3,6,52,50,3,105,181,12,298
1113424,3,0,3,109,27,3,139,265,27,431
1113425,0,3,3,46,11,0,57,108,15,180
1113426,0,0,0,58,39,3,100,186,4,290
1113427,0,0,0,41,9,0,50,85,3,138
1113428,4,0,4,40,21,0,61,116,3,180
1113429,0,0,0,67,26,6,99,179,28,306
1113430,4,6,10,61,20,4,85,172,27,284
1113431,3,0,3,61,24,0,85,145,0,230
1113432,3,0,3,58,21,0,79,170,0,249
1113433,4,3,7,62,20,0,82,157,6,245
1113434,0,0,0,101,39,0,140,204,9,353
1113435,49,3,52,69,23,0,92,266,15,373
1113436,0,0,0,84,17,0,101,143,11,255
1113437,0,0,0,26,19,0,45,102,20,167
1113438,6,0,6,64,27,4,95,170,28,293
1113439,71,3,74,36,29,7,72,285,29,386
1113440,0,3,3,57,34,3,94,158,15,267
1113441,0,0,0,0,0,0,0,6,0,6
1113442,6,0,6,103,44,0,147,232,23,402
1113443,0,0,0,63,27,0,90,120,4,214
1113444,0,0,0,76,12,0,88,98,0,186
1113445,0,0,0,39,12,5,56,111,4,171
1113501,0,0,0,3,0,0,3,0,3,6
1113601,0,0,0,87,26,9,122,229,18,369
1113602,4,0,4,59,27,0,86,209,7,302
1113603,11,0,11,68,46,8,122,258,23,403
1113604,3,0,3,59,30,13,102,212,12,326
1113605,6,0,6,53,39,9,101,192,25,318
1113606,5,0,5,32,11,0,43,94,6,143
1113607,3,0,3,85,27,6,118,180,18,316
1113608,0,0,0,41,14,3,58,49,6,113
1113609,0,0,0,112,13,14,139,158,10,307
1113610,0,0,0,158,29,8,195,199,11,405
1113611,0,0,0,112,6,4,122,95,12,229
1113612,6,0,6,81,29,6,116,156,21,293
1113613,10,0,10,94,54,6,154,246,15,415
1113614,3,0,3,101,31,5,137,208,6,351
1113615,4,0,4,156,46,6,208,263,4,475
1113616,0,0,0,0,0,0,0,0,0,0
1113617,0,0,0,88,28,6,122,220,21,363
1113618,3,0,3,80,34,12,126,189,5,320
1113619,3,0,3,75,35,3,113,209,27,349
1113620,0,0,0,91,18,3,112,143,3,258
1113621,12,0,12,67,39,6,112,217,26,355
1113622,3,6,9,118,32,7,157,220,12,389
1113623,6,0,6,87,22,6,115,161,27,303
1113624,0,0,0,84,12,11,107,110,3,220
1113625,0,3,3,85,47,6,138,226,23,387
1113626,0,0,0,43,20,0,63,91,15,169
1113627,3,0,3,38,17,8,63,107,6,176
1113628,0,3,3,63,24,0,87,116,9,212
1113629,3,0,3,68,28,3,99,166,23,288
1113630,0,0,0,78,27,0,105,147,21,273
1113631,3,0,3,32,27,0,59,124,9,192
1113632,0,0,0,55,25,3,83,156,6,245
1113633,77,0,77,123,27,9,159,284,14,457
1113634,0,0,0,57,10,3,70,135,18,223
1113635,0,0,0,123,44,14,181,180,15,376
1113701,0,0,0,51,9,9,69,97,6,172
1113702,3,3,6,122,52,3,177,251,15,443
1113703,0,0,0,0,0,0,0,3,0,3
1113704,0,0,0,44,44,6,94,106,29,229
1113705,0,0,0,65,28,0,93,133,7,233
1113706,3,0,3,89,33,6,128,210,24,362
1113707,0,0,0,52,16,3,71,126,30,227
1113708,0,0,0,46,17,3,66,135,12,213
1113709,0,0,0,52,32,6,90,140,6,236
1113710,92,29,121,31,27,3,61,328,48,437
1113711,0,0,0,67,36,4,107,231,22,360
1113712,6,0,6,55,31,3,89,220,17,326
1113713,9,3,12,80,41,6,127,284,34,445
1113714,7,0,7,74,30,6,110,271,25,406
1113715,6,3,9,71,19,4,94,220,28,342
1113716,7,0,7,52,38,0,90,228,20,338
1113717,0,0,0,50,32,6,88,140,12,240
1113718,4,0,4,50,23,6,79,188,20,287
1113719,0,0,0,0,0,0,0,3,0,3
1113720,0,0,0,0,0,0,0,0,0,0
1113721,0,0,0,0,0,0,0,13,0,13
1113722,0,0,0,45,33,3,81,128,12,221
1113801,13,0,13,42,40,4,86,190,15,291
1113802,25,0,25,28,18,3,49,199,20,268
1113803,5,0,5,30,22,3,55,177,13,245
1113804,4,0,4,47,27,3,77,172,24,273
1113805,110,15,128,22,21,0,43,384,37,464
1113806,3,3,6,36,30,0,66,210,15,291
1113807,6,3,9,39,26,9,74,194,15,283
1113808,18,0,18,44,17,3,64,170,12,246
1113809,7,3,10,78,48,4,130,288,30,448
1113810,10,0,10,46,24,6,76,168,20,264
1113811,3,0,3,85,27,4,116,251,21,388
1113812,7,3,10,64,43,6,113,198,17,328
1113813,8,0,8,65,41,4,110,191,15,316
1113814,8,3,11,26,20,3,49,208,12,269
1113815,0,0,0,87,50,4,141,225,14,380
1113816,0,0,0,30,17,6,53,152,13,218
1113817,0,0,0,41,25,0,66,111,15,192
1113818,0,3,3,15,9,6,30,93,6,129
1113819,0,0,0,9,6,0,15,40,3,58
1113820,6,0,6,64,34,12,110,219,12,341
1113821,0,0,0,84,32,0,116,209,21,346
1113901,0,0,0,9,0,0,9,18,0,27
1113902,0,0,0,0,0,0,0,6,0,6
1113903,3,0,3,31,24,3,58,107,7,172
1113904,6,0,6,65,40,9,114,270,24,408
1113905,8,3,11,83,34,7,124,221,24,369
1113906,7,0,7,47,32,3,82,160,15,257
1113907,4,3,7,46,41,6,93,192,22,307
1113908,10,0,10,100,38,8,146,276,22,444
1113909,9,0,9,60,50,3,113,194,23,330
1113910,4,0,4,38,26,0,64,180,9,253
1113911,0,0,0,0,0,0,0,0,0,0
1113912,5,3,8,82,21,15,118,261,10,389
1113913,3,0,3,53,26,7,86,122,18,226
1113914,3,0,3,74,17,4,95,147,17,259
1113915,0,0,0,64,34,4,102,189,15,306
1113916,11,0,11,76,16,6,98,180,21,299
1113917,0,4,4,24,17,3,44,136,21,201
1113918,0,0,0,0,0,0,0,0,0,0
1113919,6,3,9,63,56,4,123,270,30,423
1114001,0,0,0,117,34,12,163,181,9,353
1114002,3,0,3,26,8,6,40,81,3,124
1114003,8,0,8,58,37,3,98,184,16,298
1114004,3,0,3,61,24,0,85,169,3,257
1114005,3,0,3,31,18,3,52,114,7,173
1114006,10,0,10,91,43,0,134,277,23,434
1114007,0,0,0,99,38,16,153,308,17,478
1114008,0,0,0,41,18,6,65,102,7,174
1114009,13,3,16,65,33,9,107,341,27,475
1114010,0,3,3,35,18,3,56,172,9,237
1114011,7,6,13,70,36,9,115,169,15,299
1114012,11,3,14,55,39,4,98,305,30,433
1114013,0,0,0,49,19,7,75,206,8,289
1114014,134,12,146,24,12,0,36,272,24,332
1114015,3,3,6,31,10,6,47,121,15,183
1114016,0,0,0,18,21,3,42,128,12,182
1114017,5,0,5,54,47,6,107,243,6,356
1114018,7,3,10,38,26,0,64,140,32,236
1114019,0,0,0,41,21,3,65,118,19,202
1114020,3,0,3,25,21,0,46,134,21,201
1114101,0,0,0,126,23,6,155,169,21,345
1114102,0,0,0,0,0,0,0,0,0,0
1114103,0,0,0,41,3,6,50,52,3,105
1114104,6,0,6,80,21,3,104,213,20,337
1114105,3,0,3,48,21,3,72,88,0,160
1114106,0,0,0,114,22,0,136,110,7,253
1114107,0,0,0,82,25,0,107,143,11,261
1114108,3,0,3,99,29,7,135,162,6,303
1114109,3,0,3,231,48,12,291,325,22,638
1114110,0,0,0,109,20,3,132,128,10,270
1114111,0,0,0,0,0,0,0,0,0,0
1114112,6,3,9,96,51,10,157,304,35,496
1114113,3,0,3,72,29,0,101,178,9,288
1114114,3,0,3,84,20,9,113,171,16,300
1114115,0,3,3,41,26,3,70,167,15,252
1114116,3,0,3,91,50,7,148,267,9,424
1114117,6,0,6,68,30,4,102,210,30,342
1114118,0,0,0,62,11,4,77,110,21,208
1114119,6,3,9,73,36,9,118,279,23,420
1114120,10,0,10,65,43,0,108,252,18,378
1114121,5,0,5,64,49,3,116,248,27,391
1114122,11,0,11,106,39,5,150,296,41,487
1114123,6,0,6,156,32,0,188,183,6,377
1114124,0,3,3,38,18,4,60,140,21,221
1114125,3,0,3,150,46,10,206,286,20,512
1114126,0,0,0,38,10,6,54,84,9,147
1114127,3,0,3,85,25,3,113,154,8,275
1114128,3,0,3,138,39,4,181,236,27,444
1114129,3,0,3,81,39,0,120,250,25,395
1114130,0,0,0,136,37,6,179,239,26,444
1114131,3,0,3,98,35,6,139,196,4,339
1114132,0,0,0,129,26,0,155,210,9,374
1114201,6,0,6,96,49,3,148,263,21,432
1114202,3,0,3,68,33,6,107,197,14,318
1114203,0,0,0,3,3,0,6,15,0,21
1114204,3,0,3,60,21,0,81,193,11,285
1114205,6,3,9,78,25,0,103,208,13,324
1114206,3,0,3,61,36,0,97,208,13,318
1114207,4,0,4,63,31,0,94,187,22,303
1114208,4,0,4,75,39,0,114,245,16,375
1114209,4,0,4,34,26,4,64,196,18,278
1114210,0,0,0,37,14,0,51,128,12,191
1114211,6,3,9,72,26,0,98,244,16,358
1114212,0,0,0,75,36,6,117,158,19,294
1114213,0,0,0,71,15,3,89,150,8,247
1114214,6,3,9,62,28,4,94,192,15,301
1114215,8,0,8,32,26,0,58,180,20,258
1114216,4,0,4,62,27,11,100,191,12,303
1114217,7,3,10,66,40,0,106,215,10,331
1114218,5,3,8,88,51,6,145,260,21,426
1114219,0,0,0,53,28,0,81,134,4,219
1114220,6,0,6,71,29,0,100,196,18,314
1114221,0,0,0,6,0,0,6,18,3,27
1114222,13,4,17,90,52,0,142,256,33,431
1114223,4,0,4,61,34,4,99,158,4,261
1114224,6,6,12,62,31,3,96,193,19,308
1114225,8,0,8,78,38,0,116,283,26,425
1114226,6,0,6,69,37,6,112,193,33,338
1114301,0,0,0,34,33,0,67,148,21,236
1114302,7,3,10,86,34,3,123,283,36,442
1114303,0,0,0,49,36,0,85,216,26,327
1114304,6,0,6,54,32,0,86,176,20,282
1114305,3,3,6,29,29,0,58,150,6,214
1114306,0,0,0,63,40,0,103,199,11,313
1114307,0,3,3,61,36,0,97,189,21,307
1114308,7,0,7,55,18,0,73,138,39,250
1114309,0,3,3,54,24,0,78,144,20,242
1114310,6,0,6,67,44,0,111,212,37,360
1114311,5,0,5,53,35,6,94,197,49,340
1114312,0,0,0,0,0,0,0,0,0,0
1114313,4,3,7,43,31,4,78,219,21,318
1114314,12,0,12,3,20,0,23,283,49,355
1114315,0,0,0,63,48,4,115,209,44,368
1114316,0,0,0,61,20,3,84,164,24,272
1114317,6,0,6,95,46,9,150,317,46,513
1114318,7,0,7,31,35,9,75,247,15,337
1114319,5,0,5,73,34,6,113,243,27,383
1114320,11,0,11,58,16,3,77,178,30,285
1114321,10,0,10,88,39,5,132,316,39,487
1114322,0,0,0,32,33,3,68,169,12,249
1114323,3,0,3,46,29,0,75,226,12,313
1114324,0,0,0,38,25,6,69,112,20,201
1114325,59,8,67,57,23,0,80,355,53,488
1114326,6,0,6,78,28,4,110,263,30,403
1114327,6,3,9,35,9,0,44,160,21,225
1114328,7,0,7,57,21,0,78,147,18,243
1114329,7,3,10,40,16,0,56,100,49,205
1114330,0,0,0,43,25,3,71,164,12,247
1114331,0,0,0,57,29,9,95,197,23,315
1114332,11,0,11,46,27,0,73,198,22,293
1114333,16,4,23,44,18,0,62,287,41,390
1114334,13,3,16,85,33,9,127,313,24,464
1114335,0,3,3,76,31,6,113,252,41,406
1114336,6,0,6,64,30,8,102,218,29,349
1114337,3,0,3,59,36,6,101,198,16,315
1114338,0,0,0,36,38,9,83,149,21,253
1114339,7,0,7,55,29,7,91,230,29,350
1114340,6,0,9,39,16,0,55,143,19,217
1114341,3,0,3,53,26,5,84,123,23,230
1114342,3,3,6,42,18,0,60,220,24,304
1114343,4,7,11,43,32,6,81,176,29,286
1114344,5,0,5,92,47,0,139,277,19,435
1114345,5,0,5,85,40,3,128,249,24,401
1114346,6,0,6,73,61,9,143,285,25,453
1114347,6,0,6,58,41,12,111,243,41,395
1114348,18,0,18,52,45,9,106,243,12,361
1114349,3,0,3,71,27,8,106,332,34,472
1114350,4,0,4,73,59,7,139,272,19,430
1114401,10,0,10,68,27,6,101,231,13,345
1114402,3,0,3,109,60,15,184,269,15,468
1114403,4,0,4,26,6,0,32,137,26,195
1114404,18,0,18,61,33,9,103,250,16,369
1114405,12,6,18,40,28,3,71,229,33,333
1114406,0,0,0,58,30,0,88,188,19,295
1114407,0,0,0,86,33,7,126,265,16,407
1114408,6,3,9,50,13,0,63,171,25,259
1114409,8,0,8,38,17,0,55,151,3,209
1114410,8,0,8,49,15,0,64,204,16,284
1114411,10,6,16,55,42,3,100,186,22,308
1114412,4,0,4,6,20,0,26,157,31,214
1114413,6,0,6,57,19,0,76,180,10,266
1114414,16,0,16,73,28,9,110,254,15,379
1114415,25,4,29,13,12,0,25,117,4,146
1114416,13,0,13,39,21,0,60,124,12,196
1114417,9,6,15,105,25,4,134,327,38,499
1114418,0,0,0,3,17,0,20,392,45,457
1114419,0,0,0,36,12,0,48,153,13,214
1114420,0,0,0,15,6,0,21,72,9,102
1114421,14,6,20,66,30,3,99,241,9,349
1114422,10,0,10,92,30,7,129,237,28,394
1114423,8,0,8,98,48,0,146,335,32,513
1114424,4,0,4,72,36,6,114,257,22,393
1114425,16,3,19,86,29,9,124,267,35,426
1114426,8,9,17,106,48,4,158,272,18,448
1114427,8,6,14,53,32,0,85,266,60,411
1114428,9,6,15,97,34,3,134,291,28,453
1114429,10,0,10,79,24,3,106,193,21,320
1114430,6,3,9,72,50,3,125,204,28,357
1114431,0,0,0,78,63,8,149,314,21,484
1114432,0,0,0,70,41,6,117,197,15,329
1114433,10,0,10,86,51,4,141,320,35,496
1114434,10,0,10,75,34,6,115,221,14,350
1114435,12,0,12,73,31,0,104,308,34,446
1114436,6,0,6,42,37,4,83,418,38,539
1114437,7,4,11,74,24,0,98,251,33,382
1114438,6,0,6,44,15,0,59,131,15,205
1114439,3,0,3,64,23,0,87,168,12,267
1114440,8,0,8,65,37,0,102,204,15,321
1114441,8,0,8,53,18,6,77,192,21,290
1114442,22,6,28,52,31,9,92,210,16,318
1114443,9,3,15,64,22,6,92,250,18,360
1114444,110,10,120,82,34,0,116,422,46,584
1114445,10,0,10,86,40,3,129,284,43,456
1114446,6,6,12,38,24,3,65,221,10,296
1114447,6,3,9,60,28,3,91,183,9,283
1114448,3,3,6,44,12,0,56,107,7,170
1114501,6,0,6,52,17,4,73,161,15,249
1114502,8,0,8,95,31,10,136,263,32,431
1114503,9,0,9,87,24,6,117,195,15,327
1114504,9,0,9,61,37,0,98,182,11,291
1114505,44,8,52,104,31,4,139,281,26,446
1114506,0,0,0,0,0,0,0,0,0,0
1114507,4,0,4,30,34,3,67,213,16,296
1114508,3,0,3,76,19,6,101,144,19,264
1114509,6,3,9,63,29,4,96,202,20,318
1114510,6,4,10,69,32,4,105,282,22,409
1114511,5,0,5,60,20,3,83,165,19,267
1114512,8,3,11,49,31,6,86,213,23,322
1114513,0,0,0,25,9,4,38,122,18,178
1114514,0,0,0,57,28,3,88,142,14,244
1114515,3,0,3,54,26,9,89,211,13,313
1114516,12,3,15,102,49,4,155,334,31,520
1114517,7,0,7,56,34,0,90,238,17,345
1114518,0,0,0,98,33,0,131,269,21,421
1114519,9,0,9,63,29,3,95,172,16,283
1114520,14,3,17,84,36,0,120,234,30,384
1114521,17,4,21,52,22,3,77,142,28,247
1114522,14,0,17,36,21,0,57,227,24,308
1114523,13,3,16,81,26,3,110,299,22,431
1114524,9,0,9,51,26,0,77,160,10,247
1114525,8,0,8,55,29,0,84,157,9,250
1114526,7,0,7,56,24,9,89,219,19,327
1114527,6,0,6,63,43,0,106,192,40,338
1114528,0,0,0,69,46,3,118,241,64,423
1114529,6,0,6,67,34,0,101,261,39,401
1114530,0,0,0,18,3,0,21,55,6,82
1114531,8,6,14,62,22,6,90,203,9,302
1114532,6,0,6,49,21,0,70,173,15,258
1114533,6,0,6,85,28,8,121,246,15,382
1114534,11,3,14,82,30,3,115,231,24,370
1114535,7,3,10,84,35,3,122,314,24,460
1114536,4,0,4,33,21,0,54,128,3,185
1114537,8,0,8,39,31,0,70,167,17,254
1114538,7,3,10,69,32,0,101,236,31,368
1114539,17,0,17,89,26,0,115,270,9,394
1114601,8,0,8,47,21,3,71,158,12,241
1114602,6,0,6,62,14,4,80,246,38,364
1114603,20,0,20,66,23,0,89,344,32,465
1114604,29,4,33,37,32,0,69,200,31,300
1114605,8,6,14,59,37,0,96,303,40,439
1114606,0,3,3,83,43,6,132,179,27,338
1114607,3,0,3,75,18,6,99,179,15,293
1114608,6,0,6,64,43,4,111,143,23,277
1114609,8,0,8,118,35,11,164,294,36,494
1114610,16,6,22,101,44,0,145,229,18,392
1114611,9,0,13,94,36,5,135,246,12,393
1114612,8,0,8,64,37,0,101,202,28,331
1114613,7,5,12,37,17,3,57,171,11,239
1114614,14,5,19,122,63,6,191,341,32,564
1114615,6,0,6,43,18,9,70,298,20,388
1114616,6,0,6,63,31,7,101,251,21,373
1114617,9,0,9,43,44,0,87,286,15,388
1114618,3,0,3,34,30,0,64,335,26,425
1114619,0,3,3,36,12,0,48,117,9,174
1114620,4,0,4,44,31,6,81,123,3,207
1114621,6,0,6,50,18,6,74,73,27,174
1114622,7,0,7,102,37,9,148,241,21,410
1114623,0,0,0,74,28,9,111,165,7,283
1114624,0,0,0,79,22,6,107,183,30,320
1114625,0,0,0,96,33,12,141,205,3,349
1114626,4,0,4,138,51,4,193,289,16,498
1114627,7,0,10,107,52,10,169,275,19,463
1114628,0,0,0,74,58,12,144,149,9,302
1114629,6,4,10,70,42,0,112,206,10,328
1114630,0,0,0,87,69,9,165,256,24,445
1114631,7,3,10,64,53,0,117,176,10,303
1114632,0,0,0,54,33,6,93,176,32,301
1114633,56,0,56,24,29,0,53,214,18,285
1114634,7,4,11,81,50,4,135,226,10,371
1114635,15,0,15,105,42,0,147,329,14,490
1114636,7,0,7,73,25,7,105,216,26,347
1114637,0,0,0,124,58,4,186,261,19,466
1114638,4,0,4,12,4,0,16,17,0,33
1114639,6,3,9,14,14,0,28,186,21,235
1114640,3,0,3,99,32,0,131,265,37,433
1114641,9,3,12,76,30,0,106,158,24,288
1114642,7,3,10,75,27,6,108,170,18,296
1114643,8,0,8,69,34,9,112,225,11,348
1114644,3,3,6,66,20,6,92,203,20,315
1114645,11,3,14,118,53,7,178,256,35,469
1114646,6,3,12,80,37,6,123,293,37,453
1114701,3,6,9,132,28,3,163,225,28,416
1114702,0,0,0,125,18,3,146,231,9,386
1114703,0,0,0,66,11,3,80,115,28,223
1114704,9,0,9,74,39,7,120,201,21,342
1114705,3,6,9,98,23,6,127,228,30,385
1114706,0,0,0,65,21,3,89,119,15,223
1114707,0,0,0,0,0,0,0,0,0,0
1114708,0,0,0,98,24,4,126,211,15,352
1114709,3,0,3,65,17,12,94,138,9,241
1114710,0,0,0,3,3,0,6,6,0,12
1114711,12,0,12,102,28,9,139,200,9,348
1114712,0,0,0,83,32,5,120,189,44,353
1114713,6,0,9,124,24,3,151,300,33,484
1114714,3,0,3,35,9,0,44,100,24,168
1114715,3,0,3,39,13,0,52,85,9,146
1114716,30,0,30,29,7,3,39,179,15,233
1114717,0,0,0,6,10,3,19,47,3,69
1114718,0,0,0,52,11,6,69,159,16,244
1114719,3,0,3,47,18,12,77,124,21,222
1114720,3,10,13,72,16,12,100,174,21,295
1114721,7,0,7,86,46,10,142,174,6,322
1114722,3,3,9,101,28,6,135,214,18,367
1114723,0,0,0,136,6,9,151,132,24,307
1114724,3,0,3,98,28,6,132,209,24,365
1114801,6,0,6,79,34,5,118,203,16,337
1114802,3,0,6,86,38,9,133,177,6,316
1114803,6,0,6,58,20,0,78,143,4,225
1114804,8,3,11,89,52,0,141,235,27,403
1114805,6,0,6,56,30,0,86,164,12,262
1114806,0,0,0,0,0,0,0,0,0,0
1114807,3,0,3,61,22,3,86,177,14,277
1114808,7,3,10,87,38,5,130,192,45,367
1114809,3,0,3,52,42,6,100,141,9,250
1114810,8,3,11,78,33,3,114,227,25,366
1114811,3,0,3,90,27,14,131,207,17,355
1114812,0,0,0,0,0,0,0,0,0,0
1114813,3,0,3,75,17,13,105,183,11,299
1114814,0,0,0,26,23,0,49,109,9,167
1114815,0,0,0,59,14,11,84,109,12,205
1114816,0,0,0,53,15,7,75,138,12,225
1114817,0,0,0,0,0,0,0,0,0,0
1114818,3,0,3,31,9,4,44,108,4,156
1114819,0,0,0,59,12,3,74,104,9,187
1114820,4,0,4,41,26,6,73,138,31,242
1114821,5,0,5,86,33,6,125,196,6,327
1114822,12,9,21,48,54,16,118,261,22,401
1114823,0,0,0,47,23,5,75,123,18,216
1114824,26,0,26,87,38,0,125,261,24,410
1114825,16,4,20,74,50,0,124,239,24,387
1114826,3,0,3,131,51,15,197,267,48,512
1114827,4,4,8,91,36,7,134,238,22,394
1114828,6,0,6,57,21,3,81,180,25,286
1114829,8,0,8,44,21,0,65,152,27,244
1114830,6,0,6,79,31,4,114,125,21,260
1114831,3,0,3,81,31,11,123,186,11,320
1114901,0,0,0,0,0,0,0,0,0,0
1114902,14,0,14,127,30,6,163,202,19,384
1114903,8,0,8,44,17,0,61,263,26,350
1114904,3,0,3,36,8,0,44,106,9,159
1114905,3,6,9,82,44,3,129,252,28,409
1114906,6,3,9,34,6,0,40,102,9,151
1114907,3,3,6,82,20,3,105,219,25,349
1114908,3,7,10,77,42,0,119,434,61,614
1114909,9,0,9,75,33,3,111,224,16,351
1114910,4,0,4,49,13,0,62,158,30,250
1114911,6,3,9,72,45,6,123,324,33,480
1114912,35,4,39,68,46,0,114,245,25,384
1114913,0,3,3,22,24,0,46,209,24,279
1114914,6,3,9,45,22,6,73,195,15,283
1114915,15,0,15,61,25,0,86,215,9,310
1114916,3,0,3,75,39,0,114,314,13,441
1114917,0,5,5,57,44,9,110,481,40,631
1114918,3,0,3,21,17,3,41,221,22,284
1114919,7,0,7,45,27,0,72,427,55,554
1114920,3,3,6,31,15,3,49,259,26,334
1114921,5,12,17,49,59,3,111,515,90,716
1114922,9,3,12,51,25,0,76,333,41,450
1114923,10,0,10,61,29,0,90,413,49,552
1114924,4,0,4,52,19,3,74,332,43,449
1114925,3,3,6,68,15,0,83,339,30,452
1114926,0,0,0,75,30,0,105,443,40,588
1114927,47,4,51,57,32,3,92,382,37,511
1114928,9,0,9,79,32,0,111,331,44,486
1114929,45,3,48,55,47,0,102,443,76,621
1114930,3,0,3,56,28,3,87,351,32,470
1114931,6,3,9,54,25,6,85,156,11,252
1114932,7,0,7,58,32,3,93,471,61,625
1114933,6,0,6,47,29,9,85,215,10,310
1114934,7,3,10,88,53,9,150,326,30,506
1114935,3,0,3,65,38,6,109,237,3,349
1114936,6,9,15,68,25,0,93,173,28,294
1114937,10,0,10,53,29,3,85,267,77,429
1114938,4,3,7,39,28,0,67,336,32,435
1114939,12,3,15,109,35,0,144,278,19,441
1114940,0,0,0,0,0,0,0,7,0,7
1114941,3,0,3,39,29,3,71,371,15,457
1114942,4,0,7,53,22,3,78,146,9,233
1114943,8,6,14,73,35,3,111,200,22,333
1114944,4,0,4,38,25,6,69,90,3,162
1114945,9,0,9,28,41,0,69,330,124,523
1114946,7,0,7,42,39,0,81,328,10,419
1114947,18,6,24,19,20,0,39,305,29,373
1114948,5,3,8,42,32,0,74,320,38,432
1114949,4,0,4,36,18,0,54,311,15,380
1114950,9,6,15,23,24,4,51,288,39,378
1114951,7,0,7,25,18,0,43,329,51,423
1114952,4,0,4,57,46,3,106,335,22,463
1114953,9,0,9,40,51,3,94,484,117,695
1114954,5,4,9,41,52,0,93,303,36,432
1114955,7,0,7,39,18,0,57,217,19,293
1114956,81,9,90,47,81,0,128,666,190,984
1114957,6,0,6,45,35,0,80,223,12,315
1114958,4,3,7,59,9,3,71,135,16,222
1114959,4,0,4,83,13,3,99,144,15,258
1114960,8,3,11,66,27,4,97,156,33,286
1114961,7,3,10,74,20,4,98,214,20,332
1115001,6,0,6,61,28,0,89,177,18,284
1115002,6,6,12,100,37,4,141,259,15,415
1115003,9,0,9,102,47,11,160,302,10,472
1115004,6,4,10,79,54,0,133,252,21,406
1115005,9,6,15,83,22,6,111,211,25,347
1115006,7,0,7,138,44,10,192,246,17,455
1115007,4,6,10,62,23,7,92,189,18,299
1115008,27,0,27,53,17,3,73,298,32,403
1115009,10,0,10,58,22,0,80,179,9,268
1115010,3,5,8,53,29,7,89,180,18,287
1115011,3,0,3,71,59,0,130,205,6,341
1115012,3,0,3,44,13,0,57,105,10,172
1115013,4,0,4,28,28,3,59,120,0,179
1115014,37,0,37,114,37,6,157,339,27,523
1115015,4,0,4,97,28,5,130,213,33,376
1115016,4,0,4,52,24,4,80,121,12,213
1115017,4,0,4,99,39,9,147,284,29,460
1115018,0,0,0,51,21,3,75,140,6,221
1115019,4,3,7,86,46,7,139,232,26,397
1115020,3,3,6,79,17,6,102,133,24,259
1115021,16,0,16,84,30,3,117,226,26,369
1115022,9,4,13,122,63,12,197,313,31,541
1115023,0,0,0,93,34,6,133,170,6,309
1115024,126,13,139,63,23,0,86,372,36,494
1115025,0,0,0,54,8,0,62,113,0,175
1115026,6,3,9,35,29,3,67,227,28,322
1115027,8,0,8,104,68,5,177,333,42,552
1115028,11,3,14,29,15,0,44,112,12,168
1115029,16,3,19,98,38,3,139,218,12,369
1115030,9,0,9,95,31,9,135,268,22,425
1115031,6,0,6,128,47,10,185,213,18,416
1115032,0,0,0,62,34,3,99,147,12,258
1115033,11,3,14,95,55,7,157,295,24,476
1115034,6,0,6,55,18,6,79,133,18,230
1115035,0,4,4,91,22,6,119,164,13,296
1115036,7,0,7,159,43,13,215,256,28,499
1115037,4,0,4,43,18,0,61,151,6,218
1115038,10,0,10,66,31,3,100,160,0,260
1115039,9,0,9,55,18,0,73,157,14,244
1115040,10,3,13,107,56,12,175,282,36,493
1115041,3,0,3,91,33,9,133,189,18,340
1115042,6,0,6,92,24,6,122,193,11,326
1115043,0,0,0,3,0,0,3,3,3,9
1115044,0,0,0,51,33,4,88,136,15,239
1115101,24,21,45,85,32,0,117,354,80,551
1115102,0,0,0,20,12,3,35,106,7,148
1115103,4,0,4,47,18,3,68,150,8,226
1115104,7,0,7,54,28,0,82,168,12,262
1115105,0,0,0,49,24,0,73,195,24,292
1115106,0,0,0,34,15,6,55,81,12,148
1115107,8,0,8,25,12,0,37,108,27,172
1115108,3,0,3,59,27,0,86,219,27,332
1115109,3,0,3,33,10,3,46,152,33,231
1115110,0,0,0,56,20,4,80,209,29,318
1115111,22,0,22,96,38,13,147,374,35,556
1115112,11,3,14,66,30,0,96,261,32,389
1115113,0,0,0,0,0,0,0,0,0,0
1115114,0,0,0,59,15,3,77,162,15,254
1115201,7,0,7,76,39,0,115,280,31,426
1115202,10,3,13,42,25,6,73,196,19,288
1115203,10,10,20,53,13,0,66,206,20,292
1115204,8,0,8,48,18,3,69,342,86,497
1115205,12,3,15,80,27,7,114,216,48,378
1115206,17,3,20,63,27,0,90,270,27,387
1115207,4,0,4,49,13,0,62,152,27,241
1115208,21,3,24,80,22,3,105,298,38,441
1115209,4,0,4,26,14,4,44,174,22,240
1115210,15,3,21,68,22,6,96,248,32,376
1115211,6,4,10,48,26,0,74,262,25,361
1115212,31,0,31,31,27,3,61,264,35,360
1115213,9,6,15,51,26,3,80,196,24,300
1115214,54,0,54,50,28,9,87,397,25,509
1115215,0,0,0,0,0,0,0,10,0,10
1115216,12,0,12,50,19,4,73,247,36,356
1115217,11,6,17,22,16,3,41,227,20,288
1115218,16,5,21,73,26,3,102,376,62,540
1115219,12,10,22,44,13,3,60,271,35,366
1115220,3,0,3,38,12,0,50,144,29,223
1115221,26,7,40,37,24,3,64,390,47,501
1115222,8,3,11,25,20,7,52,180,24,256
1115223,0,0,0,0,0,0,0,0,0,0
1115224,0,0,0,21,12,0,33,59,0,92
1115225,0,3,3,42,30,5,77,211,49,337
1115226,6,3,9,40,11,0,51,178,21,250
1115227,40,20,63,12,9,0,21,185,30,236
1115228,22,3,25,34,15,3,52,309,15,376
1115229,6,0,6,50,21,4,75,195,27,297
1115230,7,3,10,60,23,4,87,230,27,344
1115231,14,6,20,59,31,0,90,301,24,415
1115232,8,3,11,38,18,3,59,226,22,307
1115233,5,0,5,102,27,0,129,313,37,479
1115234,7,101,108,20,6,0,26,121,159,306
1115235,10,3,13,43,16,0,59,239,32,330
1115236,0,0,0,21,16,0,37,148,18,203
1115301,3,0,3,61,4,0,65,182,11,258
1115302,0,0,0,31,7,4,42,107,6,155
1115303,6,3,9,114,29,6,149,295,23,467
1115304,4,0,4,56,21,3,80,318,30,428
1115305,0,0,0,21,4,0,25,124,26,175
1115306,3,3,6,13,9,0,22,156,26,204
1115307,6,0,6,75,52,0,127,259,20,406
1115308,3,3,6,34,20,0,54,138,26,218
1115309,4,0,4,27,8,0,35,128,13,176
1115310,0,0,0,31,6,0,37,135,6,178
1115311,0,0,0,53,27,0,80,212,39,331
1115312,3,0,3,19,9,4,32,164,28,224
1115313,6,0,6,62,30,0,92,227,7,326
1115314,0,4,4,38,6,3,47,126,13,186
1115315,6,0,6,60,29,0,89,246,27,362
1115316,4,0,4,107,23,16,146,266,30,442
1115401,59,51,110,27,19,3,49,342,102,493
1115402,0,0,0,0,0,0,0,0,0,0
1115403,0,0,0,0,0,0,0,0,0,0
1115404,13,6,19,23,6,3,32,151,23,206
1115405,13,0,13,51,22,0,73,382,41,496
1115406,4,0,4,31,21,0,52,209,30,291
1115407,7,3,10,26,15,0,41,137,22,200
1115408,23,0,23,47,21,0,68,285,25,378
1115409,59,7,66,15,12,0,27,256,32,315
1115410,9,0,9,26,13,6,45,223,25,293
1115411,12,12,24,44,10,0,54,211,32,297
1115412,20,12,32,44,13,4,61,231,24,316
1115413,10,3,13,55,32,0,87,396,59,542
1115414,8,3,11,53,33,6,92,219,32,343
1115415,16,6,22,31,10,0,41,207,33,281
1115416,10,4,14,42,19,6,67,197,26,290
1115417,0,0,0,0,0,0,0,12,0,12
1115418,11,3,14,21,13,0,34,150,32,216
1115419,12,0,12,20,14,0,34,134,18,186
1115501,3,0,3,95,35,3,133,234,21,388
1115502,5,0,5,52,23,0,75,162,32,269
1115503,0,0,0,32,18,3,53,88,12,153
1115504,3,0,3,52,26,3,81,260,15,356
1115505,7,0,7,36,21,3,60,135,17,212
1115506,0,0,0,36,22,4,62,148,35,245
1115507,0,0,0,42,15,0,57,113,25,195
1115508,6,0,6,47,23,0,70,146,37,253
1115509,3,0,3,49,31,0,80,155,16,251
1115510,3,0,3,41,24,3,68,259,17,344
1115511,8,0,8,62,30,9,101,252,36,389
1115512,5,3,8,70,32,6,108,267,42,417
1115513,6,3,9,36,16,0,52,108,20,180
1115514,14,3,17,40,34,6,80,227,59,366
1115515,13,3,16,66,21,0,87,153,30,270
1115516,34,3,37,37,19,0,56,185,24,265
1115517,49,0,49,61,19,6,86,242,27,355
1115518,4,3,7,61,12,5,78,107,20,205
1115519,45,5,50,50,28,4,82,257,28,367
1115520,10,3,13,30,9,0,39,149,28,216
1115521,6,0,6,77,30,6,113,279,18,410
1115522,9,0,9,85,29,7,121,279,24,424
1115523,6,0,6,49,23,0,72,120,8,200
1115524,8,0,8,57,15,6,78,165,15,258
1115525,6,0,6,44,20,0,64,129,34,227
1115526,8,0,8,50,22,9,81,232,18,331
1115527,43,3,46,53,23,6,82,217,13,312
1115528,6,3,9,56,21,8,85,130,24,239
1115529,6,3,9,61,28,0,89,165,32,286
1115530,6,0,6,47,18,0,65,198,20,283
1115531,3,0,3,34,18,0,52,138,15,205
1115532,3,0,3,81,27,6,114,304,27,445
1115533,0,0,0,29,9,3,41,125,10,176
1115534,6,0,6,39,10,3,52,152,21,225
1115535,0,0,0,0,3,0,3,0,472,475
1115536,0,0,0,28,20,6,54,121,21,196
1115537,0,0,0,0,3,0,3,75,9,87
1115538,6,3,9,39,12,3,54,228,46,328
1115539,0,0,0,3,0,4,7,56,0,63
1115540,16,0,16,52,39,3,94,245,8,347
1115601,6,3,9,26,20,0,46,167,24,237
1115602,4,0,4,37,18,3,58,229,23,310
1115603,5,0,5,42,18,3,63,208,22,293
1115604,3,0,3,41,21,3,65,188,15,268
1115605,7,0,7,39,6,0,45,172,30,247
1115606,6,0,6,43,15,3,61,150,15,226
1115607,0,0,0,30,18,3,51,140,26,217
1115608,3,0,3,40,18,6,64,144,37,245
1115609,8,0,8,48,17,3,68,226,10,304
1115610,3,3,6,29,13,0,42,146,26,214
1115611,14,0,14,58,27,0,85,192,33,310
1115612,0,0,0,64,26,0,90,190,18,298
1115613,3,0,3,58,15,3,76,122,3,201
1115614,12,0,12,41,10,0,51,224,33,308
1115615,3,3,6,57,27,9,93,234,28,355
1115616,4,0,4,22,9,0,31,126,23,180
1115617,9,3,12,14,9,6,29,131,15,175
1115618,6,3,9,20,3,0,23,133,15,171
1115619,3,0,3,41,9,4,54,171,12,237
1115620,3,3,6,77,32,0,109,225,32,366
1115621,0,0,0,34,20,3,57,113,12,182
1115622,0,0,0,53,19,0,72,211,24,307
1115623,0,0,0,46,9,7,62,190,20,272
1115624,8,0,8,94,28,10,132,283,24,439
1115625,3,0,3,33,22,0,55,153,27,235
1115626,3,0,3,40,9,0,49,158,18,225
1115627,0,0,0,37,20,4,61,170,18,249
1115628,0,0,0,36,21,0,57,204,32,293
1115701,21,8,29,52,31,6,89,283,52,424
1115702,3,0,3,26,9,3,38,147,22,207
1115703,0,0,0,34,19,0,53,111,0,164
1115704,13,0,13,55,24,8,87,210,24,321
1115705,5,0,5,16,35,3,54,147,18,219
1115706,11,0,11,53,7,4,64,148,15,227
1115707,4,3,7,21,19,0,40,116,19,175
1115708,0,0,0,42,10,3,55,126,9,190
1115709,3,3,6,47,13,4,64,240,23,327
1115710,67,9,76,18,15,3,36,236,33,305
1115711,12,5,17,47,19,9,75,198,37,310
1115712,5,0,5,32,21,6,59,122,9,190
1115713,5,0,5,49,22,3,74,146,32,252
1115714,7,3,10,49,34,6,89,232,28,349
1115715,5,0,5,24,16,6,46,96,0,142
1115801,20,0,20,41,21,0,62,275,46,383
1115802,9,4,13,35,20,3,58,359,36,453
1115803,8,0,8,36,21,0,57,184,10,251
1115804,12,9,21,85,45,8,138,256,39,433
1115805,37,9,46,33,19,0,52,389,56,497
1115806,15,7,22,31,19,0,50,244,41,335
1115807,0,0,0,0,0,0,0,0,0,0
1115808,0,0,0,0,0,0,0,0,0,0
1115809,17,0,17,28,7,0,35,156,22,213
1115810,6,0,6,45,21,0,66,180,6,252
1115811,7,0,7,79,21,3,103,212,29,344
1115812,0,0,0,0,0,0,0,3,0,3
1115813,8,5,13,42,31,0,73,164,5,242
1115814,9,3,12,77,23,0,100,303,43,446
1115815,4,0,4,42,17,0,59,166,28,253
1115816,13,9,22,56,19,3,78,322,45,445
1115817,82,6,88,35,21,0,56,292,19,367
1115818,10,3,13,61,26,3,90,285,31,406
1115819,14,4,18,39,14,3,56,195,36,287
1115901,7,3,10,56,24,0,80,237,25,342
1115902,3,3,6,40,6,3,49,126,27,202
1115903,9,3,12,67,28,6,101,266,24,391
1115904,0,0,0,15,3,0,18,62,9,89
1115905,7,0,7,143,40,5,188,442,50,680
1115906,3,0,3,70,23,0,93,187,28,308
1115907,5,0,5,36,12,0,48,127,7,182
1115908,3,0,3,57,27,0,84,190,13,287
1115909,6,0,6,73,42,8,123,271,16,410
1115910,3,6,9,36,7,0,43,153,15,211
1115911,0,0,0,51,24,9,84,191,9,284
1115912,4,0,4,36,6,3,45,165,19,229
1115913,3,0,3,23,7,0,30,71,9,110
1115914,3,0,3,46,17,0,63,170,19,252
1115915,0,0,0,38,18,3,59,206,20,285
1115916,3,0,3,43,12,0,55,254,12,321
1115917,0,0,0,40,24,6,70,160,13,243
1115918,9,0,9,48,19,3,70,154,21,245
1115919,0,0,0,0,5,5,10,50,0,60
1115920,7,3,10,31,23,7,61,340,29,430
1115921,3,3,6,32,4,0,36,135,21,192
1115922,0,0,0,45,16,0,61,85,10,156
1116001,11,0,11,45,31,6,82,314,32,428
1116002,22,4,26,16,14,0,30,224,25,279
1116003,10,0,10,32,0,3,35,154,16,205
1116004,36,4,40,29,11,0,40,207,7,254
1116005,7,0,7,49,6,7,62,188,13,263
1116006,8,3,11,67,19,0,86,191,30,307
1116007,11,9,20,40,18,3,61,212,25,298
1116008,3,3,6,18,13,0,31,106,9,146
1116009,3,3,6,48,11,3,62,192,40,294
1116010,0,0,0,0,0,0,0,0,0,0
1116011,3,0,3,21,0,0,21,81,12,114
1116012,0,0,0,0,0,0,0,0,0,0
1116013,3,0,3,51,25,3,79,274,22,375
1116014,5,0,5,44,9,0,53,209,18,280
1116015,5,3,8,20,13,3,36,257,38,331
1116016,10,7,17,25,21,3,49,164,16,229
1116017,11,0,11,58,27,7,92,278,15,385
1116101,8,0,8,52,14,0,66,224,11,301
1116201,0,0,0,82,12,6,100,198,15,313
1116202,0,0,0,39,7,0,46,113,4,163
1116203,0,0,0,60,17,7,84,166,12,262
1116204,3,0,3,111,22,9,142,294,15,451
1116205,7,0,7,29,6,0,35,140,10,185
1116206,6,4,10,73,36,6,115,226,13,354
1116207,4,3,7,35,12,6,53,165,15,233
1116208,12,0,12,23,21,0,44,186,16,246
1116209,0,0,0,43,10,0,53,97,12,162
1116210,6,0,6,113,31,15,159,239,21,419
1116211,3,3,6,54,18,3,75,178,20,273
1116212,8,0,8,32,9,0,41,109,12,162
1116213,68,3,71,9,3,0,12,226,30,268
1116214,7,0,7,40,15,6,61,134,9,204
1116215,0,0,0,50,26,0,76,164,15,255
1116216,0,0,0,20,9,0,29,65,15,109
1116217,0,0,0,43,17,3,63,202,28,293
1116218,5,0,5,68,29,9,106,236,9,351
1116219,7,0,7,27,13,0,40,180,16,236
1116220,3,0,3,52,30,4,86,173,18,277
1116221,3,3,6,21,15,5,41,145,3,189
1116222,6,0,6,27,18,0,45,152,18,215
1116223,10,6,16,45,11,3,59,157,33,249
1116224,14,0,14,22,23,0,45,238,19,302
1116225,11,0,11,38,18,0,56,161,21,238
1116226,0,0,0,3,0,0,3,6,6,15
1116227,0,0,0,24,12,0,36,153,16,205
1116228,12,6,18,17,17,0,34,187,24,245
1116229,11,0,11,89,29,0,118,279,31,428
1116230,6,0,6,83,31,0,114,231,24,369
1116231,6,3,9,23,10,0,33,219,16,268
1116232,16,7,23,38,34,3,75,310,43,428
1116233,0,0,0,0,0,0,0,13,0,13
1116234,5,0,5,40,26,0,66,147,21,234
1116235,3,4,7,38,19,3,60,128,9,197
1116236,7,0,7,55,17,6,78,159,6,243
1116237,6,0,6,83,28,4,115,288,20,423
1116238,0,3,3,12,3,0,15,91,6,112
1116239,11,0,11,31,14,6,51,249,26,326
1116240,0,0,0,0,0,0,0,0,0,0
1116241,9,3,12,29,12,9,50,173,23,246
1116242,9,6,15,34,15,0,49,267,50,366
1116243,7,6,13,57,17,3,77,243,37,357
1116244,17,0,17,43,20,3,66,237,13,316
1116245,5,0,5,24,15,0,39,132,6,177
1116246,7,0,7,39,15,4,58,179,5,242
1116247,37,73,110,15,28,3,46,314,136,496
1116248,0,0,0,58,16,3,77,231,17,325
1116249,38,13,54,36,27,6,69,424,55,548
1116250,0,0,0,0,0,0,0,0,0,0
1116251,7,0,7,24,12,3,39,99,6,144
1116301,3,0,3,72,30,6,108,180,7,295
1116302,6,0,6,60,25,3,88,163,19,270
1116303,17,7,24,58,39,0,97,391,32,520
1116304,22,7,29,68,33,0,101,256,27,384
1116305,4,0,4,68,36,0,104,240,15,359
1116306,6,3,9,39,20,3,62,150,15,227
1116307,72,7,79,74,25,6,105,500,39,644
1116308,6,3,9,97,34,6,137,248,34,419
1116309,4,0,4,71,18,0,89,236,16,341
1116310,15,0,15,45,18,0,63,212,15,290
1116311,3,3,6,103,28,6,137,286,22,445
1116312,12,0,12,94,23,3,120,238,4,362
1116313,9,0,9,71,19,0,90,158,15,263
1116314,3,3,6,47,6,3,56,148,6,210
1116315,11,3,14,26,30,3,59,342,97,498
1116316,9,3,15,28,15,3,46,254,39,339
1116317,49,3,52,34,17,6,57,223,18,298
1116318,10,0,10,64,27,9,100,213,20,333
1116319,0,0,0,0,0,0,0,0,0,0
1116320,77,12,92,40,30,0,70,312,43,425
1116321,10,0,10,60,28,0,88,173,9,270
1116322,9,3,12,49,16,0,65,182,21,268
1116323,38,5,43,23,12,4,39,205,18,262
1116324,6,6,12,33,28,7,68,155,18,241
1116325,0,0,0,0,0,0,0,0,0,0
1116326,4,0,4,88,27,10,125,240,6,371
1116327,7,0,7,99,19,0,118,183,7,308
1116328,3,0,3,41,24,0,65,157,3,225
1116329,3,0,3,49,12,9,70,149,3,222
1116330,3,3,6,46,15,9,70,124,10,204
1116331,0,0,0,51,9,4,64,132,15,211
1116332,10,0,10,60,18,3,81,185,13,279
1116333,9,3,12,59,19,6,84,145,3,232
1116334,0,3,3,57,37,0,94,172,24,290
1116335,0,4,4,41,16,3,60,244,40,344
1116336,3,0,3,47,24,3,74,175,29,278
1116337,3,0,3,77,12,17,106,168,16,290
1116338,9,3,12,84,27,3,114,179,12,305
1116339,9,3,15,74,34,6,114,247,14,375
1116340,7,0,7,47,19,0,66,130,9,205
1116341,6,3,9,114,31,6,151,378,21,550
1116342,6,3,12,111,30,0,141,241,30,412
1116343,0,0,0,65,18,15,98,179,27,304
1116344,0,0,0,39,8,5,52,121,6,179
1116345,6,0,6,56,11,6,73,191,24,288
1116346,4,6,10,78,34,12,124,300,29,453
1116347,3,3,6,51,18,0,69,124,18,211
1116348,4,3,7,57,22,4,83,129,21,233
1116349,16,3,19,81,28,3,112,243,18,373
1116350,7,0,10,113,37,5,155,261,29,445
1116351,8,0,8,40,20,6,66,233,22,321
1116352,10,0,10,81,41,4,126,205,15,346
1116353,3,0,3,54,31,7,92,145,12,249
1116354,0,0,0,87,19,0,106,272,24,402
1116355,5,4,9,64,9,7,80,219,24,323
1116356,10,3,13,23,11,6,40,159,25,224
1116357,10,0,10,31,40,0,71,267,56,394
1116358,7,3,10,65,34,3,102,276,27,405
1116359,10,4,14,92,42,9,143,287,16,446
1116360,13,3,19,79,36,3,118,207,15,340
1116361,6,0,6,83,36,0,119,260,17,396
1116362,122,11,133,24,3,0,27,304,29,360
1116363,5,0,5,98,44,7,149,300,23,472
1116364,3,0,3,91,29,9,129,281,10,420
1116365,3,3,6,75,25,3,103,163,18,284
1116366,8,3,11,53,28,4,85,222,16,323
1116367,13,0,13,61,32,4,97,450,32,579
1116401,3,0,3,28,22,0,50,171,70,291
1116402,6,0,6,48,32,0,80,316,31,427
1116403,0,0,0,4,0,0,4,25,5,34
1116404,0,0,0,49,16,0,65,143,24,232
1116405,0,0,0,110,29,9,148,194,9,351
1116406,136,13,149,33,8,0,41,432,59,532
1116407,8,6,14,86,37,6,129,290,64,483
1116408,9,0,9,78,39,3,120,243,29,392
1116409,3,0,3,45,21,9,75,159,30,264
1116410,43,6,49,53,38,6,97,450,48,595
1116411,14,10,24,30,37,0,67,366,69,502
1116412,6,6,12,41,13,0,54,252,19,325
1116413,15,0,15,62,27,0,89,327,49,465
1116414,3,3,6,24,17,4,45,250,24,319
1116415,6,0,6,28,14,0,42,155,15,212
1116416,6,3,9,59,26,0,85,211,27,323
1116417,7,0,7,24,18,9,51,117,3,171
1116418,11,3,14,37,30,3,70,244,21,335
1116419,27,6,33,41,48,15,104,319,47,470
1116420,16,0,16,37,22,0,59,251,48,358
1116421,64,5,69,57,15,6,78,350,50,478
1116422,9,0,9,91,34,9,134,343,38,515
1116423,7,3,10,86,36,11,133,251,17,401
1116424,0,0,0,119,41,15,175,221,18,414
1116425,3,0,3,115,39,6,160,250,23,433
1116426,9,0,9,58,16,5,79,220,11,310
1116427,18,8,26,52,33,3,88,280,51,419
1116428,8,0,8,46,34,0,80,242,22,344
1116429,32,4,36,31,12,0,43,206,22,271
1116430,0,0,0,79,25,6,110,181,29,320
1116431,6,0,6,38,9,0,47,134,24,205
1116432,41,23,64,12,7,0,19,181,33,233
1116433,0,0,0,91,26,7,124,163,18,305
1116434,32,5,37,3,25,0,28,355,49,432
1116435,0,0,0,0,0,0,0,0,0,0
1116436,8,0,8,37,12,0,49,95,31,175
1116437,0,0,0,0,6,0,6,6,3,15
1116438,3,0,3,56,21,6,83,168,21,272
1116501,9,0,9,79,20,3,102,174,16,292
1116502,0,0,0,32,18,6,56,142,12,210
1116503,4,3,7,29,18,6,53,109,24,186
1116504,0,0,0,27,11,0,38,159,32,229
1116505,3,0,3,61,25,3,89,220,15,324
1116506,3,0,3,54,20,6,80,210,18,308
1116507,0,3,3,50,18,3,71,225,21,317
1116508,0,3,3,16,18,0,34,66,17,117
1116509,3,0,3,48,37,4,89,230,13,332
1116510,7,0,7,25,4,6,35,122,12,169
1116511,0,0,0,42,8,3,53,131,34,218
1116512,0,0,0,64,6,0,70,145,12,227
1116513,0,0,0,63,18,6,87,204,23,314
1116514,0,0,0,47,19,0,66,184,16,266
1116515,6,0,6,36,9,0,45,188,28,261
1116516,6,6,12,46,17,0,63,300,35,398
1116601,3,0,3,31,18,3,52,97,6,155
1116602,3,0,3,31,27,6,64,172,18,254
1116603,0,29,29,45,25,0,70,163,73,306
1116604,13,0,13,82,36,12,130,217,24,371
1116605,10,0,10,73,20,6,99,170,17,286
1116606,5,0,5,80,21,10,111,178,18,307
1116607,6,0,6,90,36,3,129,199,10,338
1116608,6,0,6,67,15,7,89,184,7,280
1116609,38,52,90,41,15,0,56,219,90,365
1116610,4,0,4,52,18,6,76,127,12,215
1116611,6,0,10,110,35,0,145,240,40,425
1116612,3,0,3,50,18,3,71,193,16,280
1116613,0,0,0,29,8,0,37,60,9,106
1116614,8,0,8,86,42,4,132,304,17,453
1116615,6,0,6,55,30,0,85,221,18,324
1116616,6,0,6,39,21,0,60,134,17,211
1116617,0,0,0,0,0,0,0,9,0,9
1116618,0,0,3,81,15,0,96,201,19,316
1116619,7,0,7,91,34,9,134,310,26,470
1116620,3,0,3,86,20,0,106,202,12,320
1116621,4,0,4,50,16,3,69,172,23,264
1116622,0,0,0,69,29,3,101,190,32,323
1116623,4,0,4,31,19,0,50,128,3,181
1116624,9,0,9,48,23,4,75,145,9,229
1116625,7,0,7,19,23,6,48,149,13,210
1116626,9,3,12,46,25,6,77,203,32,312
1116627,0,0,0,62,18,3,83,157,9,249
1116628,8,0,8,27,9,0,36,117,20,173
1116629,8,5,13,55,33,4,92,171,24,287
1116701,5,0,5,47,19,0,66,180,21,267
1116702,24,6,30,57,22,0,79,301,37,417
1116703,28,0,28,35,4,4,43,206,7,256
1116704,13,3,16,41,11,6,58,139,18,215
1116705,3,3,6,25,29,0,54,161,21,236
1116706,4,0,4,27,15,0,42,173,17,232
1116707,0,0,0,3,0,0,3,18,0,21
1116708,7,0,7,79,32,6,117,295,24,436
1116709,3,0,3,32,10,3,45,158,23,226
1116710,3,0,3,36,9,0,45,153,6,204
1116711,3,0,6,46,23,3,72,205,28,305
1116712,3,0,3,24,12,0,36,112,12,160
1116713,6,6,12,58,37,0,95,321,25,441
1116714,12,0,12,65,26,3,94,220,16,330
1116715,0,0,0,59,29,0,88,240,16,344
1116801,4,0,4,82,28,10,120,286,36,442
1116802,3,3,6,19,3,0,22,140,19,181
1116803,5,0,5,54,20,6,80,269,24,373
1116804,0,0,0,58,12,3,73,150,3,226
1116805,3,0,3,84,26,6,116,199,21,336
1116806,0,0,0,89,55,4,148,333,18,499
1116807,0,0,0,37,13,6,56,139,18,213
1116808,0,4,4,58,25,7,90,190,33,313
1116809,8,4,12,29,23,0,52,215,17,284
1116810,0,0,0,8,0,0,8,29,3,40
1116811,0,0,0,35,4,0,39,117,13,169
1116812,3,0,3,56,30,0,86,267,21,374
1116813,9,0,9,73,17,0,90,179,9,278
1116814,6,0,6,27,10,0,37,118,16,171
1116815,0,0,0,91,30,9,130,284,21,435
1116816,11,3,14,68,29,0,97,237,17,351
1116817,6,0,6,28,6,0,34,135,6,175
1116818,48,4,52,35,22,0,57,223,27,307
1116819,7,4,11,69,32,3,104,252,29,385
1116820,11,3,14,45,17,0,62,242,37,341
1116821,0,0,0,25,6,0,31,78,4,113
1116822,0,0,0,44,17,6,67,255,26,348
1116823,0,0,0,30,17,0,47,176,9,232
1116824,4,0,4,52,26,0,78,203,10,291
1116825,3,0,3,90,34,0,124,199,8,331
1116826,3,4,7,34,11,0,45,106,4,155
1116827,3,0,3,26,9,0,35,111,0,146
1116828,0,0,0,0,0,0,0,0,0,0
1116829,0,0,0,51,19,3,73,168,13,254
1116901,25,7,32,61,23,0,84,299,29,412
1116902,3,0,3,49,12,6,67,168,27,262
1116903,69,6,75,39,12,3,54,264,31,349
1116904,6,4,10,57,28,3,88,176,8,272
1116905,12,0,12,48,14,3,65,140,16,221
1116906,0,0,0,20,9,3,32,78,3,113
1116907,6,0,6,65,22,5,92,228,21,341
1116908,4,0,4,45,21,3,69,163,10,242
1116909,0,0,0,49,30,0,79,204,25,308
1116910,0,0,0,41,26,0,67,119,12,198
1116911,6,0,6,39,25,3,67,186,13,266
1116912,6,0,6,71,18,4,93,147,14,254
1116913,0,3,3,55,21,9,85,196,30,311
1116914,8,0,8,26,15,0,41,187,12,240
1116915,12,0,12,106,38,6,150,250,12,412
1116916,6,3,12,78,30,3,111,284,26,421
1116917,0,0,0,35,21,3,59,127,21,207
1116918,6,0,6,94,40,8,142,214,24,380
1116919,8,0,8,68,21,3,92,179,12,283
1116920,6,3,9,36,28,7,71,152,26,249
1116921,0,0,0,39,16,0,55,127,17,199
1116922,14,6,20,77,18,12,107,245,44,396
1116923,5,0,5,45,25,3,73,180,41,294
1116924,11,3,14,37,15,6,58,147,18,223
1116925,4,0,4,17,6,9,32,121,5,158
1116926,0,7,7,48,29,3,80,187,25,292
1116927,0,0,0,23,12,3,38,65,12,115
1116928,0,0,0,52,14,3,69,187,31,287
1116929,10,3,13,63,23,0,86,251,47,384
1116930,4,0,4,44,13,0,57,124,28,209
1116931,12,7,19,54,30,0,84,267,53,404
1116932,8,4,12,32,8,0,40,153,9,202
1116933,6,6,12,42,24,3,69,160,24,253
1116934,9,0,9,48,21,3,72,142,13,227
1116935,10,3,13,56,31,0,87,198,27,312
1116936,5,0,5,18,12,6,36,111,31,178
1116937,8,3,11,66,38,0,104,132,16,252
1116938,9,0,9,34,25,0,59,160,18,237
1116939,7,0,7,51,19,3,73,128,12,213
1116940,10,4,14,27,21,0,48,168,48,264
1116941,4,6,10,30,19,0,49,180,25,254
1116942,7,0,7,42,15,0,57,135,25,217
1116943,12,3,15,60,35,9,104,264,28,396
1116944,3,3,6,24,28,0,52,140,22,214
1116945,8,0,8,32,8,0,40,115,15,170
1116946,0,0,0,63,12,0,75,157,36,268
1116947,4,3,7,15,12,3,30,98,12,140
1116948,10,0,10,57,30,12,99,272,31,402
1116949,13,3,16,94,42,10,146,274,42,462
1116950,54,8,62,44,11,3,58,206,42,306
1116951,0,0,0,7,6,3,16,45,3,64
1116952,92,5,97,20,10,0,30,316,32,378
1116953,0,0,0,3,3,0,6,63,11,80
1116954,4,6,10,41,27,0,68,241,33,342
1116955,6,0,6,48,15,5,68,199,21,288
1116956,0,0,0,50,20,3,73,175,7,255
1116957,9,4,13,42,31,4,77,195,16,288
1116958,18,0,18,46,6,3,55,186,13,254
1116959,4,0,4,54,23,9,86,219,23,328
1116960,68,15,83,29,10,3,42,241,25,308
1117001,8,0,8,79,50,0,129,505,44,678
1117002,0,0,0,0,0,0,0,0,0,0
1117003,0,0,0,25,12,0,37,115,20,172
1117004,6,3,9,43,15,4,62,152,30,244
1117005,0,0,0,32,21,0,53,253,30,336
1117006,16,0,16,43,19,3,65,234,24,323
1117007,0,0,0,18,17,0,35,137,22,194
1117008,7,6,13,40,17,0,57,229,30,316
1117009,0,0,0,0,0,0,0,0,0,0
1117010,7,0,7,43,19,0,62,164,18,244
1117011,0,0,0,0,0,0,0,0,0,0
1117012,7,0,7,75,17,9,101,325,31,457
1117013,8,0,8,49,25,3,77,158,17,252
1117014,5,0,5,56,17,10,83,244,18,345
1117015,11,0,11,56,32,0,88,308,21,417
1117016,3,0,3,39,13,3,55,142,16,213
1117017,0,0,0,43,17,4,64,164,18,246
1117018,0,0,0,0,0,0,0,0,0,0
1117019,3,3,6,24,14,0,38,161,28,227
1117020,6,0,6,32,20,0,52,228,12,292
1117021,0,0,0,60,24,3,87,158,25,270
1117022,3,0,3,52,29,3,84,190,59,333
1117023,0,0,0,37,15,6,58,185,14,257
1117024,3,0,3,38,25,0,63,168,33,264
1117025,0,3,3,48,24,0,72,126,15,213
1117026,0,3,3,32,9,0,41,150,16,207
1117027,6,3,9,38,30,3,71,251,7,329
1117028,4,0,4,47,14,3,64,138,11,213
1117029,0,0,0,16,14,0,30,78,3,111
1117030,3,0,3,23,6,0,29,112,15,156
1117031,4,0,4,50,25,4,79,224,30,333
1117032,0,0,0,75,35,0,110,239,29,378
1117033,3,8,11,49,15,0,64,208,8,280
1117034,4,0,4,61,22,0,83,320,22,425
1117035,0,0,0,0,0,0,0,7,0,7
1117036,0,0,0,15,0,0,15,59,3,77
1117037,11,3,14,20,11,3,34,232,33,299
1117038,0,0,0,27,14,0,41,117,13,171
1117039,4,0,4,45,28,3,76,191,24,291
1117101,6,3,9,37,17,0,54,142,21,217
1117102,3,3,6,60,27,3,90,259,24,373
1117103,7,0,7,49,20,3,72,165,15,252
1117104,10,0,10,56,15,4,75,173,34,282
1117105,6,6,12,69,11,3,83,201,39,323
1117106,8,0,8,76,40,0,116,275,19,410
1117107,9,0,9,84,32,4,120,220,22,362
1117108,3,0,3,64,31,0,95,236,33,364
1117109,0,0,0,44,28,0,72,200,9,281
1117110,6,0,6,47,19,0,66,120,6,192
1117111,4,7,11,49,17,3,69,241,16,326
1117112,4,3,7,25,11,3,39,82,14,135
1117113,6,3,9,50,14,3,67,185,18,270
1117114,41,7,48,31,11,0,42,200,17,259
1117115,7,0,7,32,15,0,47,140,16,203
1117201,3,0,3,80,30,7,117,196,16,329
1117202,3,0,3,113,38,3,154,226,15,395
1117203,7,0,7,74,26,8,108,219,12,339
1117204,0,0,0,74,27,5,106,165,15,286
1117205,7,0,7,80,32,3,115,205,23,343
1117206,3,3,6,141,24,10,175,265,24,464
1117207,3,0,3,57,25,0,82,241,25,348
1117208,0,0,0,94,35,0,129,232,20,381
1117209,0,0,0,83,28,4,115,122,10,247
1117210,3,0,3,88,40,7,135,167,19,321
1117211,0,0,0,75,25,3,103,167,9,279
1117212,0,3,3,61,29,9,99,172,19,290
1117213,5,0,5,57,21,0,78,171,9,258
1117214,4,7,11,69,24,3,96,281,27,404
1117215,8,3,11,48,23,8,79,145,12,236
1117216,8,0,8,53,21,6,80,163,8,251
1117217,5,3,8,70,32,4,106,300,25,431
1117218,4,0,4,43,17,0,60,127,8,195
1117219,48,10,58,28,8,0,36,294,34,364
1117220,3,0,3,117,29,4,150,250,38,438
1117221,35,0,35,159,36,17,212,420,25,657
1117222,32,3,35,73,17,0,90,229,27,346
1117223,3,0,3,203,33,6,242,231,24,497
1117224,4,0,4,45,15,7,67,213,45,325
1117225,0,0,0,36,12,3,51,81,6,138
1117226,0,0,0,39,9,0,48,84,6,138
1117227,0,0,0,130,38,6,174,285,21,480
1117228,6,3,9,57,14,6,77,231,26,334
1117229,0,3,3,76,28,0,104,316,39,459
1117230,3,0,3,0,3,0,3,3,0,6
1117301,0,0,0,20,9,0,29,66,0,95
1117302,3,0,3,64,13,9,86,119,14,219
1117303,0,0,0,42,15,0,57,133,21,211
1117304,0,0,0,67,12,8,87,169,67,323
1117305,9,0,9,64,21,4,89,205,22,316
1117306,4,3,7,72,22,10,104,259,53,416
1117307,10,7,17,92,42,3,137,295,41,473
1117308,5,0,5,32,14,0,46,140,36,222
1117309,19,0,19,97,26,0,123,277,29,429
1117310,3,0,3,24,6,0,30,113,11,154
1117311,11,6,17,83,31,7,121,273,50,444
1117312,8,3,11,73,23,0,96,220,42,358
1117313,3,6,9,32,9,0,41,128,28,197
1117314,7,7,14,46,31,4,81,196,37,314
1117315,6,0,6,44,31,0,75,182,12,269
1117316,0,4,4,58,19,3,80,194,14,288
1117317,0,0,0,66,18,0,84,121,10,215
1117318,14,3,17,55,37,0,92,222,27,341
1117319,7,0,7,36,15,4,55,203,34,292
1117320,0,0,0,46,32,4,82,204,10,296
1117321,3,3,6,83,34,3,120,296,12,428
1117322,0,0,0,90,35,0,125,172,7,304
1117323,0,0,0,18,6,0,24,57,3,84
1117324,0,0,0,52,10,3,65,139,6,210
1117325,3,0,3,60,13,0,73,115,21,209
1117326,3,3,6,76,9,0,85,167,30,282
1117401,5,0,5,33,14,3,50,206,20,276
1117402,44,7,51,61,23,0,84,316,26,426
1117403,4,7,11,77,35,3,115,272,21,408
1117404,14,6,20,58,19,4,81,312,70,463
1117405,7,3,10,90,38,3,131,236,24,391
1117406,6,4,10,79,41,9,129,301,17,447
1117407,3,3,6,56,33,5,94,309,39,442
1117408,5,3,8,64,19,3,86,211,36,333
1117409,14,3,17,44,22,3,69,293,41,403
1117410,0,0,0,105,25,7,137,227,47,411
1117411,6,6,12,62,23,3,88,194,18,300
1117412,9,0,9,28,21,3,52,131,30,213
1117413,0,3,3,56,27,3,86,217,12,315
1117414,125,14,139,20,25,4,49,388,38,475
1117415,9,3,12,91,45,6,142,266,30,438
1117416,3,0,3,52,36,0,88,251,23,362
1117417,32,0,32,65,22,0,87,202,19,308
1117418,10,0,10,92,21,6,119,261,21,401
1117419,0,0,0,0,0,0,0,6,0,6
1117420,0,0,0,0,0,0,0,0,0,0
1117421,0,0,0,0,0,0,0,4,0,4
1117422,0,0,0,0,0,0,0,6,0,6
1117423,7,3,10,33,15,3,51,162,33,246
1117424,6,3,9,35,9,0,44,173,18,235
1117425,29,0,29,60,26,4,90,249,21,360
1117426,4,0,4,52,29,0,81,320,51,452
1117427,13,3,16,21,12,0,33,145,30,208
1117428,3,0,3,44,31,0,75,225,27,327
1117429,0,0,0,57,14,6,77,135,0,212
1117501,13,0,13,96,25,6,127,230,6,363
1117502,0,0,0,53,16,0,69,121,3,193
1117503,4,0,4,63,26,0,89,201,23,313
1117504,0,0,0,57,27,3,87,196,13,296
1117505,8,4,12,62,27,3,92,225,27,344
1117506,0,0,0,86,17,0,103,119,4,226
1117507,0,0,0,89,18,0,107,194,13,314
1117508,3,0,3,107,23,9,139,240,13,392
1117509,30,6,36,44,30,0,74,246,36,356
1117510,0,0,0,30,13,6,49,123,9,181
1117511,3,3,6,61,14,9,84,199,43,326
1117512,0,0,0,49,19,0,68,138,12,218
1117513,3,0,3,82,17,0,99,165,21,285
1117514,3,0,6,88,29,0,117,180,6,303
1117515,0,0,0,43,21,0,64,66,43,173
1117516,0,0,0,51,39,0,90,206,7,303
1117517,0,0,0,54,36,7,97,155,16,268
1117518,4,0,4,46,16,3,65,120,13,198
1117519,3,0,3,41,10,0,51,147,24,222
1117520,0,0,0,44,12,0,56,99,12,167
1117521,0,0,0,31,17,3,51,126,20,197
1117522,20,0,20,59,33,6,98,182,34,314
1117523,4,0,4,55,24,8,87,175,27,289
1117524,6,3,9,42,25,9,76,160,43,279
1117525,0,0,0,61,21,6,88,131,4,223
1117526,3,0,3,52,11,3,66,88,24,178
1117527,3,3,9,45,22,3,70,167,17,254
1117528,39,5,44,61,33,6,100,325,41,466
1117529,6,0,6,62,18,6,86,134,13,233
1117530,0,0,0,0,0,0,0,6,0,6
1117531,0,0,0,51,18,6,75,169,12,256
1117532,0,0,0,35,3,0,38,72,0,110
1117533,0,0,0,29,11,4,44,118,7,169
1117534,0,0,0,13,4,0,17,70,8,95
1117601,4,0,4,83,40,0,123,274,59,456
1117602,6,0,6,55,16,3,74,139,9,222
1117603,4,0,4,45,30,0,75,179,18,272
1117604,10,0,10,92,25,4,121,281,24,426
1117605,6,3,9,61,44,6,111,251,31,393
1117606,6,4,10,39,33,9,81,179,16,276
1117607,0,3,3,89,35,3,127,282,46,455
1117608,3,3,6,47,23,3,73,182,26,281
1117609,0,0,0,58,14,0,72,216,22,310
1117610,15,3,18,76,32,8,116,314,38,468
1117611,3,0,3,53,21,0,74,260,32,366
1117612,14,3,17,38,35,0,73,221,38,332
1117613,8,3,15,66,35,0,101,282,51,434
1117614,39,6,45,46,21,3,70,288,30,388
1117615,10,0,10,67,35,6,108,212,22,342
1117616,5,0,5,37,25,0,62,182,28,272
1117617,3,0,3,43,24,0,67,199,12,278
1117618,3,0,3,41,10,7,58,128,17,203
1117619,4,0,4,34,22,0,56,165,9,230
1117620,6,3,9,72,45,0,117,237,39,393
1117621,7,0,7,36,12,0,48,220,27,295
1117622,10,3,16,70,38,3,111,217,24,352
1117623,4,0,4,49,25,3,77,97,8,182
1117624,3,0,3,36,21,3,60,179,31,270
1117625,3,0,3,16,7,0,23,97,12,132
1117626,0,0,0,3,0,0,3,0,0,3
1117627,3,0,3,53,21,4,78,242,25,345
1117628,3,0,3,72,49,0,121,270,17,408
1117629,22,3,25,11,0,4,15,114,23,152
1117630,7,3,10,29,9,3,41,130,17,188
1117631,0,0,0,62,26,3,91,162,13,266
1117632,3,0,3,61,29,0,90,198,18,306
1117633,0,0,0,102,37,10,149,261,11,421
1117634,6,0,6,120,62,0,182,353,21,556
1117635,0,0,0,33,17,3,53,108,12,173
1117636,7,0,7,83,44,3,130,350,35,515
1117701,3,0,3,36,20,0,56,185,25,266
1117702,6,0,6,32,12,3,47,117,15,179
1117703,0,0,0,27,5,0,32,100,17,149
1117704,21,0,21,50,17,4,71,207,28,306
1117705,3,0,3,41,22,0,63,172,24,259
1117706,5,0,5,20,9,0,29,96,7,132
1117707,3,0,3,53,21,3,77,105,13,195
1117708,7,3,10,45,3,0,48,126,9,183
1117709,8,0,8,28,19,0,47,117,9,173
1117710,3,0,3,28,3,0,31,87,11,129
1117711,0,0,0,31,9,0,40,109,15,164
1117712,0,0,0,53,19,0,72,170,12,254
1117801,0,0,0,75,16,3,94,112,4,210
1117802,5,0,5,62,29,7,98,191,35,324
1117803,0,0,0,30,24,6,60,87,23,170
1117804,0,0,0,45,23,4,72,129,16,217
1117805,3,0,3,58,14,0,72,207,17,296
1117806,0,0,0,0,0,0,0,0,0,0
1117807,6,3,9,18,15,0,33,170,29,232
1117808,0,0,0,48,29,0,77,98,15,190
1117809,0,0,0,54,12,0,66,71,9,146
1117810,0,0,0,9,15,0,24,61,0,85
1117811,4,0,4,34,15,0,49,135,17,201
1117812,6,3,9,27,15,0,42,163,21,226
1117813,11,3,14,36,20,0,56,169,34,259
1117814,0,0,0,36,10,0,46,165,33,244
1117815,7,20,27,36,21,6,63,188,54,305
1117816,0,0,0,0,3,0,3,13,0,16
1117817,0,0,0,54,29,9,92,231,21,344
1117818,3,0,3,48,12,9,69,82,8,159
1117819,3,3,6,53,20,0,73,127,12,212
1117820,7,0,7,34,23,0,57,126,6,189
1117821,3,0,3,61,38,3,102,200,24,326
1117822,6,0,6,37,12,0,49,132,30,211
1117901,3,3,6,61,17,0,78,162,31,271
1117902,0,0,0,8,10,0,18,90,6,114
1117903,0,3,3,71,30,3,104,199,36,339
1117904,3,3,6,45,15,0,60,174,44,278
1117905,3,0,3,27,7,3,37,134,16,187
1117906,3,3,6,87,12,0,99,200,24,323
1117907,3,3,6,81,16,0,97,229,27,353
1117908,14,8,22,62,16,6,84,232,49,365
1117909,3,3,6,45,22,0,67,167,37,271
1117910,3,3,6,52,21,0,73,207,40,320
1117911,3,0,3,16,10,0,26,115,9,150
1118001,4,0,4,31,7,3,41,136,3,180
1118002,0,0,0,23,9,0,32,85,12,129
1118003,8,0,8,68,22,4,94,255,12,361
1118004,16,9,25,46,25,3,74,245,36,355
1118005,6,3,12,37,25,4,66,165,23,254
1118006,11,3,14,45,12,0,57,183,35,275
1118007,8,3,11,60,31,6,97,217,35,349
1118008,6,0,6,30,24,6,60,155,24,239
1118009,7,11,18,18,6,0,24,88,21,133
1118010,6,3,9,32,12,0,44,124,13,181
1118011,5,3,8,64,23,0,87,150,33,270
1118012,6,0,6,71,27,7,105,227,37,369
1118013,6,3,9,94,35,0,129,329,36,494
1118014,0,0,0,0,0,0,0,3,0,3
1118015,0,0,0,0,0,0,0,6,0,6
1118016,0,0,0,0,0,0,0,0,0,0
1118017,15,34,49,43,13,0,56,120,75,251
1118018,3,3,6,41,12,0,53,98,12,163
1118019,4,0,4,12,0,3,15,43,3,61
1118020,3,3,6,60,24,8,92,237,15,344
1118021,3,3,9,31,13,0,44,114,13,171
1118101,3,0,3,44,20,3,67,179,15,261
1118102,10,0,10,72,31,0,103,271,39,413
1118103,0,3,3,45,8,0,53,105,15,173
1118104,3,6,9,59,11,8,78,147,16,241
1118105,0,0,0,29,9,0,38,82,14,134
1118106,3,0,3,67,23,6,96,175,25,296
1118107,0,0,0,0,0,0,0,0,0,0
1118108,5,0,5,55,20,0,75,189,13,277
1118109,10,0,10,56,24,9,89,174,28,291
1118110,8,3,14,28,20,3,51,193,18,262
1118111,0,4,4,77,21,3,101,161,26,288
1118112,3,6,9,27,10,3,40,138,17,195
1118113,3,0,3,35,13,0,48,195,12,255
1118114,3,0,3,83,21,6,110,197,15,322
1118115,7,3,10,60,27,0,87,194,14,295
1118116,11,3,14,71,27,4,102,295,26,423
1118117,3,0,3,40,19,0,59,120,11,190
1118118,10,0,10,41,27,6,74,236,13,323
1118119,11,0,11,39,26,3,68,234,32,334
1118120,6,4,10,57,8,0,65,196,24,285
1118201,4,0,4,36,18,3,57,109,21,187
1118202,0,0,0,0,0,0,0,0,0,0
1118203,10,9,19,39,9,6,54,151,33,238
1118204,7,3,10,53,16,0,69,191,28,288
1118205,0,0,0,49,11,0,60,141,16,217
1118206,3,3,6,42,20,0,62,110,15,187
1118207,7,4,11,37,33,4,74,215,46,335
1118208,0,0,0,31,14,0,45,116,16,177
1118209,0,0,0,49,18,0,67,114,7,188
1118210,0,0,0,41,22,0,63,128,18,209
1118211,0,5,5,64,26,0,90,154,33,277
1118212,4,4,8,35,19,6,60,172,23,255
1118213,9,4,13,61,16,0,77,251,28,356
1118214,3,3,6,63,28,3,94,181,36,311
1118215,18,3,21,42,20,6,68,195,18,281
1118216,25,6,31,23,12,3,38,203,25,266
1118217,27,6,33,44,16,0,60,167,33,260
1118218,6,0,6,43,13,0,56,140,35,231
1118219,13,8,24,54,19,0,73,276,42,391
1118220,3,0,3,50,27,6,83,203,21,307
1118221,6,6,12,31,20,0,51,140,26,217
1118222,7,6,13,64,35,5,104,231,41,376
1118223,0,0,0,0,0,0,0,0,0,0
1118224,0,0,0,66,13,6,85,126,4,215
1118301,0,4,4,54,12,6,72,107,10,189
1118302,7,0,7,54,28,3,85,262,23,370
1118303,7,0,7,25,12,0,37,128,10,175
1118304,10,3,13,18,20,0,38,183,21,242
1118305,38,5,43,73,31,3,107,319,39,465
1118306,9,6,15,33,6,0,39,189,38,266
1118307,0,0,0,16,13,0,29,86,30,145
1118308,5,0,5,49,11,0,60,184,32,276
1118309,3,0,3,33,25,0,58,136,37,231
1118310,7,0,7,45,15,0,60,126,12,198
1118311,0,0,0,49,12,0,61,115,15,191
1118312,3,0,3,61,26,0,87,197,21,305
1118313,3,0,3,44,26,6,76,139,18,233
1118314,4,0,4,37,9,0,46,132,16,194
1118315,0,0,0,69,25,0,94,204,44,342
1118316,3,0,3,60,24,3,87,199,12,298
1118317,4,0,4,80,40,9,129,257,39,425
1118318,3,0,3,77,20,0,97,163,26,286
1118319,0,4,4,69,32,9,110,170,14,294
1118320,3,3,6,42,20,0,62,132,21,215
1118321,0,0,0,22,6,0,28,81,5,114
1118322,0,0,0,6,13,0,19,37,0,56
1118401,7,0,7,18,24,3,45,368,38,451
1118402,0,0,0,44,21,6,71,93,9,173
1118403,0,0,0,69,26,3,98,302,31,431
1118404,7,0,7,32,28,0,60,166,36,262
1118405,0,0,0,3,6,3,12,52,9,73
1118406,33,4,37,8,6,0,14,128,21,163
1118407,8,7,15,62,23,4,89,287,53,429
1118408,8,0,8,46,14,3,63,224,40,327
1118409,22,6,28,35,18,3,56,190,33,279
1118410,0,0,0,59,21,9,89,149,18,256
1118411,0,0,0,102,24,6,132,154,6,292
1118412,0,0,0,76,25,3,104,190,14,308
1118413,0,0,0,49,22,0,71,163,9,243
1118414,3,3,6,40,37,3,80,167,13,260
1118415,7,0,7,58,16,3,77,207,22,306
1118501,7,0,7,49,17,0,66,207,13,286
1118502,0,0,0,71,31,5,107,207,18,332
1118503,19,8,27,56,25,0,81,339,40,460
1118504,24,10,34,42,11,0,53,236,43,332
1118505,9,0,9,73,31,5,109,360,59,528
1118506,6,0,6,45,30,0,75,264,34,373
1118507,3,0,3,37,19,3,59,116,9,184
1118508,0,0,0,51,11,0,62,121,13,196
1118509,3,0,3,56,15,0,71,116,11,198
1118510,0,0,0,53,23,3,79,173,24,276
1118511,3,0,6,29,7,0,36,106,6,148
1118512,0,0,0,63,14,0,77,167,5,249
1118513,3,3,6,40,16,0,56,155,21,232
1118514,0,0,0,20,6,3,29,85,13,127
1118515,4,6,10,46,9,6,61,140,9,210
1118516,12,11,23,51,22,3,76,207,44,327
1118517,5,0,8,65,26,0,91,240,25,356
1118518,15,6,21,35,26,3,64,203,37,304
1118519,3,40,43,46,17,0,63,206,94,363
1118520,13,0,13,33,20,0,53,171,24,248
1118521,6,0,6,51,15,3,69,147,30,246
1118522,0,0,0,20,18,0,38,96,16,150
1118523,18,3,21,56,18,0,74,217,41,332
1118524,6,0,6,52,26,3,81,201,34,316
1118525,3,0,3,41,26,6,73,181,21,275
1118526,16,19,35,23,24,3,50,194,38,282
1118527,3,0,3,78,33,0,111,218,21,350
1118601,0,0,0,3,32,0,35,790,33,858
1118602,3,0,3,62,32,9,103,248,12,363
1118603,4,0,4,79,29,3,111,262,10,383
1118604,0,0,0,122,35,7,164,291,27,482
1118605,4,0,4,70,44,6,120,264,7,391
1118606,3,0,3,62,14,6,82,184,17,283
1118607,0,0,0,29,10,3,42,306,61,409
1118608,7,0,7,46,17,4,67,192,27,286
1118609,10,4,14,81,32,0,113,214,12,339
1118610,3,0,3,41,18,0,59,149,24,232
1118611,0,0,0,35,14,0,49,154,4,207
1118612,8,0,8,79,21,4,104,189,28,321
1118613,0,3,3,34,16,3,53,201,17,271
1118614,3,0,3,73,19,6,98,202,32,332
1118615,9,0,9,79,22,0,101,265,28,394
1118616,13,0,13,61,19,0,80,255,9,344
1118617,0,0,0,54,30,0,84,182,4,270
1118618,0,6,6,86,30,0,116,287,31,434
1118619,0,0,0,22,30,3,55,99,12,166
1118620,3,3,6,76,28,3,107,202,11,320
1118621,6,0,6,53,21,0,74,208,9,291
1118622,9,3,12,66,36,4,106,216,32,354
1118623,6,0,6,60,28,3,91,234,21,346
1118624,5,0,5,86,45,6,137,304,29,470
1118625,6,0,6,27,14,0,41,118,19,178
1118626,3,0,3,37,18,7,62,138,18,218
1118627,4,3,7,61,29,6,96,211,36,343
1118628,0,0,0,56,17,0,73,128,12,213
1118629,9,3,12,69,16,0,85,185,24,294
1118630,3,0,3,57,30,10,97,254,74,425
1118631,8,6,14,18,18,3,39,220,66,325
1118632,5,0,5,58,23,3,84,256,25,365
1118633,5,6,11,35,8,0,43,188,38,269
1118634,0,0,0,36,11,3,50,128,9,187
1118635,3,0,3,32,10,0,42,104,19,165
1118636,6,3,9,48,22,11,81,174,37,292
1118637,7,3,13,86,31,10,127,264,33,424
1118638,3,5,8,66,26,8,100,264,32,396
1118639,3,0,3,37,20,6,63,192,31,286
1118640,7,4,11,54,28,3,85,223,23,331
1118641,8,0,8,73,31,3,107,218,35,360
1118642,77,7,84,63,17,9,89,330,17,436
1118643,32,16,48,44,26,0,70,347,73,490
1118644,8,3,11,71,36,3,110,302,34,446
1118645,8,3,11,45,32,3,80,191,38,309
1118646,0,0,0,34,3,0,37,121,15,173
1118647,6,0,6,50,24,4,78,139,15,232
1118648,6,0,6,56,20,0,76,233,33,342
1118649,0,0,0,93,23,4,120,211,64,395
1118650,0,0,0,67,21,3,91,205,52,348
1118651,4,0,4,67,19,0,86,198,18,302
1118652,35,0,35,65,16,7,88,212,19,319
1118653,3,3,6,30,13,6,49,151,13,213
1118654,7,4,11,94,31,6,131,341,85,557
1118701,10,0,10,64,30,3,97,240,42,379
1118702,4,0,4,54,17,0,71,172,36,279
1118703,36,3,39,55,27,8,90,291,48,429
1118704,18,0,18,81,39,6,126,297,50,473
1118705,0,0,0,28,13,0,41,106,0,147
1118706,3,0,3,75,25,0,100,144,3,247
1118707,3,0,3,64,22,0,86,257,17,360
1118708,0,0,0,72,13,0,85,162,6,253
1118709,3,3,6,36,9,0,45,138,6,189
1118710,4,0,4,63,13,0,76,89,3,168
1118711,4,0,4,42,18,6,66,154,20,240
1118712,0,0,0,48,13,9,70,151,24,245
1118801,3,3,6,67,29,0,96,201,20,317
1118802,5,3,8,48,21,3,72,198,36,306
1118803,7,3,10,56,38,3,97,240,33,370
1118804,15,8,23,35,22,0,57,165,38,260
1118805,0,0,0,84,33,3,120,188,21,329
1118806,0,0,0,89,15,3,107,169,17,293
1118807,0,0,0,64,23,9,96,173,14,283
1118808,4,3,7,34,25,0,59,163,15,237
1118809,3,0,3,22,13,0,35,100,9,144
1118810,4,0,4,61,35,0,96,252,16,364
1118811,0,0,0,31,8,0,39,114,25,178
1118812,0,0,0,40,10,0,50,112,0,162
1118813,0,0,0,36,13,0,49,87,6,142
1118814,0,0,0,62,20,3,85,153,18,256
1118815,0,0,0,48,14,3,65,169,17,251
1118816,6,0,6,45,19,0,64,128,12,204
1118817,0,0,0,59,27,3,89,138,3,230
1118818,3,0,3,47,23,4,74,170,31,275
1118819,0,0,0,31,9,3,43,104,12,159
1118901,0,3,3,26,6,0,32,130,18,180
1118902,10,0,10,36,5,4,45,188,0,233
1118903,35,3,38,47,16,0,63,214,17,294
1118904,6,3,9,41,10,3,54,136,9,199
1118905,6,3,9,39,11,3,53,230,25,308
1118906,3,0,3,38,8,0,46,121,30,197
1118907,0,0,0,61,22,0,83,207,20,310
1118908,3,0,3,77,15,4,96,182,18,296
1118909,3,0,3,17,9,0,26,83,8,117
1118910,3,0,3,23,0,0,23,92,6,121
1118911,4,0,4,52,14,0,66,139,10,215
1118912,0,0,0,31,6,0,37,87,6,130
1119001,0,0,0,37,6,6,49,115,9,173
1119002,3,3,6,59,40,0,99,236,26,361
1119003,11,0,11,20,16,0,36,206,33,275
1119004,0,0,0,46,12,0,58,180,20,258
1119005,6,0,6,43,14,3,60,162,21,243
1119006,3,0,3,56,23,8,87,166,31,284
1119007,4,0,4,31,17,0,48,151,27,226
1119008,9,0,9,55,12,0,67,199,33,299
1119009,15,0,15,57,15,9,81,275,33,389
1119010,8,6,14,58,33,0,91,253,37,381
1119011,6,3,9,54,20,3,77,131,24,232
1119012,43,3,46,48,26,3,77,239,33,349
1119013,21,6,27,84,30,6,120,375,45,540
1119014,3,3,6,31,23,0,54,153,12,219
1119015,9,0,9,49,20,4,73,220,18,311
1119016,7,4,11,48,10,0,58,140,21,219
1119017,25,3,28,52,23,0,75,253,25,353
1119018,0,0,0,59,15,6,80,214,35,329
1119019,3,0,3,22,12,0,34,68,6,108
1119020,0,0,0,23,19,0,42,119,11,172
1119021,7,0,7,78,18,6,102,283,141,526
1119022,0,0,0,64,21,3,88,176,19,283
1119023,4,0,4,30,10,7,47,119,10,176
1119024,3,0,3,32,24,0,56,120,15,191
1119025,0,0,0,22,18,0,40,150,3,193
1119101,0,0,0,69,28,7,104,223,31,358
1119102,6,0,6,68,33,0,101,173,10,284
1119103,0,0,0,56,31,3,90,152,19,261
1119104,3,0,6,31,22,3,56,101,23,180
1119105,3,3,6,40,7,0,47,166,12,225
1119106,7,6,13,64,37,6,107,268,22,397
1119107,6,3,9,74,8,0,82,177,27,286
1119108,7,3,10,61,15,3,79,147,22,248
1119109,4,0,4,46,21,3,70,170,27,267
1119110,8,4,12,63,28,0,91,208,25,324
1119111,6,0,6,79,40,6,125,287,39,451
1119112,8,3,11,59,26,6,91,223,27,341
1119113,4,0,4,80,23,12,115,264,27,406
1119114,14,0,14,86,36,0,122,318,35,475
1119115,11,84,95,12,15,0,27,76,149,252
1119116,3,0,3,27,15,0,42,108,10,160
1119117,6,0,6,84,32,3,119,242,19,380
1119118,6,3,9,57,28,0,85,277,46,408
1119119,11,0,11,78,33,3,114,266,22,402
1119120,12,0,12,89,23,3,115,171,10,296
1119121,8,0,8,53,22,3,78,149,12,239
1119122,4,0,4,85,27,0,112,186,12,310
1119123,31,0,31,54,21,5,80,318,43,441
1119124,6,4,10,65,23,6,94,231,22,347
1119125,13,3,16,104,38,10,152,258,33,443
1119126,0,0,0,36,15,7,58,109,14,181
1119127,8,4,12,61,18,0,79,228,44,351
1119128,3,0,3,48,30,0,78,147,26,251
1119201,6,0,6,28,18,6,52,151,21,224
1119202,11,0,11,30,11,0,41,119,16,176
1119203,6,0,6,34,10,4,48,135,11,194
1119204,5,0,5,34,18,3,55,117,6,178
1119205,4,0,4,42,18,3,63,205,12,280
1119206,14,0,20,59,22,3,84,215,20,319
1119207,6,0,6,58,7,0,65,219,32,316
1119208,5,0,5,63,19,3,85,211,12,308
1119209,0,0,0,25,12,3,40,109,12,161
1119210,3,0,3,58,23,6,87,219,30,336
1119211,0,3,3,70,22,0,92,200,24,316
1119212,6,0,6,100,39,13,152,239,29,420
1119213,0,0,0,48,23,6,77,139,21,237
1119214,0,0,0,41,9,3,53,90,7,150
1119215,0,0,0,103,12,3,118,325,31,474
1119301,12,0,12,23,18,0,41,168,23,232
1119302,3,0,3,74,13,0,87,156,6,249
1119303,3,0,3,45,6,0,51,96,0,147
1119304,0,0,0,52,15,6,73,167,11,251
1119305,4,0,4,15,6,0,21,77,0,98
1119306,3,0,3,44,15,0,59,182,15,256
1119307,0,0,0,58,30,3,91,128,9,228
1119308,6,0,6,53,15,0,68,132,10,210
1119309,0,0,0,53,16,6,75,183,6,264
1119310,0,0,0,60,5,3,68,119,6,193
1119311,3,0,3,25,9,0,34,116,15,165
1119312,0,0,0,43,9,0,52,99,18,169
1119313,9,0,9,30,16,0,46,144,18,208
1119314,0,0,0,39,23,3,65,167,11,243
1119315,27,0,27,50,23,0,73,187,19,279
1119316,13,4,17,67,25,4,96,283,32,411
1119317,0,0,0,40,15,0,55,158,20,233
1119318,8,0,8,35,6,0,41,137,15,193
1119319,33,4,37,35,12,6,53,266,34,353
1119320,0,0,0,27,9,0,36,123,13,172
1119401,0,0,0,14,6,0,20,79,15,114
1119402,12,0,12,45,28,0,73,212,33,318
1119403,3,0,3,53,36,0,89,215,28,332
1119404,7,0,7,51,23,0,74,181,20,275
1119405,6,4,10,36,5,0,41,130,14,185
1119406,3,0,3,38,16,3,57,239,35,331
1119407,6,0,6,43,16,6,65,211,12,288
1119408,6,0,6,61,22,0,83,190,20,293
1119409,0,3,3,37,20,0,57,107,13,177
1119410,0,9,9,23,9,3,35,128,27,190
1119411,6,0,6,26,13,0,39,128,9,176
1119412,3,0,3,36,16,0,52,232,72,356
1119413,3,0,3,17,12,0,29,102,48,179
1119414,0,0,0,52,19,0,71,165,5,241
1119415,8,0,8,21,20,0,41,154,25,220
1119416,23,0,23,19,18,3,40,166,16,222
1119417,22,3,25,44,4,0,48,188,12,248
1119418,4,0,4,53,34,10,97,176,30,303
1119419,3,0,3,54,12,0,66,164,15,245
1119420,3,0,3,23,0,4,27,76,6,109
1119421,0,0,0,14,3,0,17,68,3,88
1119422,6,0,6,37,27,3,67,216,17,300
1119423,3,3,6,23,9,3,35,114,21,170
1119424,3,3,6,26,12,3,41,95,21,157
1119501,0,0,0,9,0,0,9,26,0,35
1119502,0,0,0,34,19,0,53,127,16,196
1119503,0,0,0,41,15,3,59,229,143,431
1119504,12,3,15,97,44,3,144,265,37,446
1119505,3,3,6,60,19,9,88,132,21,241
1119506,3,0,3,40,19,3,62,194,64,320
1119507,0,0,0,67,10,0,77,119,21,217
1119508,8,0,8,55,32,0,87,252,30,369
1119509,49,0,49,23,7,4,34,249,54,337
1119510,0,0,0,84,24,9,117,240,13,370
1119511,6,0,6,76,18,3,97,195,27,319
1119512,0,0,0,11,6,0,17,40,6,63
1119513,0,0,0,82,21,3,106,172,19,297
1119514,0,0,0,65,9,6,80,159,28,267
1119515,3,0,3,50,22,4,76,112,19,207
1119516,0,0,0,69,18,7,94,189,41,324
1119517,4,4,8,49,27,3,79,186,89,354
1119518,3,0,3,41,12,0,53,133,34,220
1119519,7,3,10,63,23,0,86,267,88,441
1119520,7,0,10,33,19,4,56,196,74,326
1119521,0,0,0,39,19,0,58,133,59,250
1119522,3,0,3,65,23,0,88,144,29,261
1119523,0,0,0,70,24,5,99,132,12,243
1119524,0,0,0,0,0,0,0,0,0,0
1119525,0,0,0,0,0,0,0,0,6,6
1119601,0,0,0,22,22,0,44,157,15,216
1119602,0,0,0,17,6,0,23,86,10,119
1119603,0,0,0,42,8,0,50,79,12,141
1119604,0,0,0,60,18,7,85,109,9,203
1119605,6,3,9,93,14,6,113,289,27,429
1119606,0,0,0,82,15,0,97,150,14,261
1119607,0,0,0,36,30,12,78,60,0,138
1119608,0,3,3,67,39,20,126,144,17,287
1119609,0,0,0,26,18,18,62,74,3,139
1119610,0,0,0,18,9,0,27,44,6,77
1119611,0,0,0,46,15,0,61,72,7,140
1119612,0,0,0,86,22,4,112,187,12,311
1119613,0,0,0,50,6,0,56,104,18,178
1119614,3,0,3,67,12,3,82,213,43,338
1119615,0,0,0,52,10,4,66,120,8,194
1119616,3,0,3,63,18,0,81,157,21,259
1119617,3,0,3,49,10,6,65,123,33,221
1119618,3,0,3,106,42,6,154,297,23,474
1119701,4,3,7,47,12,0,59,126,12,197
1119702,0,3,3,36,19,3,58,152,28,238
1119703,9,0,9,45,27,6,78,135,15,228
1119704,0,0,0,37,20,0,57,107,7,171
1119705,3,0,3,70,18,9,97,173,6,276
1119706,10,0,10,50,30,6,86,184,37,307
1119707,6,3,9,36,9,6,51,164,18,233
1119708,4,0,4,41,22,3,66,224,36,326
1119709,3,0,3,68,16,0,84,131,7,222
1119710,0,0,0,59,22,3,84,138,45,267
1119711,9,0,9,41,11,3,55,152,28,235
1119712,3,0,3,52,15,4,71,106,12,189
1119713,6,0,6,44,17,10,71,157,14,242
1119714,4,0,4,42,16,0,58,212,33,303
1119715,0,0,0,64,15,6,85,146,22,253
1119716,0,0,0,3,0,0,3,12,0,15
1119717,54,4,58,44,23,6,73,238,25,336
1119718,0,3,3,39,14,3,56,80,24,160
1119719,5,0,5,36,27,6,69,131,20,220
1119720,3,0,3,47,20,0,67,109,25,201
1119721,0,0,0,113,29,8,150,255,30,435
1119722,8,0,8,76,24,0,100,238,25,363
1119801,3,0,3,56,28,7,91,228,47,366
1119802,14,0,14,33,8,0,41,125,17,183
1119803,4,0,4,75,21,0,96,217,20,333
1119804,0,0,0,83,18,0,101,160,23,284
1119805,3,0,3,36,6,3,45,106,7,158
1119806,3,0,3,40,17,0,57,135,22,214
1119807,0,0,0,35,14,3,52,80,6,138
1119808,3,3,6,78,35,0,113,264,38,415
1119809,3,0,3,46,24,0,70,137,9,216
1119810,3,0,3,18,0,0,18,101,8,127
1119811,3,0,3,67,25,0,92,193,31,316
1119812,3,0,3,45,15,0,60,167,31,258
1119813,3,0,3,104,43,11,158,225,34,417
1119814,8,0,8,53,24,3,80,189,29,298
1119901,6,0,6,71,24,8,103,224,50,377
1119902,3,0,3,63,21,8,92,192,21,305
1119903,7,0,7,61,34,3,98,214,32,344
1119904,9,3,12,41,23,0,64,167,21,252
1119905,11,3,14,69,31,6,106,226,44,376
1119906,7,0,7,65,24,0,89,212,39,340
1119907,12,0,12,79,28,12,119,253,10,382
1119908,7,3,10,62,34,9,105,225,33,363
1119909,30,6,36,28,6,0,34,151,33,218
1119910,0,0,0,38,13,0,51,104,6,161
1119911,0,0,0,39,9,0,48,75,6,129
1119912,3,0,3,102,26,4,132,210,37,379
1119913,5,0,5,54,32,9,95,198,28,321
1119914,0,0,0,48,17,0,65,183,25,273
1119915,6,3,9,122,32,9,163,322,42,527
1119916,20,45,65,71,33,7,111,319,121,551
1119917,10,0,10,43,9,0,52,157,10,219
1119918,7,3,10,44,34,3,81,269,38,388
1119919,9,0,9,70,27,6,103,187,29,319
1119920,3,0,3,34,7,3,44,71,7,122
1119921,9,0,9,109,49,10,168,320,56,544
1120001,6,0,6,84,24,0,108,294,52,454
1120002,4,0,4,75,16,0,91,183,29,303
1120003,13,3,16,63,16,9,88,237,29,354
1120004,0,0,0,29,0,0,29,88,20,137
1120005,3,0,3,56,10,0,66,106,23,195
1120006,7,0,7,62,19,0,81,207,20,308
1120007,3,0,3,69,6,3,78,159,9,246
1120008,0,0,0,43,14,0,57,132,17,206
1120009,0,0,0,44,26,0,70,100,15,185
1120010,3,0,3,67,16,0,83,184,23,290
1120011,0,3,3,43,8,0,51,106,18,175
1120012,0,0,0,94,22,3,119,285,22,426
1120013,3,3,6,74,13,0,87,140,14,241
1120101,13,0,13,90,28,0,118,298,38,454
1120102,3,0,3,10,12,0,22,148,7,177
1120103,8,0,8,42,22,3,67,208,15,290
1120104,5,0,5,30,15,3,48,183,19,250
1120105,10,0,10,57,19,9,85,207,37,329
1120106,11,0,11,70,30,3,103,254,29,386
1120107,10,0,10,32,10,0,42,165,10,217
1120108,47,0,47,32,18,3,53,281,15,349
1120109,8,3,11,46,8,6,60,135,16,211
1120110,3,0,3,67,19,6,92,159,24,275
1120111,0,0,0,38,18,3,59,217,25,301
1120112,3,0,3,31,8,0,39,141,12,192
1120113,3,3,6,45,24,3,72,177,15,264
1120114,0,0,0,47,12,0,59,162,11,232
1120115,6,0,6,91,21,3,115,216,29,360
1120116,14,3,17,64,27,3,94,274,33,401
1120117,5,0,5,50,20,3,73,230,41,344
1120118,0,0,0,52,15,0,67,106,8,181
1120119,0,0,0,51,15,0,66,170,11,247
1120120,0,0,0,36,9,4,49,100,25,174
1120121,3,0,3,46,14,3,63,229,28,320
1120122,3,0,3,18,3,0,21,39,0,60
1120201,0,0,0,129,41,3,173,255,25,453
1120202,4,0,4,35,12,0,47,136,7,190
1120203,6,0,6,88,36,3,127,184,15,326
1120204,0,0,0,164,77,10,251,399,41,691
1120205,6,3,9,126,21,7,154,223,21,398
1120206,3,0,3,64,25,0,89,148,21,258
1120207,6,0,6,126,61,10,197,297,9,503
1120208,4,0,4,52,24,3,79,150,24,253
1120209,0,0,0,105,43,3,151,275,27,453
1120210,4,0,4,23,12,3,38,129,22,189
1120211,0,0,0,4,14,0,18,172,9,199
1120212,6,3,9,71,41,3,115,192,24,331
1120213,0,0,0,44,24,3,71,139,12,222
1120214,3,0,3,106,44,8,158,222,18,398
1120215,7,0,7,35,10,3,48,142,18,208
1120216,0,3,3,42,16,3,61,125,13,199
1120217,7,6,13,40,9,0,49,114,19,182
1120218,7,3,10,48,24,0,72,172,30,274
1120219,5,0,5,69,18,0,87,158,25,270
1120220,4,0,4,59,41,3,103,237,23,363
1120221,0,3,3,34,18,0,52,93,18,163
1120222,0,0,0,50,15,6,71,105,6,182
1120223,0,0,0,91,43,8,142,202,12,356
1120224,18,0,18,24,20,0,44,127,6,177
1120225,13,6,19,63,31,3,97,260,41,398
1120226,9,3,12,46,25,3,74,164,28,266
1120227,7,5,12,36,25,3,64,279,32,375
1120228,6,6,12,34,15,0,49,140,30,219
1120229,0,0,0,0,0,0,0,0,0,0
1120230,7,0,7,49,22,0,71,178,27,276
1120231,7,3,10,68,32,0,100,306,74,480
1120232,9,3,12,44,16,0,60,204,50,314
1120233,4,0,4,18,3,0,21,91,14,126
1120234,7,0,7,34,20,0,54,176,22,252
1120235,11,3,14,68,25,0,93,266,41,400
1120236,7,0,7,36,24,0,60,167,42,269
1120237,5,3,8,53,32,4,89,228,55,372
1120238,0,4,4,33,11,3,47,109,25,181
1120239,0,0,0,48,30,3,81,186,33,300
1120240,5,0,5,72,28,6,106,212,30,348
1120241,8,3,11,71,41,7,119,226,24,369
1120242,5,0,5,47,11,3,61,150,27,238
1120243,12,0,12,73,40,6,119,207,20,346
1120244,8,3,11,64,42,9,115,226,19,360
1120245,4,0,4,69,37,0,106,180,23,309
1120246,8,0,8,46,49,9,104,181,8,293
1120247,0,0,0,48,0,4,52,110,3,165
1120248,8,0,8,79,36,9,124,228,27,379
1120249,6,0,6,62,13,0,75,130,12,217
1120250,0,0,0,86,28,0,114,213,24,351
1120251,5,3,8,69,30,0,99,211,41,351
1120252,8,0,8,46,21,6,73,144,15,232
1120253,9,0,9,56,19,3,78,197,29,304
1120301,8,0,8,62,26,0,88,194,9,291
1120302,24,7,31,46,13,0,59,236,36,331
1120303,19,3,22,46,4,0,50,150,20,220
1120304,13,3,16,13,17,0,30,151,125,306
1120305,21,6,27,34,21,0,55,192,28,275
1120306,63,45,108,40,19,0,59,317,91,467
1120307,9,3,12,50,10,3,63,153,37,253
1120308,9,3,12,44,25,0,69,171,36,276
1120309,67,0,67,55,19,3,77,331,18,426
1120310,0,0,0,33,10,0,43,156,39,238
1120311,7,0,7,26,9,0,35,124,51,210
1120312,6,0,6,41,22,0,63,143,24,230
1120313,7,3,10,28,24,6,58,154,21,233
1120314,7,0,7,78,41,0,119,247,33,399
1120315,14,4,18,48,30,3,81,218,28,327
1120316,11,0,11,42,26,3,71,222,20,313
1120317,8,3,11,33,9,9,51,184,24,259
1120318,0,0,0,78,23,10,111,221,17,349
1120319,7,3,10,60,23,6,89,264,45,398
1120320,7,0,7,78,31,6,115,278,36,429
1120321,24,3,27,43,16,5,64,206,32,302
1120322,9,3,12,82,36,0,118,288,36,442
1120323,3,0,3,60,17,3,80,215,37,332
1120324,0,3,3,48,29,9,86,219,54,359
1120325,0,0,0,184,40,6,230,347,45,622
1120326,55,3,58,55,42,4,101,319,23,443
1120327,5,0,5,64,32,10,106,179,18,303
1120328,0,0,0,57,23,4,84,182,6,272
1120329,3,3,6,97,41,7,145,207,23,375
1120330,0,3,3,79,30,0,109,190,23,322
1120331,0,0,0,6,3,0,9,22,6,37
1120332,0,0,0,0,6,0,6,0,0,6
1120333,3,0,3,58,17,0,75,166,19,260
1120334,0,3,3,46,17,0,63,105,16,184
1120335,4,0,4,100,31,4,135,225,28,388
1120336,0,0,0,46,15,0,61,96,21,178
1120401,5,0,5,7,0,0,7,29,3,39
1120402,3,0,3,40,30,4,74,152,21,247
1120403,0,0,0,81,20,0,101,154,6,261
1120404,3,0,3,48,19,6,73,148,13,234
1120405,0,0,0,41,21,6,68,164,29,261
1120406,0,0,0,50,21,0,71,126,44,241
1120407,3,0,3,143,33,12,188,297,32,517
1120408,0,0,0,111,35,6,152,182,31,365
1120409,4,0,4,82,28,6,116,149,22,287
1120410,3,0,3,65,25,7,97,142,36,275
1120411,0,0,0,88,20,4,112,192,42,346
1120412,5,0,5,92,10,4,106,244,46,396
1120413,8,0,8,51,39,0,90,201,12,303
1120501,0,0,0,13,6,0,19,58,9,86
1120502,0,0,0,44,0,0,44,76,11,131
1120503,0,0,0,37,17,0,54,87,6,147
1120504,0,0,0,37,7,0,44,106,9,159
1120505,3,0,3,53,18,0,71,83,14,168
1120506,5,0,5,83,41,6,130,302,28,460
1120507,0,0,0,58,21,0,79,257,21,357
1120508,0,0,0,31,14,0,45,163,7,215
1120509,0,0,0,36,19,0,55,106,17,178
1120510,3,0,3,56,15,0,71,124,3,198
1120511,3,0,3,45,24,0,69,81,6,156
1120512,6,3,9,268,60,18,346,442,34,822
1120513,6,0,6,63,24,7,94,160,12,266
1120514,19,0,19,77,56,14,147,386,26,559
1120515,6,0,6,47,29,3,79,147,24,250
1120516,0,0,0,36,15,0,51,167,27,245
1120517,6,0,6,62,19,0,81,207,14,302
1120518,4,0,4,44,16,3,63,175,18,256
1120519,0,0,0,35,7,6,48,121,15,184
1120520,0,0,0,21,6,0,27,77,0,104
1120521,0,0,0,34,16,0,50,83,0,133
1120522,8,5,13,20,18,4,42,172,18,232
1120523,23,6,32,43,15,4,62,242,29,333
1120524,6,0,6,29,12,0,41,153,27,221
1120525,3,0,3,30,3,3,36,134,24,194
1120526,7,6,13,57,17,0,74,203,34,311
1120527,0,0,0,58,36,0,94,201,11,306
1120528,3,0,3,67,21,3,91,216,21,328
1120529,8,0,8,72,41,6,119,311,16,446
1120530,0,0,0,14,6,0,20,105,19,144
1120531,7,0,7,46,28,4,78,205,32,315
1120532,9,0,9,47,20,3,70,228,18,316
1120533,3,0,3,54,24,0,78,190,24,292
1120534,10,0,10,33,12,3,48,176,12,236
1120535,21,0,21,30,17,3,50,143,20,213
1120536,6,0,6,29,8,5,42,164,18,224
1120537,0,0,0,55,15,6,76,163,25,264
1120538,4,0,4,94,32,3,129,255,19,403
1120539,0,0,0,50,14,0,64,115,0,179
1120540,0,0,0,28,12,0,40,65,4,109
1120541,7,0,7,49,18,0,67,159,15,241
1120542,4,0,4,66,25,4,95,218,9,322
1120543,3,0,3,59,22,3,84,189,12,285
1120544,6,0,6,73,23,0,96,182,22,300
1120545,3,3,6,60,15,4,79,152,27,258
1120546,3,0,3,57,12,5,74,171,15,260
1120547,0,3,3,90,32,4,126,161,36,323
1120548,3,0,3,51,27,6,84,173,26,283
1120549,0,0,0,54,26,0,80,114,0,194
1120550,52,6,58,74,22,6,102,288,30,420
1120551,0,0,0,35,9,0,44,87,3,134
1120552,0,0,0,98,28,9,135,172,12,319
1120601,3,0,3,9,21,0,30,114,6,150
1120602,3,0,3,43,34,0,77,156,27,260
1120603,0,0,0,50,31,0,81,118,7,206
1120604,0,0,0,53,36,0,89,184,7,280
1120605,0,0,0,74,33,8,115,208,21,344
1120606,15,6,21,51,42,0,93,281,39,413
1120607,0,0,0,0,0,0,0,0,0,0
1120608,8,0,8,42,14,0,56,157,31,244
1120609,19,30,49,57,35,0,92,229,84,405
1120610,5,0,5,109,43,6,158,285,41,484
1120611,7,0,7,91,20,9,120,190,28,338
1120612,0,0,0,95,49,3,147,251,18,416
1120613,0,0,0,57,18,0,75,160,16,251
1120614,3,0,3,71,19,0,90,146,9,245
1120615,6,0,6,98,63,0,161,272,28,461
1120616,7,0,7,65,35,0,100,186,38,324
1120617,0,0,0,31,28,3,62,153,27,242
1120618,4,0,4,77,32,4,113,195,11,319
1120619,7,0,7,80,44,4,128,272,39,439
1120620,4,0,4,65,55,3,123,266,18,407
1120621,3,0,3,101,34,0,135,197,14,346
1120622,8,3,11,51,30,0,81,204,21,306
1120623,7,3,10,110,46,3,159,305,32,496
1120624,0,0,0,62,35,0,97,197,5,299
1120625,3,0,3,95,21,6,122,145,14,281
1120626,3,0,3,94,45,11,150,283,16,449
1120627,4,0,4,117,47,3,167,269,12,448
1120628,7,0,7,70,34,6,110,192,13,315
1120629,14,3,17,25,27,0,52,258,28,338
1120630,7,3,10,30,39,0,69,181,30,280
1120631,7,3,10,56,19,4,79,192,33,304
1120632,3,0,3,58,24,0,82,160,17,259
1120633,69,12,81,53,21,0,74,357,59,490
1120634,6,0,6,102,32,9,143,230,29,402
1120635,77,3,80,34,19,0,53,233,27,313
1120636,3,0,3,51,19,0,70,170,19,259
1120637,8,6,17,70,29,0,99,181,29,309
1120638,10,0,10,93,48,4,145,275,32,452
1120639,11,3,14,47,31,3,81,251,35,367
1120640,0,0,0,74,35,6,115,261,24,400
1120641,3,0,3,104,47,0,151,180,0,331
1120642,18,3,21,39,30,0,69,187,23,279
1120701,3,4,7,75,37,0,112,224,36,372
1120702,12,0,12,91,32,3,126,216,28,370
1120703,3,0,3,62,50,0,112,177,32,321
1120704,6,0,6,41,22,0,63,113,10,186
1120705,5,0,5,50,40,3,93,226,29,348
1120706,4,3,7,39,27,3,69,174,29,272
1120707,9,0,9,49,36,0,85,246,38,369
1120708,8,6,14,64,26,0,90,259,22,371
1120709,8,0,8,71,41,3,115,222,47,384
1120710,0,0,0,0,0,0,0,0,0,0
1120711,9,3,12,47,26,0,73,192,15,280
1120712,18,0,18,44,29,6,79,338,52,469
1120713,10,3,13,42,18,0,60,161,15,236
1120714,0,0,0,0,0,0,0,0,0,0
1120715,9,4,13,95,52,5,152,280,33,465
1120716,4,0,4,37,23,0,60,150,11,221
1120801,13,3,16,78,27,3,108,183,20,311
1120802,3,3,6,54,14,3,71,170,12,253
1120803,6,0,6,26,18,6,50,179,19,248
1120804,0,0,0,50,5,6,61,111,6,178
1120805,11,0,11,74,54,10,138,230,21,389
1120806,4,3,7,58,21,9,88,124,13,225
1120807,4,0,4,63,39,3,105,220,6,331
1120808,3,0,3,80,31,3,114,208,11,333
1120809,6,0,6,53,16,0,69,142,11,222
1120810,9,0,9,62,29,0,91,189,22,302
1120811,8,0,8,68,31,4,103,194,12,309
1120812,6,3,9,58,18,6,82,174,15,271
1120813,9,3,12,44,30,3,77,162,25,264
1120814,6,0,6,58,40,0,98,261,24,383
1120815,7,3,10,60,31,6,97,209,15,321
1120816,6,0,6,57,26,4,87,157,15,259
1120817,7,0,7,89,43,4,136,253,20,409
1120818,13,0,13,40,30,3,73,203,26,302
1120819,9,0,9,60,25,0,85,253,21,359
1120820,8,0,8,56,21,0,77,208,13,298
1120821,15,6,21,77,20,0,97,202,47,346
1120822,0,0,0,73,41,6,120,227,12,359
1120823,0,0,0,0,0,0,0,0,0,0
1120824,0,0,0,35,14,6,55,99,10,164
1120825,0,0,0,71,28,5,104,208,22,334
1120826,3,0,3,95,61,3,159,239,11,409
1120827,6,0,6,97,41,6,144,250,17,411
1120828,9,0,9,69,32,3,104,224,6,334
1120829,6,0,6,55,28,0,83,129,8,220
1120830,0,0,0,39,38,0,77,146,7,230
1120831,0,0,0,70,25,3,98,127,15,240
1120832,3,0,3,54,18,0,72,148,9,229
1120833,6,0,6,48,27,0,75,137,24,236
1120834,4,3,7,63,25,3,91,130,6,227
1120835,20,5,25,54,43,9,106,217,20,343
1120836,0,0,0,96,24,0,120,234,36,390
1120837,4,0,4,63,42,5,110,196,21,327
1120838,0,0,0,43,36,6,85,135,13,233
1120839,59,6,65,44,26,0,70,275,25,370
1120840,4,6,10,75,36,6,117,217,29,363
1120841,3,0,3,70,50,3,123,241,18,382
1120842,16,0,16,46,24,15,85,153,8,246
1120843,3,3,6,33,12,0,45,187,16,248
1120844,10,0,10,24,15,3,42,158,16,216
1120845,3,0,3,56,22,0,78,220,15,313
1120846,0,0,0,116,24,4,144,144,6,294
1120847,0,3,3,44,18,3,65,135,15,215
1120848,3,0,3,49,35,0,84,178,18,280
1120849,7,0,7,70,49,3,122,187,12,321
1120850,3,0,3,49,18,0,67,149,3,219
1120851,14,0,14,37,10,0,47,165,23,235
1120852,7,3,10,60,32,0,92,179,20,291
1120853,0,3,3,41,26,3,70,186,18,274
1120854,3,3,6,48,25,3,76,124,17,217
1120855,14,3,17,111,31,9,151,295,23,469
1120856,8,0,8,43,33,5,81,153,14,248
1120857,6,0,6,47,33,7,87,173,17,277
1120858,7,0,7,45,40,0,85,234,28,347
1120859,8,3,11,69,35,0,104,259,23,386
1120860,11,3,14,90,44,0,134,286,38,458
1120861,8,3,11,55,13,8,76,139,33,248
1120862,6,0,6,63,29,7,99,246,22,367
1120863,12,9,21,34,28,0,62,261,27,350
1120864,0,0,0,94,17,6,117,172,12,301
1120865,4,0,4,0,0,0,0,18,0,18
1120866,3,0,3,42,15,7,64,106,5,175
1120901,54,0,54,62,29,0,91,265,30,386
1120902,0,0,0,0,0,0,0,0,3,3
1120903,0,0,0,57,23,9,89,171,14,274
1120904,4,0,4,56,34,0,90,172,0,262
1120905,9,6,15,61,35,0,96,266,35,397
1120906,10,0,10,84,38,0,122,273,25,420
1120907,13,3,16,54,25,4,83,258,24,365
1120908,3,0,6,42,16,0,58,180,21,259
1120909,23,3,26,45,21,0,66,186,3,255
1120910,3,0,3,64,31,0,95,144,18,257
1120911,0,0,0,61,23,3,87,131,15,233
1120912,0,0,0,57,21,3,81,117,15,213
1120913,3,0,3,89,45,10,144,234,9,387
1120914,3,0,3,83,67,9,159,224,19,402
1120915,7,0,7,135,56,3,194,249,39,482
1120916,0,0,0,70,43,9,122,216,9,347
1120917,3,0,3,94,48,6,148,256,13,417
1120918,13,0,13,85,59,9,153,266,24,443
1120919,3,6,9,55,42,6,103,186,11,300
1120920,3,0,3,75,32,0,107,182,21,310
1120921,6,0,6,110,37,3,150,269,25,444
1120922,0,4,4,88,30,0,118,269,31,418
1120923,3,0,3,75,61,0,136,193,20,349
1120924,4,0,4,84,35,4,123,211,7,341
1120925,17,0,17,88,37,0,125,248,29,402
1120926,12,6,18,66,45,6,117,195,31,343
1120927,6,0,9,74,25,0,99,221,15,335
1120928,3,0,3,114,43,4,161,254,27,442
1120929,0,0,0,60,15,0,75,118,15,208
1120930,0,0,0,88,20,4,112,146,16,274
1120931,9,0,9,61,28,3,92,243,25,360
1120932,6,3,9,92,28,12,132,266,21,419
1120933,10,3,13,74,28,6,108,227,28,363
1120934,12,0,12,56,38,3,97,222,18,337
1120935,9,0,9,66,28,6,100,197,9,306
1120936,7,6,13,72,13,4,89,195,44,328
1120937,0,0,0,0,0,0,0,6,0,6
1120938,0,0,0,0,0,0,0,0,0,0
1120939,0,0,0,108,36,8,152,199,30,381
1120940,10,0,10,60,23,6,89,226,19,334
1120941,0,3,3,87,27,0,114,181,15,310
1120942,7,0,7,93,26,0,119,178,17,314
1120943,7,3,10,68,37,3,108,227,18,353
1120944,0,0,0,73,42,3,118,238,18,374
1120945,0,0,0,82,34,6,122,198,19,339
1120946,3,0,3,51,47,9,107,252,9,368
1120947,3,3,6,101,48,6,155,202,15,372
1120948,45,0,45,90,27,12,129,287,9,425
1120949,3,0,3,41,22,3,66,185,9,260
1120950,8,7,15,93,32,4,129,232,22,383
1120951,54,6,60,30,16,0,46,227,27,300
1120952,3,3,6,82,46,6,134,203,20,357
1120953,3,0,3,81,39,3,123,249,19,391
1120954,6,0,6,87,56,0,143,281,25,449
1120955,4,0,4,69,40,0,109,245,12,366
1120956,7,0,7,89,33,4,126,215,15,356
1121001,3,3,6,38,15,0,53,79,28,160
1121002,0,0,0,38,18,6,62,95,3,160
1121003,3,0,3,81,29,6,116,175,18,309
1121004,3,0,3,38,30,6,74,147,9,230
1121005,3,0,3,78,25,6,109,167,9,285
1121006,13,3,16,65,27,0,92,248,23,363
1121007,13,4,17,95,40,3,138,327,22,487
1121008,3,0,3,73,49,3,125,243,19,387
1121009,9,0,9,156,51,12,219,438,29,686
1121010,27,54,81,9,3,3,15,92,102,209
1121011,0,0,0,57,14,3,74,135,12,221
1121012,0,0,0,32,23,0,55,184,31,270
1121013,6,0,6,56,48,5,109,261,79,449
1121014,11,0,11,40,20,6,66,166,22,254
1121015,39,10,49,39,20,0,59,200,25,284
1121016,3,0,3,72,42,3,117,168,12,297
1121017,6,0,6,77,14,3,94,139,3,236
1121018,6,3,9,66,32,7,105,263,53,421
1121019,0,3,3,28,22,3,53,144,27,224
1121020,10,3,13,53,27,3,83,233,43,359
1121021,6,4,10,48,26,0,74,214,28,316
1121022,6,0,6,65,21,3,89,186,22,297
1121101,8,3,11,46,27,3,76,129,9,214
1121102,4,0,4,46,24,4,74,161,0,235
1121103,18,5,23,19,44,0,63,343,50,456
1121104,3,0,3,83,23,3,109,164,0,273
1121105,48,4,52,56,29,5,90,190,8,288
1121106,9,3,12,65,21,3,89,182,21,292
1121107,13,0,13,55,23,3,81,188,6,275
1121108,6,0,6,130,47,6,183,249,16,448
1121109,0,0,0,0,0,0,0,12,0,12
1121110,0,0,0,67,58,4,129,210,11,350
1121201,0,0,0,70,33,10,113,198,19,330
1121202,13,0,13,50,32,3,85,188,30,303
1121203,4,0,4,32,23,4,59,126,12,197
1121204,13,0,13,58,56,0,114,320,30,464
1121205,7,0,7,58,22,6,86,196,18,300
1121206,8,0,8,57,37,4,98,245,16,359
1121207,10,0,10,68,43,0,111,290,52,453
1121208,6,0,6,52,38,4,94,201,11,306
1121209,3,3,6,71,27,0,98,210,22,330
1121210,0,0,0,55,21,3,79,129,6,214
1121211,14,4,18,36,27,9,72,205,26,303
1121212,3,0,3,76,43,7,126,269,20,415
1121213,0,0,0,25,24,0,49,108,16,173
1121214,6,0,6,83,25,5,113,188,46,347
1121215,19,5,24,51,35,3,89,215,39,343
1121216,34,14,48,29,17,6,52,299,36,387
1121217,4,0,4,70,26,3,99,227,33,359
1121218,36,14,50,18,17,0,35,256,54,345
1121219,0,0,0,52,13,0,65,136,31,232
1121220,0,0,0,0,0,0,0,0,0,0
1121221,6,0,6,32,24,0,56,180,19,255
1121222,9,3,12,107,29,3,139,211,50,400
1121223,26,3,29,39,25,3,67,234,37,338
1121224,4,0,4,99,46,9,154,349,33,536
1121225,6,0,6,87,47,0,134,337,45,516
1121226,0,3,3,55,25,0,80,182,35,297
1121227,8,6,14,87,49,12,148,314,30,492
1121301,0,0,0,0,0,0,0,0,3,3
1121302,0,0,0,0,0,0,0,0,0,0
1121303,0,0,0,79,72,7,158,249,18,425
1121304,4,0,4,74,37,12,123,183,18,324
1121305,3,0,3,91,41,9,141,230,21,392
1121306,6,3,9,65,50,10,125,190,15,330
1121307,6,4,10,75,45,0,120,298,17,435
1121308,3,0,3,100,55,6,161,257,12,430
1121309,3,0,3,27,19,0,46,126,0,172
1121310,3,0,3,74,62,0,136,238,23,397
1121311,4,0,4,79,44,10,133,236,11,380
1121312,3,3,6,58,39,6,103,255,21,379
1121313,3,0,3,54,32,7,93,131,5,229
1121314,39,7,46,53,40,3,96,329,19,444
1121315,6,0,6,88,36,6,130,249,6,385
1121316,0,0,0,48,18,3,69,76,9,154
1121317,4,0,4,64,40,3,107,234,12,353
1121318,3,0,3,80,26,6,112,227,5,344
1121319,5,0,5,91,46,0,137,182,17,336
1121320,8,0,8,35,22,0,57,135,3,195
1121321,5,0,5,71,42,0,113,181,11,305
1121322,4,0,4,84,59,12,155,269,14,438
1121323,0,0,0,138,56,6,200,215,10,425
1121324,6,0,6,81,48,0,129,260,25,414
1121325,9,0,9,84,75,6,165,269,18,452
1121326,12,0,18,63,49,9,121,236,21,378
1121327,13,3,16,46,48,0,94,252,18,364
1121328,3,0,3,57,19,0,76,163,10,249
1121329,17,6,26,50,27,0,77,178,54,309
1121330,4,0,4,72,21,3,96,197,7,300
1121401,9,0,9,81,35,8,124,241,27,392
1121402,10,0,10,49,47,3,99,186,12,297
1121403,8,4,12,89,43,4,136,304,36,476
1121404,9,8,17,71,47,6,124,216,15,355
1121405,0,0,0,0,0,0,0,3,0,3
1121406,3,6,9,84,43,3,130,275,22,427
1121407,7,3,10,72,23,6,101,234,34,369
1121408,6,0,6,44,18,3,65,158,15,238
1121409,5,0,5,40,20,6,66,125,9,200
1121410,17,5,22,66,70,8,144,328,32,504
1121411,3,0,3,66,40,3,109,171,3,283
1121412,5,0,5,36,25,0,61,75,12,148
1121413,3,0,3,80,18,0,98,231,21,350
1121414,21,3,24,94,50,4,148,336,20,504
1121415,11,5,16,69,36,10,115,327,22,464
1121416,8,3,11,61,29,0,90,193,18,301
1121417,22,0,22,55,28,0,83,212,21,316
1121418,0,0,0,0,0,0,0,0,0,0
1121419,8,0,8,56,45,4,105,195,24,324
1121420,0,0,0,0,0,0,0,6,0,6
1121421,4,3,7,74,32,6,112,204,18,334
1121422,12,3,15,81,44,4,129,265,21,415
1121423,3,0,3,74,35,3,112,154,19,285
1121424,3,0,3,39,20,0,59,183,25,267
1121425,7,0,7,56,37,0,93,174,18,285
1121426,0,0,0,71,37,0,108,180,22,310
1121427,13,0,13,46,42,6,94,293,24,411
1121428,15,3,18,100,48,3,151,242,24,417
1121429,4,0,4,50,25,3,78,162,3,243
1121430,17,0,17,78,32,3,113,197,18,328
1121431,5,3,8,62,8,0,70,132,16,218
1121432,6,3,9,104,39,7,150,259,13,422
1121433,3,3,9,59,33,6,98,190,21,309
1121434,9,0,9,55,32,6,93,144,4,241
1121501,11,5,16,25,29,3,57,127,17,201
1121502,9,3,12,42,35,4,81,200,26,307
1121503,8,0,8,54,34,9,97,195,21,313
1121504,0,0,0,76,26,9,111,128,20,259
1121505,10,4,14,62,44,9,115,211,30,356
1121506,0,0,0,86,18,4,108,213,13,334
1121507,6,0,6,65,64,0,129,208,35,372
1121508,55,0,55,43,17,6,66,305,20,391
1121509,3,0,3,61,43,6,110,221,9,340
1121510,0,0,0,68,30,5,103,213,34,350
1121511,0,0,0,89,42,0,131,172,11,314
1121512,0,0,0,55,14,0,69,130,7,206
1121513,0,0,0,100,39,0,139,231,16,386
1121514,0,0,0,45,9,6,60,112,18,190
1121515,0,0,0,0,0,0,0,0,0,0
1121516,5,0,5,67,31,3,101,266,31,398
1121517,120,9,133,35,20,0,55,323,31,409
1121518,67,7,74,44,35,0,79,295,33,407
1121519,9,0,9,49,24,3,76,201,26,303
1121520,3,0,3,42,19,4,65,144,15,224
1121521,0,0,0,9,3,0,12,31,0,43
1121522,7,0,7,73,38,0,111,256,18,385
1121523,0,0,0,0,0,0,0,0,0,0
1121524,0,0,0,57,41,4,102,209,10,321
1121525,7,0,7,47,24,6,77,200,3,280
1121601,7,0,7,53,24,0,77,190,10,277
1121602,6,0,6,64,27,3,94,189,23,306
1121603,3,0,3,142,51,9,202,343,46,591
1121604,8,0,8,60,41,6,107,231,22,360
1121605,6,3,9,40,30,0,70,120,9,199
1121606,5,0,5,74,32,9,115,219,30,364
1121607,13,0,13,82,38,0,120,326,35,481
1121608,11,0,11,93,45,4,142,272,31,445
1121609,3,0,3,56,48,4,108,263,27,398
1121610,8,3,11,61,39,3,103,200,19,322
1121611,0,3,3,52,19,0,71,134,10,215
1121612,6,3,9,106,53,5,164,308,23,495
1121613,4,0,4,64,19,3,86,175,18,279
1121614,0,0,0,68,7,3,78,164,21,263
1121615,6,0,6,77,54,8,139,283,32,454
1121616,9,5,14,57,30,6,93,263,27,383
1121617,10,0,10,79,71,3,153,396,26,575
1121701,117,13,130,0,6,0,6,300,32,338
1121702,0,0,0,97,41,6,144,111,19,274
1121703,0,0,0,45,24,0,69,109,19,197
1121704,0,0,0,76,56,9,141,204,24,369
1121705,9,4,13,64,28,12,104,268,17,389
1121706,0,0,0,78,47,9,134,163,18,315
1121707,12,3,15,47,21,0,68,176,41,285
1121708,0,0,0,56,27,9,92,166,26,284
1121709,3,0,3,44,30,3,77,173,18,268
1121710,3,0,3,41,33,5,79,102,18,199
1121711,0,0,0,102,48,6,156,251,25,432
1121712,6,0,6,73,35,0,108,153,8,269
1121713,0,0,0,42,14,0,56,114,17,187
1121714,0,0,0,82,26,0,108,196,12,316
1121715,0,0,0,14,3,0,17,13,3,33
1121716,0,0,0,96,23,8,127,131,7,265
1121717,0,0,0,201,52,12,265,300,7,572
1121718,0,0,0,0,0,0,0,0,0,0
1121719,3,0,3,55,38,0,93,196,15,304
1121720,4,0,4,22,33,3,58,89,6,153
1121721,5,0,5,86,56,0,142,301,23,466
1121722,3,0,3,111,38,3,152,218,19,389
1121723,0,3,3,142,46,5,193,256,28,477
1121724,0,0,0,94,19,9,122,134,12,268
1121725,43,0,47,145,22,3,170,287,11,468
1121726,0,0,0,16,3,0,19,41,0,60
1121727,0,0,0,0,0,0,0,6,0,6
1121728,3,0,3,128,22,0,150,158,0,308
1121729,6,0,6,108,31,6,145,177,7,329
1121730,0,0,0,67,29,3,99,179,6,284
1121731,0,0,0,83,28,3,114,248,7,369
1121801,0,3,3,71,33,9,113,168,12,293
1121802,29,3,32,25,24,0,49,180,15,244
1121803,7,0,7,49,16,0,65,126,19,210
1121804,0,0,0,0,0,0,0,3,0,3
1121805,3,0,3,36,28,0,64,140,13,217
1121806,0,0,0,0,0,0,0,3,0,3
1121807,4,0,4,22,3,0,25,110,3,138
1121808,0,0,0,29,11,6,46,104,3,153
1121809,11,60,71,47,31,0,78,190,114,382
1121810,0,0,0,36,18,3,57,150,6,213
1121811,3,0,3,84,23,4,111,200,11,322
1121812,6,0,6,93,41,6,140,356,43,539
1121813,0,0,0,53,15,0,68,96,7,171
1121814,4,0,4,93,47,7,147,271,24,442
1121815,0,0,0,44,19,3,66,149,5,220
1121816,0,0,0,67,24,0,91,191,20,302
1121817,4,0,4,0,0,0,0,201,0,201
1121818,7,3,10,29,27,0,56,181,37,274
1121819,9,3,12,35,20,4,59,167,6,232
1121820,0,0,0,26,29,0,55,150,9,214
1121821,3,0,3,51,23,0,74,128,17,219
1121822,14,0,14,83,38,0,121,333,22,476
1121823,3,3,6,34,24,0,58,161,15,234
1121824,0,0,0,8,0,0,8,73,13,94
1121825,6,0,6,45,30,7,82,209,20,311
1121826,3,0,3,40,17,6,63,226,9,298
1121827,22,5,27,22,17,3,42,208,30,280
1121828,0,0,0,73,23,6,102,165,10,277
1121829,3,0,3,23,17,5,45,82,14,141
1121830,75,10,85,0,15,0,15,286,30,331
1121831,69,8,77,26,25,0,51,372,38,461
1121832,131,5,136,8,42,0,50,381,27,458
1121833,0,0,0,60,22,0,82,152,9,243
1121834,6,0,6,129,26,8,163,262,31,456
1121835,5,0,5,54,29,0,83,221,24,328
1121836,3,4,7,40,21,0,61,174,13,248
1121837,6,0,6,86,27,12,125,248,34,407
1121838,0,0,0,11,8,0,19,53,3,75
1121839,0,3,3,36,26,0,62,113,15,190
1121840,0,0,0,72,29,6,107,190,7,304
1121841,3,0,3,40,24,0,64,179,7,250
1121842,49,12,61,54,29,3,86,313,33,432
1121843,5,0,5,34,12,3,49,191,15,255
1121901,9,3,12,39,26,3,68,159,27,254
1121902,13,3,16,47,28,0,75,165,27,267
1121903,60,4,64,51,27,0,78,280,17,375
1121904,3,0,3,61,29,5,95,206,21,322
1121905,6,0,6,33,22,3,58,95,13,166
1121906,7,0,7,34,11,3,48,107,8,163
1121907,10,0,10,23,24,0,47,131,16,194
1121908,6,0,6,59,38,0,97,249,15,361
1121909,3,0,3,45,35,0,80,152,9,241
1121910,25,10,35,62,62,7,131,317,47,495
1121911,6,0,6,56,29,3,88,205,21,314
1121912,6,0,6,29,13,3,45,96,7,148
1121913,11,3,14,34,32,0,66,193,21,280
1121914,4,0,4,70,32,9,111,245,35,391
1121915,0,0,0,27,22,0,49,149,9,207
1121916,44,7,51,35,35,6,76,250,26,352
1121917,8,3,11,71,42,4,117,255,36,408
1121918,3,3,6,54,29,6,89,220,38,347
1121919,7,3,10,36,38,0,74,145,15,234
1121920,7,3,10,44,14,0,58,180,33,271
1121921,0,0,0,0,0,0,0,4,0,4
1121922,0,0,0,12,24,0,36,54,0,90
1121923,12,0,12,72,36,8,116,240,18,374
1121924,3,5,8,30,16,0,46,140,8,194
1121925,3,0,3,70,14,7,91,162,15,268
1121926,3,0,3,73,21,3,97,162,13,272
1121927,0,0,0,0,0,0,0,0,0,0
1121928,0,0,0,46,26,0,72,160,21,253
1121929,0,0,0,36,17,0,53,136,54,243
1121930,0,0,0,75,40,7,122,236,39,397
1121931,0,3,3,72,33,3,108,205,24,337
1121932,11,4,15,99,53,4,156,344,53,553
1121933,7,0,7,28,24,6,58,167,15,240
1121934,63,20,83,34,39,0,73,298,46,417
1121935,15,0,15,55,47,3,105,276,25,406
1121936,3,3,6,57,25,6,88,186,12,286
1121937,6,3,9,49,33,4,86,177,9,272
1121938,6,3,9,82,40,0,122,318,15,455
1121939,7,3,10,33,29,3,65,142,12,219
1122001,3,0,3,66,28,6,100,216,12,328
1122002,0,0,0,54,23,6,83,178,18,279
1122003,10,0,10,51,34,3,88,219,19,326
1122004,3,0,3,75,34,4,113,221,13,347
1122005,6,4,10,81,67,0,148,236,27,411
1122006,25,0,25,81,26,4,111,315,22,448
1122007,9,0,9,70,43,4,117,243,9,369
1122008,0,0,0,5,3,0,8,3,9,20
1122009,6,0,6,77,20,3,100,253,36,389
1122010,7,0,7,65,43,6,114,279,20,413
1122011,9,0,9,82,38,3,123,306,10,439
1122012,0,0,0,69,36,0,105,180,12,297
1122013,4,0,4,75,41,0,116,279,25,420
1122014,12,0,12,32,33,0,65,218,10,293
1122015,6,0,6,51,26,0,77,145,13,235
1122016,0,0,0,73,28,9,110,232,10,352
1122017,3,0,3,66,35,13,114,213,13,340
1122018,0,0,0,33,20,0,53,176,14,243
1122019,0,0,0,38,37,9,84,145,15,244
1122020,12,4,16,80,42,4,126,342,31,499
1122021,13,3,16,63,60,3,126,371,40,537
1122101,0,0,0,61,27,4,92,214,18,324
1122102,3,0,3,23,12,0,35,89,16,140
1122103,3,0,3,70,20,0,90,124,18,232
1122104,0,0,0,80,25,9,114,147,10,271
1122105,0,0,0,55,16,0,71,110,15,196
1122106,4,0,4,80,43,14,137,206,9,352
1122107,0,0,0,48,27,0,75,173,12,260
1122108,4,0,4,32,18,9,59,98,12,169
1122109,0,0,0,52,25,0,77,92,12,181
1122110,0,0,0,51,20,6,77,196,3,276
1122111,0,0,0,70,19,4,93,162,14,269
1122112,4,0,4,70,48,0,118,211,32,361
1122113,0,0,0,83,27,0,110,123,16,249
1122114,0,0,0,61,19,4,84,147,26,257
1122115,6,3,9,87,23,0,110,183,24,317
1122116,6,0,6,42,21,3,66,93,6,165
1122117,0,0,0,53,23,0,76,150,24,250
1122118,0,0,0,38,10,0,48,121,14,183
1122119,0,0,0,41,27,0,68,93,20,181
1122120,6,3,9,28,9,0,37,107,9,153
1122201,6,0,6,61,25,11,97,186,0,283
1122202,3,0,3,51,26,0,77,212,10,299
1122203,12,0,12,82,21,4,107,273,18,398
1122204,11,6,17,114,47,6,167,227,18,412
1122205,7,3,10,54,51,7,112,194,12,318
1122206,9,3,12,78,64,0,142,245,21,408
1122207,7,3,10,73,72,3,148,285,21,454
1122208,7,8,15,67,28,0,95,238,23,356
1122209,0,0,0,75,3,6,84,75,6,165
1122210,5,0,5,79,38,3,120,241,31,392
1122211,5,0,5,68,28,0,96,162,7,265
1122212,10,3,13,76,33,4,113,259,24,396
1122213,0,3,3,49,15,0,64,116,9,189
1122214,5,0,5,62,32,0,94,185,31,310
1122215,0,3,3,82,4,4,90,154,16,260
1122216,11,3,14,86,24,7,117,226,23,366
1122217,6,6,12,97,36,6,139,248,21,408
1122218,9,0,9,82,31,0,113,214,26,353
1122219,0,0,0,56,23,0,79,250,19,348
1122220,5,0,8,64,37,0,101,250,31,382
1122221,0,0,0,0,0,0,0,0,0,0
1122222,0,0,0,0,0,0,0,0,0,0
1122223,17,4,21,117,45,9,171,263,13,447
1122224,11,0,11,66,34,9,109,227,13,349
1122225,6,3,9,82,34,6,122,218,24,364
1122226,10,0,10,69,45,3,117,189,10,316
1122227,3,0,3,78,48,9,135,266,21,422
1122228,6,3,9,72,25,3,100,168,13,281
1122229,8,0,11,62,41,3,106,209,9,324
1122230,5,0,5,83,37,7,127,172,18,317
1122231,3,0,3,59,34,0,93,155,9,257
1122232,7,0,7,75,39,9,123,202,13,338
1122233,14,0,14,51,38,0,89,197,30,316
1122234,3,0,7,61,29,0,90,149,4,243
1122235,11,0,11,119,33,3,155,286,23,464
1122236,8,0,8,45,17,3,65,154,4,223
1122237,0,0,0,0,0,0,0,0,0,0
1122238,0,0,0,0,0,0,0,3,0,3
1122239,9,0,9,52,20,0,72,256,39,367
1122240,5,4,9,90,26,11,127,245,20,392
1122301,0,0,0,44,18,3,65,89,3,157
1122302,6,3,9,82,26,3,111,170,32,313
1122303,15,3,18,79,40,3,122,279,35,436
1122304,3,3,6,34,41,6,81,165,24,270
1122305,4,3,7,56,36,3,95,193,23,311
1122306,4,3,7,64,41,0,105,234,19,358
1122307,6,0,6,52,23,9,84,217,33,334
1122308,0,0,0,58,30,3,91,155,15,261
1122309,0,0,0,6,0,0,6,26,0,32
1122310,10,6,16,73,37,7,117,244,25,386
1122311,9,3,12,79,31,3,113,268,24,405
1122312,9,0,9,59,34,6,99,242,11,352
1122313,15,3,18,46,37,3,86,284,46,416
1122314,0,0,0,70,26,0,96,134,12,242
1122315,0,0,0,56,16,0,72,169,12,253
1122316,6,0,6,24,18,3,45,97,9,151
1122317,0,0,5,83,13,0,96,189,28,313
1122318,0,0,0,56,40,0,96,169,7,272
1122319,0,0,0,50,22,3,75,181,26,282
1122320,0,4,4,46,34,6,86,211,32,329
1122321,0,3,3,37,12,3,52,102,21,175
1122322,3,0,3,68,28,3,99,215,63,377
1122323,0,0,0,47,30,7,84,124,17,225
1122401,11,4,15,87,36,6,129,244,26,399
1122402,6,0,6,65,31,3,99,161,30,290
1122403,5,6,11,28,17,3,48,270,130,448
1122404,11,6,17,77,30,3,110,254,51,415
1122405,6,0,6,28,21,6,55,191,59,305
1122406,3,0,3,29,12,0,41,101,18,160
1122407,0,0,0,28,10,3,41,178,31,250
1122408,3,0,3,34,9,0,43,103,19,165
1122409,0,0,0,0,0,0,0,0,0,0
1122410,0,0,0,3,3,0,6,3,0,9
1122411,0,0,0,62,20,6,88,192,10,290
1122412,8,3,11,74,30,13,117,291,24,432
1122413,4,0,4,71,16,3,90,229,24,343
1122414,0,0,0,55,25,9,89,179,11,279
1122415,8,3,11,63,27,0,90,209,22,321
1122416,0,0,0,0,3,0,3,0,0,3
1122417,3,3,6,24,21,0,45,127,18,190
1122418,44,8,52,64,42,4,110,350,43,503
1122419,6,0,6,50,9,9,68,251,10,329
1122420,4,0,4,15,12,0,27,70,18,115
1122421,14,3,17,72,56,9,137,367,63,567
1122422,14,0,14,113,39,5,157,321,22,500
1122423,13,0,13,38,15,0,53,227,21,301
1122424,9,3,12,37,25,0,62,237,26,325
1122425,6,0,9,46,30,0,76,296,21,393
1122426,16,4,20,82,44,0,126,354,39,519
1122427,10,0,10,101,42,0,143,303,21,467
1122428,10,0,10,49,34,6,89,174,8,271
1122429,3,0,3,70,39,12,121,229,26,376
1122430,10,0,10,74,21,6,101,202,6,309
1122431,13,0,13,82,42,9,133,238,14,385
1122432,6,0,6,26,19,3,48,121,21,190
1122501,18,3,21,90,36,11,137,262,15,414
1122502,6,3,9,59,18,3,80,112,9,201
1122503,13,3,16,68,37,4,109,212,13,334
1122504,41,3,47,77,55,3,135,375,27,537
1122505,6,6,12,92,24,0,116,164,30,310
1122506,6,3,9,52,16,0,68,121,24,213
1122507,16,6,22,77,24,7,108,228,56,392
1122508,18,0,18,115,39,14,168,253,6,427
1122509,8,3,11,54,19,7,80,138,16,234
1122510,15,6,21,49,22,3,74,135,28,237
1122511,12,6,18,56,22,6,84,164,15,263
1122512,11,0,11,69,25,3,97,194,18,309
1122513,11,3,17,140,40,7,187,264,12,463
1122514,11,4,15,70,36,0,106,247,14,367
1122515,3,0,3,52,18,4,74,137,14,225
1122516,10,9,19,75,24,0,99,263,35,397
1122517,7,3,10,46,27,6,79,174,12,265
1122518,3,6,9,86,40,0,126,213,24,363
1122519,14,5,19,76,26,0,102,252,20,374
1122520,3,3,9,34,17,10,61,111,9,181
1122521,0,0,0,99,27,9,135,196,7,338
1122522,0,0,0,65,21,3,89,141,3,233
1122523,11,0,11,56,35,0,91,314,27,432
1122524,4,0,4,76,38,6,120,278,9,407
1122525,10,6,16,67,24,4,95,221,20,336
1122526,6,0,6,108,39,9,156,268,33,457
1122527,5,0,5,40,23,0,63,138,17,218
1122528,5,3,8,56,29,3,88,198,27,313
1122529,6,0,6,48,28,0,76,154,0,230
1122530,4,0,4,89,25,4,118,247,24,389
1122531,5,0,5,44,33,0,77,170,20,267
1122532,4,0,4,51,26,0,77,169,13,259
1122533,0,0,0,9,0,0,9,12,0,21
1122534,0,0,0,69,34,5,108,226,29,363
1122535,0,0,0,0,0,0,0,0,0,0
1122536,3,0,3,73,21,3,97,144,5,246
1122537,0,0,0,94,19,3,116,150,21,287
1122538,12,0,12,50,24,0,74,258,23,355
1122539,7,0,7,55,47,0,102,274,30,406
1122540,10,0,10,84,29,4,117,197,12,326
1122541,4,0,4,50,24,0,74,143,5,222
1122542,0,3,3,38,15,3,56,106,15,177
1122543,11,0,11,87,23,8,118,202,39,359
1122601,7,0,7,82,36,4,122,222,19,363
1122602,3,0,3,38,18,3,59,98,6,163
1122603,0,0,0,159,43,8,210,226,18,454
1122604,0,0,0,37,21,7,65,164,3,232
1122605,0,0,0,134,39,14,187,218,18,423
1122606,3,0,3,67,23,0,90,101,12,203
1122607,0,0,0,123,34,13,170,127,10,307
1122608,3,3,6,124,27,9,160,174,21,355
1122609,0,0,0,100,27,9,136,224,15,375
1122610,0,0,0,52,15,0,67,180,6,253
1122611,3,0,3,30,21,4,55,140,21,216
1122612,0,0,0,51,21,3,75,74,0,149
1122613,0,0,0,53,16,6,75,86,15,176
1122614,0,0,0,86,38,6,130,205,9,344
1122615,4,0,4,99,24,8,131,218,14,363
1122616,0,0,0,74,18,4,96,75,0,171
1122617,0,0,0,64,13,3,80,136,18,234
1122618,0,0,0,78,33,3,114,214,21,349
1122619,0,0,0,56,28,4,88,168,23,279
1122620,0,0,0,34,37,6,77,118,5,200
1122621,0,0,0,34,19,0,53,103,7,163
1122622,0,0,0,0,0,0,0,0,0,0
1122623,0,0,0,65,27,0,92,145,13,250
1122624,0,4,4,67,21,10,98,146,16,260
1122625,3,0,3,77,35,0,112,261,8,381
1122626,0,0,0,85,26,0,111,189,6,306
1122627,0,0,0,49,24,8,81,131,3,215
1122628,0,0,0,93,27,8,128,190,0,318
1122629,0,0,0,80,29,3,112,142,15,269
1122630,0,0,0,124,27,8,159,247,15,421
1122631,0,0,0,3,3,0,6,6,3,15
1122632,4,0,4,71,27,9,107,132,12,251
1122701,0,0,0,48,12,0,60,138,12,210
1122702,0,0,0,0,0,0,0,0,0,0
1122703,10,3,13,30,27,3,60,141,16,217
1122704,0,6,6,57,14,0,71,179,21,271
1122705,0,0,0,64,27,0,91,167,27,285
1122706,4,0,4,66,30,8,104,266,29,399
1122707,9,0,9,98,14,8,120,319,30,469
1122708,7,3,10,71,29,6,106,237,40,383
1122709,9,3,12,55,14,0,69,187,27,283
1122710,6,0,6,68,23,6,97,206,15,318
1122711,7,3,10,76,37,9,122,262,35,419
1122712,0,0,0,40,7,3,50,116,9,175
1122713,7,3,10,90,27,6,123,291,55,469
1122714,18,8,29,75,30,0,105,297,46,448
1122715,89,8,97,29,35,3,67,328,37,432
1122716,3,0,3,33,25,0,58,157,18,233
1122717,0,0,0,68,20,10,98,194,34,326
1122718,8,0,8,59,24,7,90,258,26,374
1122719,6,4,10,63,27,7,97,237,29,363
1122720,3,0,3,63,9,4,76,230,51,357
1122721,6,0,6,71,21,3,95,232,48,375
1122722,41,0,41,25,19,3,47,191,15,253
1122723,61,0,61,45,23,0,68,352,31,451
1122724,7,6,13,49,36,0,85,253,24,362
1122725,4,0,4,73,15,0,88,218,50,356
1122726,0,0,0,36,16,3,55,221,16,292
1122727,3,0,3,49,20,0,69,131,23,223
1122728,7,0,7,77,43,0,120,256,26,402
1122729,6,3,9,70,31,3,104,270,32,406
1122730,5,3,8,72,22,8,102,290,37,429
1122731,7,5,12,78,25,6,109,258,43,410
1122732,6,0,6,86,34,0,120,275,35,430
1122733,9,3,12,39,21,3,63,248,37,348
1122734,6,0,6,71,15,3,89,230,38,357
1122735,6,5,11,49,30,6,85,252,28,365
1122736,45,0,45,67,31,0,98,330,42,470
1122801,8,3,11,109,46,3,158,214,14,386
1122802,10,0,10,93,40,6,139,228,23,390
1122803,0,0,0,0,0,0,0,0,0,0
1122804,6,0,6,77,20,3,100,146,0,246
1122805,5,0,5,31,27,3,61,181,6,248
1122806,6,6,12,82,38,4,124,270,9,403
1122807,12,6,21,105,50,6,161,326,18,505
1122808,8,0,8,87,33,0,120,185,12,317
1122809,16,0,16,55,19,6,80,323,48,451
1122810,9,0,9,73,47,12,132,303,19,454
1122811,12,4,16,118,39,9,166,227,4,397
1122812,6,0,6,93,35,9,137,252,7,396
1122813,6,0,6,91,26,3,120,233,25,378
1122814,9,3,12,58,20,6,84,276,24,384
1122815,4,3,7,43,22,3,68,164,23,255
1122816,0,0,0,25,21,0,46,196,14,256
1122817,9,0,9,60,32,6,98,369,42,509
1122818,3,3,6,111,58,4,173,245,15,433
1122819,5,0,5,47,29,0,76,128,10,214
1122820,6,0,6,90,47,8,145,235,13,393
1122821,0,4,4,66,53,9,128,186,25,339
1122822,6,3,9,48,24,0,72,213,16,301
1122823,3,0,3,22,18,0,40,186,10,236
1122824,8,0,8,38,14,0,52,157,4,213
1122825,10,0,10,42,30,4,76,180,8,264
1122826,15,3,18,86,45,4,135,386,18,539
1122827,7,3,10,63,31,0,94,284,39,417
1122828,7,6,13,43,27,0,70,191,9,270
1122829,8,7,15,74,29,0,103,396,40,539
1122830,7,3,10,44,45,3,92,214,15,321
1122831,7,0,7,83,27,6,116,210,15,341
1122832,6,0,6,66,28,6,100,286,22,408
1122901,3,0,3,28,37,0,65,290,37,392
1122902,3,0,3,67,23,9,99,282,26,407
1122903,0,0,0,44,57,0,101,412,33,546
1122904,6,0,6,33,25,0,58,277,45,380
1122905,4,3,7,46,43,3,92,437,95,624
1122906,6,0,6,12,27,3,42,212,12,266
1122907,6,0,6,45,36,0,81,305,30,416
1122908,7,0,7,41,15,0,56,235,35,326
1122909,5,0,5,43,33,0,76,248,41,365
1122910,3,3,6,33,20,6,59,241,34,334
1122911,8,0,8,64,50,0,114,414,25,553
1122912,6,0,6,38,27,0,65,207,27,299
1122913,11,0,11,34,24,3,61,181,27,269
1122914,0,0,0,0,0,0,0,0,0,0
1122915,0,0,0,24,20,0,44,214,27,285
1122916,3,0,3,52,13,3,68,273,30,371
1122917,0,0,0,29,22,0,51,226,29,306
1122918,3,0,3,36,14,0,50,285,22,357
1122919,0,0,0,49,37,3,89,284,27,400
1122920,6,3,9,37,10,4,51,116,9,176
1122921,4,0,4,24,18,3,45,114,18,177
1122922,11,0,11,68,34,0,102,207,13,322
1122923,3,3,6,52,30,0,82,349,47,478
1122924,6,3,9,49,21,9,79,193,27,299
1122925,16,0,16,66,25,4,95,345,30,470
1122926,3,4,7,35,21,0,56,212,15,283
1123001,0,0,0,3,4,0,7,4,0,11
1123101,20,5,25,34,20,0,54,193,23,270
1123102,12,4,16,55,19,0,74,186,20,280
1123103,6,3,9,26,22,3,51,214,30,295
1123104,9,3,12,88,30,4,122,369,27,518
1123105,82,6,88,21,13,0,34,221,31,286
1123106,0,0,0,3,3,0,6,15,3,24
1123107,0,0,0,16,9,0,25,28,8,61
1123108,4,0,4,70,45,7,122,300,5,427
1123109,10,0,10,84,56,5,145,300,28,473
1123110,8,0,8,79,42,7,128,271,24,423
1123111,10,0,10,47,36,9,92,323,27,442
1123112,0,0,0,0,0,0,0,0,0,0
1123113,7,3,10,68,21,4,93,222,15,330
1123114,11,6,17,55,18,0,73,351,48,472
1123115,10,0,10,60,24,6,90,242,27,359
1123116,9,0,9,53,11,0,64,262,9,335
1123117,8,0,8,33,11,4,48,119,10,177
1123118,3,3,6,16,0,0,16,142,18,176
1123119,9,0,9,55,21,0,76,263,44,383
1123120,9,4,13,40,12,0,52,158,34,244
1123121,6,0,6,31,6,6,43,184,15,242
1123122,3,5,8,57,40,6,103,242,16,361
1123123,13,0,13,76,29,0,105,293,50,448
1123124,7,0,7,45,43,4,92,443,82,617
1123125,0,0,0,3,15,0,18,582,51,651
1123126,57,3,60,24,23,0,47,285,40,372
1123201,9,0,9,55,26,6,87,183,20,290
1123202,3,0,3,52,60,0,112,211,29,352
1123203,3,3,6,36,37,7,80,193,28,301
1123204,14,3,17,60,32,0,92,270,52,414
1123205,9,0,9,62,43,10,115,229,34,378
1123206,3,3,6,42,32,6,80,163,24,267
1123207,18,0,18,75,38,6,119,236,24,379
1123208,70,3,73,52,18,5,75,295,15,385
1123209,9,0,9,54,36,6,96,244,29,369
1123210,3,0,3,17,8,0,25,68,3,96
1123211,0,0,0,3,3,0,6,393,0,399
1123212,12,0,12,83,34,3,120,264,30,414
1123213,14,6,20,24,54,0,78,575,70,723
1123214,0,0,0,40,26,0,66,163,34,263
1123215,0,0,0,95,12,6,113,133,15,261
1123216,0,0,0,0,0,0,0,0,0,0
1123301,9,0,9,62,17,0,79,196,27,302
1123302,10,3,13,52,38,0,90,215,25,330
1123303,8,0,8,83,44,9,136,250,36,422
1123304,9,0,9,96,43,6,145,292,25,462
1123305,14,0,14,83,37,4,124,339,65,528
1123306,74,3,77,42,26,0,68,341,26,435
1123307,23,37,60,9,17,0,26,203,77,306
1123308,0,0,0,0,0,0,0,0,0,0
1123309,8,3,11,91,32,0,123,200,6,329
1123310,7,3,10,107,45,3,155,357,30,542
1123311,0,0,0,0,0,0,0,0,0,0
1123312,4,0,4,65,26,6,97,199,43,339
1123313,0,0,0,42,12,10,64,113,0,177
1123314,4,0,4,54,38,15,107,215,6,328
1123315,12,0,12,77,29,7,113,219,21,353
1123316,7,0,7,104,61,9,174,264,4,442
1123317,6,3,9,54,25,0,79,261,37,377
1123318,24,0,24,27,17,3,47,300,32,379
1123319,3,0,3,127,45,6,178,305,26,509
1123320,3,3,6,58,30,0,88,163,28,279
1123321,3,0,3,95,42,4,141,317,17,475
1123322,7,0,7,76,42,0,118,160,22,300
1123323,6,0,6,75,45,3,123,170,28,321
1123324,0,4,4,85,29,4,118,211,13,342
1123325,8,4,12,88,45,9,142,240,21,403
1123326,3,0,3,34,24,0,58,94,8,160
1123327,7,3,10,78,85,3,166,271,18,455
1123328,6,4,10,71,48,4,123,207,20,350
1123329,0,0,0,61,32,4,97,267,4,368
1123330,3,0,3,79,25,3,107,222,3,332
1123331,4,0,4,40,27,9,76,219,20,315
1123332,4,0,4,54,23,0,77,191,12,280
1123333,3,3,6,56,39,3,98,189,21,308
1123334,9,3,12,89,45,3,137,224,35,396
1123335,94,6,100,78,20,3,101,400,25,526
1123336,6,0,6,81,54,3,138,249,38,425
1123337,3,3,6,87,59,6,152,301,10,463
1123338,4,0,4,60,44,5,109,214,9,332
1123339,7,6,13,46,11,3,60,144,27,231
1123340,0,0,0,51,24,0,75,143,7,225
1123341,7,0,7,67,46,15,128,286,26,440
1123342,12,4,16,108,27,8,143,282,23,448
1123343,14,0,14,71,32,0,103,280,26,409
1123344,57,16,73,59,36,0,95,294,41,430
1123401,6,3,9,56,14,3,73,199,23,295
1123402,12,3,15,70,28,8,106,345,37,488
1123403,4,0,4,97,23,0,120,260,14,394
1123404,15,5,20,46,18,3,67,216,19,302
1123405,6,4,13,36,30,3,69,148,34,251
1123406,13,4,17,91,35,6,132,289,43,464
1123407,72,3,75,74,32,3,109,393,39,541
1123408,6,3,9,60,35,3,98,180,21,299
1123409,4,0,4,52,30,6,88,237,18,343
1123410,55,63,118,51,32,0,83,281,124,488
1123411,6,0,6,35,32,0,67,167,12,246
1123412,0,3,3,28,37,0,65,295,20,380
1123413,3,0,3,70,26,3,99,291,29,419
1123414,9,0,9,83,24,6,113,260,22,395
1123415,10,3,13,71,20,6,97,210,6,313
1123416,17,0,17,91,56,4,151,324,28,503
1123417,5,3,8,71,37,10,118,220,22,360
1123418,10,0,10,64,26,6,96,168,9,273
1123419,0,0,0,46,22,9,77,157,17,251
1123420,4,0,4,49,32,3,84,253,24,361
1123421,9,0,9,57,26,3,86,234,53,373
1123422,103,6,109,21,5,6,32,311,53,396
1123423,11,0,11,54,24,4,82,233,29,344
1123424,49,24,73,35,19,4,58,216,45,319
1123425,5,3,8,85,44,12,141,340,40,521
1123426,11,0,11,59,30,3,92,188,15,295
1123427,20,4,24,57,32,3,92,252,25,369
1123501,4,0,4,22,21,0,43,172,16,231
1123502,6,6,12,94,45,7,146,310,49,505
1123503,6,0,6,92,28,9,129,350,56,535
1123504,6,6,12,93,25,7,125,232,29,386
1123505,0,0,0,37,24,0,61,253,29,343
1123506,0,0,0,0,0,0,0,0,0,0
1123507,7,3,10,78,44,11,133,237,24,394
1123508,0,3,3,32,25,3,60,211,41,312
1123509,3,0,3,70,19,3,92,224,23,339
1123510,0,0,0,51,20,0,71,224,24,319
1123511,3,3,6,72,29,9,110,290,24,424
1123512,4,3,7,73,33,0,106,273,39,418
1123513,3,3,6,39,18,6,63,241,33,337
1123514,6,3,9,65,19,5,89,236,25,350
1123515,3,0,3,32,18,3,53,159,20,232
1123516,8,0,8,74,38,4,116,335,35,486
1123517,0,0,0,34,20,3,57,230,24,311
1123518,3,0,3,36,25,0,61,140,21,222
1123519,4,3,7,75,36,6,117,230,28,375
1123601,6,0,6,101,39,6,146,288,34,468
1123602,0,0,0,0,0,0,0,0,0,0
1123603,0,0,0,0,0,0,0,0,0,0
1123604,0,0,0,30,7,0,37,86,0,123
1123605,0,3,3,16,0,0,16,17,9,42
1123606,0,0,0,0,0,0,0,0,0,0
1123607,0,0,0,0,0,0,0,0,0,0
1123608,14,0,14,64,21,3,88,215,23,326
1123609,0,0,0,57,32,6,95,243,13,351
1123610,0,0,0,36,28,0,64,150,10,224
1123611,7,0,7,48,22,0,70,247,25,342
1123612,8,0,8,48,24,0,72,223,16,311
1123613,9,6,15,32,8,3,43,135,18,196
1123614,157,18,175,0,6,0,6,402,36,444
1123615,14,4,21,22,22,0,44,267,29,340
1123616,4,3,7,67,22,9,98,203,15,316
1123617,6,6,12,46,26,3,75,314,41,430
1123618,24,5,29,72,55,6,133,476,55,664
1123619,18,3,21,49,29,4,82,262,18,362
1123620,13,0,13,37,16,0,53,196,21,270
1123621,3,0,3,42,18,0,60,203,20,283
1123622,10,3,13,52,22,0,74,232,36,342
1123623,9,3,12,35,22,6,63,194,36,293
1123624,0,4,4,25,23,3,51,170,22,243
1123625,4,0,4,39,15,0,54,131,9,194
1123626,6,0,6,33,19,3,55,186,17,258
1123627,6,3,9,46,21,0,67,221,47,335
1123628,8,0,8,51,15,6,72,201,19,292
1123629,6,3,9,45,32,0,77,227,29,333
1123630,25,9,34,75,48,0,123,321,64,508
1123631,13,12,25,30,22,0,52,174,35,261
1123632,12,3,15,27,19,0,46,162,40,248
1123633,11,3,14,79,26,14,119,246,19,384
1123634,36,50,86,44,31,3,78,224,94,396
1123635,113,9,122,19,13,3,35,284,27,346
1123636,29,6,35,49,25,0,74,317,31,422
1123637,15,7,22,34,13,3,50,172,33,255
1123638,7,11,18,84,49,7,140,250,46,436
1123639,9,0,9,43,16,3,62,208,30,300
1123640,7,0,7,63,29,3,95,232,21,348
1123641,4,0,4,35,11,0,46,146,4,196
1123642,3,3,6,50,26,0,76,182,25,283
1123643,6,0,6,43,17,0,60,130,11,201
1123644,27,4,31,43,13,0,56,290,40,386
1123645,18,3,21,26,30,0,56,174,30,260
1123646,18,4,22,65,23,7,95,321,39,455
1123647,11,3,14,60,38,9,107,204,25,336
1123701,14,6,20,53,26,3,82,244,24,350
1123702,4,0,4,44,10,3,57,120,14,191
1123703,17,3,20,66,22,4,92,229,16,337
1123704,8,0,8,95,19,6,120,253,29,402
1123705,5,0,5,48,10,0,58,157,16,231
1123706,7,3,10,79,35,3,117,261,24,402
1123707,0,0,0,6,3,0,9,53,9,71
1123708,4,0,4,65,25,3,93,182,21,296
1123709,3,0,3,61,16,9,86,193,8,287
1123710,6,0,6,46,12,0,58,131,15,204
1123711,6,0,6,35,20,0,55,142,4,201
1123712,9,0,9,90,26,6,122,234,14,370
1123713,3,0,3,24,0,3,27,113,6,146
1123714,3,0,3,40,24,0,64,150,17,231
1123715,75,0,75,9,3,0,12,167,0,179
1123716,6,0,6,66,29,3,98,214,9,321
1123717,0,0,0,182,48,6,236,389,16,641
1123718,0,0,0,65,11,0,76,195,18,289
1123719,3,0,3,52,18,3,73,127,9,209
1123720,3,0,3,57,20,0,77,127,8,212
1123721,0,0,0,45,6,6,57,165,26,248
1123722,0,0,0,49,12,3,64,127,9,200
1123723,6,0,6,33,8,3,44,104,5,153
1123724,6,0,6,72,39,0,111,253,14,378
1123725,0,0,0,67,33,6,106,222,21,349
1123726,0,0,0,42,20,0,62,128,4,194
1123727,0,0,0,39,26,12,77,167,15,259
1123728,0,0,0,32,18,0,50,107,13,170
1123729,9,0,9,26,29,0,55,87,3,145
1123730,5,0,5,29,4,0,33,119,3,155
1123731,6,0,6,47,24,3,74,136,6,216
1123732,4,0,4,102,29,0,131,177,22,330
1123733,3,0,3,42,33,0,75,193,21,289
1123734,6,0,6,80,25,3,108,246,22,376
1123735,6,0,6,133,44,0,177,300,17,494
1123736,10,0,10,43,33,0,76,223,6,305
1123737,8,3,11,47,24,0,71,202,13,286
1123738,10,3,13,53,10,0,63,166,18,247
1123739,20,0,20,75,19,4,98,218,15,331
1123740,13,6,19,52,24,3,79,200,28,307
1123741,13,0,13,77,29,0,106,253,17,376
1123742,65,0,65,49,25,6,80,241,17,338
1123743,11,0,11,37,18,0,55,142,6,203
1123744,15,0,15,46,22,8,76,169,9,254
1123745,13,0,13,22,20,4,46,94,6,146
1123746,0,0,0,46,22,6,74,188,4,266
1123801,0,0,0,32,12,6,50,99,13,162
1123802,4,3,7,55,14,0,69,154,12,235
1123803,6,3,13,63,26,0,89,237,36,362
1123804,0,0,0,54,15,4,73,129,9,211
1123805,0,4,4,36,13,0,49,140,16,205
1123806,0,0,0,36,14,9,59,122,18,199
1123807,0,0,0,68,21,9,98,181,30,309
1123808,0,3,3,47,27,0,74,166,34,274
1123809,3,0,3,52,16,3,71,104,6,181
1123810,3,0,3,54,7,4,65,119,9,193
1123811,6,3,9,59,20,0,79,146,21,246
1123812,0,0,0,42,3,3,48,52,17,117
1123813,3,3,6,39,3,3,45,102,3,150
1123814,0,3,3,48,18,3,69,139,12,220
1123815,0,0,0,90,16,3,109,143,6,258
1123816,3,0,3,63,15,4,82,137,24,243
1123817,3,0,3,87,12,9,108,208,14,330
1123818,46,4,50,97,22,3,122,205,13,340
1123901,18,4,22,62,22,9,93,250,38,381
1123902,6,0,6,87,33,6,126,263,32,421
1123903,3,3,6,26,18,9,53,121,21,195
1123904,7,0,7,26,14,3,43,110,7,160
1123905,15,8,26,35,23,12,70,244,60,374
1123906,6,0,6,64,24,16,104,157,28,289
1123907,0,0,0,17,9,3,29,89,12,130
1123908,0,0,0,0,0,0,0,0,0,0
1123909,4,0,4,79,15,6,100,216,19,335
1123910,6,3,9,82,34,6,122,318,27,467
1123911,0,0,0,60,21,12,93,82,9,184
1123912,0,0,0,0,0,0,0,0,0,0
1123913,0,0,0,105,34,10,149,207,20,376
1123914,5,0,5,117,32,7,156,224,16,396
1123915,0,0,0,0,0,3,3,0,0,3
1123916,0,0,0,3,0,3,6,11,0,17
1123917,5,0,5,81,18,6,105,175,22,302
1123918,6,0,6,95,43,6,144,243,27,414
1123919,5,0,5,65,22,4,91,172,7,270
1123920,7,3,10,70,29,10,109,267,10,386
1123921,3,0,3,41,18,6,65,167,15,247
1123922,4,0,4,47,13,0,60,120,4,184
1123923,7,0,7,29,6,3,38,135,11,184
1123924,0,0,0,78,17,3,98,142,18,258
1123925,0,0,0,83,9,7,99,147,16,262
1124001,33,3,36,26,34,0,60,241,36,337
1124002,3,0,3,20,7,0,27,127,36,190
1124003,7,0,7,29,18,3,50,153,18,221
1124004,4,0,4,54,26,4,84,250,26,360
1124005,3,0,3,68,26,12,106,260,22,388
1124006,3,3,6,26,19,3,48,223,32,303
1124007,6,0,6,39,12,0,51,137,20,208
1124008,0,0,0,59,20,6,85,188,31,304
1124009,0,0,0,52,15,0,67,136,16,219
1124010,6,0,6,23,8,0,31,124,10,165
1124011,22,0,22,97,20,11,128,280,54,462
1124012,3,0,3,52,12,9,73,123,36,232
1124013,6,0,6,65,40,10,115,231,28,374
1124014,0,0,0,67,15,6,88,189,25,302
1124015,6,0,6,91,19,8,118,233,25,376
1124016,3,0,3,41,22,0,63,168,28,259
1124017,16,6,22,19,15,0,34,146,25,205
1124018,8,0,8,52,20,3,75,222,35,332
1124019,6,0,6,42,16,0,58,171,23,252
1124020,0,0,0,35,10,3,48,109,32,189
1124021,15,13,28,36,25,6,67,282,74,423
1124022,3,0,3,83,33,0,116,300,41,457
1124023,0,4,4,74,25,4,103,296,35,434
1124024,4,0,4,29,18,3,50,131,13,194
1124025,6,0,6,45,15,3,63,122,6,191
1124101,4,3,7,66,16,6,88,147,21,256
1124102,14,0,14,40,27,0,67,151,20,238
1124103,6,0,6,70,19,3,92,246,22,360
1124104,0,0,0,36,13,6,55,117,3,175
1124105,8,8,16,40,13,0,53,189,30,272
1124106,7,0,7,67,22,4,93,237,16,346
1124107,10,0,10,43,22,4,69,214,18,301
1124108,10,3,13,54,24,0,78,325,42,445
1124109,15,6,24,84,32,5,121,295,46,462
1124110,16,3,19,69,30,6,105,314,30,449
1124111,0,0,0,37,13,6,56,160,21,237
1124112,0,0,0,59,9,0,68,132,9,209
1124113,3,0,3,18,4,0,22,94,9,125
1124114,6,3,9,18,19,0,37,162,18,217
1124115,0,0,0,3,0,0,3,3,0,6
1124201,11,3,14,41,15,3,59,188,21,268
1124202,6,0,6,56,24,0,80,194,18,292
1124203,4,0,4,65,24,4,93,207,15,315
1124204,3,0,3,36,21,6,63,81,10,154
1124205,3,5,8,98,33,10,141,273,21,435
1124206,3,0,3,100,34,5,139,257,20,416
1124207,0,0,0,7,0,3,10,36,0,46
1124208,0,0,0,20,7,3,30,35,7,72
1124209,6,0,6,97,21,9,127,328,18,473
1124210,0,0,0,0,3,0,3,6,0,9
1124211,0,0,0,88,28,7,123,260,12,395
1124212,0,0,0,88,22,7,117,170,16,303
1124213,3,0,3,63,28,3,94,178,15,287
1124214,6,3,9,150,30,7,187,306,13,506
1124215,0,0,0,71,22,12,105,191,16,312
1124216,3,0,3,69,33,4,106,177,22,305
1124217,3,0,3,146,20,15,181,212,9,402
1124218,3,0,6,87,27,0,114,190,20,324
1124219,8,3,11,89,28,0,117,305,30,452
1124301,4,0,4,45,10,0,55,119,10,184
1124302,3,0,3,40,26,8,74,146,15,235
1124303,6,0,6,50,21,6,77,176,36,289
1124304,6,0,6,106,30,10,146,241,36,423
1124305,0,0,0,26,18,3,47,101,16,164
1124306,9,0,9,63,15,0,78,176,28,282
1124307,6,0,6,47,19,0,66,100,13,179
1124308,3,0,3,99,20,9,128,196,18,342
1124309,12,7,19,35,29,6,70,226,24,320
1124310,4,0,4,73,17,11,101,135,19,255
1124311,13,3,16,89,26,4,119,215,29,363
1124312,29,0,29,43,9,0,52,162,11,225
1124313,9,0,9,63,13,17,93,190,16,299
1124314,6,3,9,40,4,6,50,143,15,208
1124315,4,0,7,62,29,16,107,180,21,308
1124316,3,3,6,39,16,9,64,137,46,247
1124317,0,3,3,47,17,3,67,138,15,220
1124318,4,0,4,79,37,3,119,229,19,367
1124319,3,0,3,99,22,8,129,268,47,444
1124320,0,0,0,53,17,4,74,131,38,243
1124321,3,0,3,45,21,5,71,132,29,232
1124401,0,0,0,15,0,0,15,54,0,69
1124402,0,3,3,82,35,3,120,179,15,314
1124403,0,0,0,109,41,10,160,264,12,436
1124404,45,5,50,64,45,3,112,301,39,452
1124405,8,0,8,25,7,0,32,145,12,189
1124406,8,3,11,56,40,4,100,261,31,392
1124407,4,0,4,43,35,0,78,206,25,309
1124408,11,4,15,66,18,3,87,217,28,332
1124409,3,3,6,104,31,4,139,257,24,420
1124410,4,3,7,29,14,3,46,111,18,175
1124411,7,4,11,75,32,0,107,200,21,328
1124412,17,4,21,60,44,4,108,228,42,378
1124413,10,0,10,50,12,0,62,203,31,296
1124414,0,0,0,19,12,3,34,79,11,124
1124415,0,3,3,19,9,0,28,55,3,86
1124416,0,0,0,52,20,3,75,141,19,235
1124417,0,0,0,0,0,0,0,0,0,0
1124418,14,3,17,48,14,0,62,158,33,253
1124419,0,0,0,9,6,0,15,9,6,30
1124420,0,0,0,0,0,0,0,0,0,0
1124421,0,0,0,0,12,0,12,165,12,189
1124422,3,0,3,31,9,3,43,89,6,138
1124423,4,0,4,70,35,3,108,163,50,321
1124424,6,0,6,47,18,0,65,167,54,286
1124425,5,6,11,80,37,4,121,227,54,402
1124426,3,0,3,43,4,3,50,159,30,239
1124427,11,6,17,38,24,0,62,192,30,284
1124428,10,7,17,75,36,0,111,290,38,439
1124429,0,35,35,57,23,6,86,156,80,322
1124430,10,3,13,72,28,0,100,221,27,348
1124431,27,0,27,68,26,7,101,301,28,430
1124432,29,5,34,52,24,3,79,242,30,351
1124433,7,0,7,34,22,0,56,128,17,201
1124434,6,0,11,57,14,6,77,148,25,250
1124435,10,6,16,54,23,3,80,171,34,285
1124501,0,6,6,33,10,0,43,172,22,237
1124502,22,0,22,23,4,0,27,101,23,151
1124503,3,3,6,57,11,0,68,139,12,219
1124504,6,0,6,46,19,11,76,161,28,265
1124505,0,3,3,28,18,0,46,101,27,174
1124506,4,3,7,15,12,3,30,81,9,120
1124507,6,0,6,31,21,3,55,157,12,224
1124508,3,3,6,29,12,3,44,127,19,190
1124509,6,0,6,16,7,3,26,120,19,165
1124510,3,0,3,31,14,0,45,119,29,193
1124511,3,0,3,19,0,0,19,78,9,106
1124512,0,0,0,40,22,0,62,154,6,222
1124513,0,0,0,41,20,0,61,104,8,173
1124514,3,0,3,37,16,9,62,133,0,195
1124515,3,0,3,19,13,6,38,90,12,140
1124516,3,0,3,68,22,0,90,176,0,266
1124517,0,0,0,71,25,3,99,150,25,274
1124518,0,0,0,22,12,0,34,94,15,143
1124519,4,0,4,38,8,3,49,145,15,209
1124520,0,0,0,48,15,3,66,78,6,150
1124521,3,0,3,30,3,6,39,121,14,174
1124522,0,0,0,39,12,4,55,121,21,197
1124523,3,0,3,55,3,5,63,116,16,195
1124524,3,0,3,41,21,0,62,123,10,195
1124525,0,0,0,57,16,0,73,134,7,214
1124526,3,0,3,39,18,0,57,156,31,244
1124527,3,0,3,22,9,0,31,148,23,202
1124528,6,0,6,38,20,3,61,145,9,215
1124601,3,3,6,56,22,0,78,151,7,236
1124602,0,0,0,26,15,0,41,73,9,123
1124603,0,0,0,59,17,6,82,219,25,326
1124604,6,0,6,84,27,10,121,280,44,445
1124605,5,0,5,65,22,6,93,161,0,254
1124606,7,3,10,49,22,6,77,173,15,265
1124607,6,0,6,83,30,0,113,246,15,374
1124608,27,3,30,81,47,3,131,359,27,517
1124609,7,0,7,59,20,3,82,192,21,295
1124610,6,3,9,90,45,4,139,297,26,462
1124611,90,0,90,52,18,9,79,275,4,358
1124612,0,0,0,49,30,10,89,148,10,247
1124613,8,0,8,62,32,4,98,227,19,344
1124614,9,4,13,91,24,6,121,280,35,436
1124615,18,7,25,44,22,3,69,158,21,248
1124616,6,0,6,76,34,5,115,271,24,410
1124617,3,0,3,67,29,0,96,183,14,293
1124618,4,0,4,67,42,15,124,280,15,419
1124619,3,0,3,38,21,0,59,203,6,268
1124620,6,3,9,50,37,6,93,226,21,340
1124621,0,0,0,36,16,3,55,135,15,205
1124622,3,3,6,54,24,3,81,236,12,329
1124623,6,0,9,38,32,6,76,166,16,258
1124624,0,0,0,93,33,7,133,216,11,360
1124625,62,3,65,29,15,6,50,244,21,315
1124626,7,3,10,55,10,0,65,137,21,223
1124627,4,0,4,62,35,0,97,187,25,309
1124628,6,3,9,34,15,0,49,147,18,214
1124629,0,0,0,77,25,6,108,126,3,237
1124630,0,0,0,72,23,0,95,274,5,374
1124631,3,0,3,14,8,0,22,59,9,90
1124632,0,0,0,62,28,4,94,140,19,253
1124633,0,0,0,37,23,0,60,146,12,218
1124634,0,0,0,25,15,3,43,99,8,150
1124701,0,0,0,15,12,0,27,74,10,111
1124702,0,0,0,18,15,5,38,101,20,159
1124703,4,0,4,80,22,5,107,319,31,457
1124704,0,0,0,26,15,0,41,106,24,171
1124705,3,0,3,32,21,0,53,147,7,207
1124706,0,3,3,41,18,0,59,103,9,171
1124707,0,0,3,66,26,0,92,204,21,317
1124708,0,0,0,32,17,0,49,113,3,165
1124709,0,0,0,55,19,0,74,218,14,306
1124710,3,0,3,33,16,7,56,100,7,163
1124711,3,0,3,64,13,0,77,196,21,294
1124712,0,0,0,29,3,3,35,80,6,121
1124713,0,0,0,35,18,6,59,111,16,186
1124714,10,4,14,83,32,5,120,239,33,392
1124715,13,7,20,87,55,0,142,297,32,471
1124716,6,4,10,25,17,6,48,129,17,194
1124717,0,0,0,27,10,3,40,112,18,170
1124718,57,4,61,40,27,6,73,198,11,282
1124719,9,0,9,64,31,4,99,227,18,344
1124720,13,0,13,60,37,6,103,226,35,364
1124721,3,6,9,33,18,4,55,177,24,256
1124722,5,0,5,26,10,0,36,86,12,134
1124723,0,0,0,27,16,0,43,116,13,172
1124724,0,0,0,34,11,6,51,151,10,212
1124725,3,3,9,36,15,0,51,189,31,271
1124801,0,0,0,11,9,0,20,67,12,99
1124802,13,0,13,34,8,3,45,190,12,247
1124803,19,0,19,80,31,11,122,291,9,422
1124804,3,4,10,44,21,6,71,184,40,295
1124805,8,0,11,74,24,11,109,205,23,337
1124806,51,4,55,63,29,5,97,318,54,469
1124807,3,0,3,34,26,0,60,272,52,384
1124808,24,4,28,75,50,3,128,305,36,469
1124809,8,0,8,37,26,4,67,251,17,335
1124810,3,0,3,79,34,0,113,244,15,372
1124811,8,3,11,84,30,9,123,261,21,405
1124812,10,0,10,64,35,0,99,258,28,385
1124813,9,0,9,35,12,0,47,159,22,228
1124814,4,0,4,57,26,0,83,238,13,334
1124815,6,4,10,88,33,12,133,179,24,336
1124816,6,3,9,95,17,9,121,210,30,361
1124817,3,0,3,47,17,3,67,181,26,274
1124818,12,3,15,106,32,6,144,296,35,475
1124819,6,5,11,54,38,3,95,260,30,385
1124820,8,0,8,39,28,9,76,248,7,331
1124821,8,0,8,84,22,4,110,283,15,408
1124822,0,0,0,21,18,3,42,126,19,187
1124823,5,0,5,86,41,0,127,270,15,412
1124824,8,0,8,56,28,3,87,246,8,341
1124825,12,4,16,74,36,5,115,234,13,362
1124826,0,0,0,64,36,8,108,221,21,350
1124827,7,0,7,43,28,0,71,131,9,211
1124828,8,0,8,59,14,0,73,149,3,225
1124829,62,7,69,41,15,3,59,261,23,343
1124830,3,3,6,74,25,14,113,243,19,375
1124831,3,0,3,20,6,0,26,56,3,85
1124832,5,0,5,25,13,3,41,120,14,175
1124833,3,0,3,32,19,0,51,135,15,201
1124834,6,3,9,20,11,0,31,157,33,221
1124835,3,0,3,62,29,3,94,299,40,433
1124836,6,3,9,48,16,3,67,199,27,293
1124837,3,0,3,80,22,6,108,217,31,356
1124838,4,0,4,27,15,0,42,80,12,134
1124839,3,0,3,49,29,10,88,178,34,300
1124840,6,6,12,59,15,0,74,241,21,336
1124901,6,0,9,117,29,8,154,235,24,413
1124902,3,0,3,47,18,9,74,97,3,174
1124903,3,0,3,52,6,0,58,109,11,178
1124904,0,0,0,89,34,0,123,247,18,388
1124905,6,0,6,47,20,3,70,148,6,224
1124906,0,0,0,63,27,0,90,163,23,276
1124907,0,0,0,30,13,0,43,92,0,135
1124908,0,0,0,57,29,6,92,169,19,280
1124909,0,3,3,67,27,6,100,195,41,336
1124910,0,0,0,67,35,6,108,288,22,418
1124911,0,0,0,91,31,5,127,189,21,337
1124912,3,0,3,126,35,0,161,311,42,514
1124913,6,0,6,45,34,9,88,177,11,276
1124914,4,0,4,54,36,6,96,164,12,272
1124915,3,0,3,64,14,0,78,89,3,170
1124916,0,0,0,72,31,7,110,164,16,290
1124917,4,0,4,57,31,3,91,181,18,290
1124918,4,0,4,29,12,0,41,117,3,161
1124919,3,0,3,78,41,0,119,236,19,374
1124920,3,0,3,34,24,3,61,184,9,254
1124921,0,0,0,67,24,0,91,197,22,310
1124922,3,0,3,96,44,6,146,265,8,419
1124923,3,0,3,30,13,3,46,110,6,162
1124924,0,3,3,67,18,0,85,184,9,278
1124925,0,0,0,61,22,0,83,160,19,262
1124926,0,0,0,76,30,0,106,134,6,246
1124927,3,0,3,56,12,0,68,88,3,159
1124928,0,0,0,0,0,0,0,3,0,3
1124929,0,3,3,23,20,0,43,156,19,218
1124930,5,5,10,49,30,3,82,241,65,388
1124931,0,0,0,43,18,4,65,89,20,174
1124932,0,0,0,20,7,0,27,87,27,141
1124933,6,0,6,82,33,6,121,247,30,398
1124934,3,0,3,67,27,12,106,212,40,358
1124935,4,0,4,37,18,0,55,135,9,199
1124936,0,0,0,40,15,6,61,129,28,218
1124937,3,0,6,58,33,4,95,186,18,299
1124938,4,0,4,49,8,6,63,116,13,192
1124939,0,0,0,50,32,7,89,166,14,269
1124940,0,0,0,42,18,0,60,143,14,217
1124941,3,0,3,37,24,5,66,108,8,182
1124942,12,0,12,73,21,4,98,241,21,360
1124943,3,3,6,64,16,6,86,186,18,290
1124944,0,0,0,40,14,0,54,159,6,219
1125001,6,6,12,101,30,9,140,225,66,431
1125002,0,0,0,185,55,9,249,386,37,672
1125003,0,0,0,190,26,11,227,279,32,538
1125004,4,0,4,222,50,12,284,314,25,623
1125005,3,0,3,87,50,4,141,242,26,409
1125006,7,0,7,51,23,6,80,155,21,256
1125007,11,0,11,69,40,3,112,371,60,543
1125008,18,5,23,60,34,6,100,345,40,485
1125009,8,4,12,103,32,6,141,309,29,479
1125010,0,0,0,0,0,0,0,0,0,0
1125011,5,0,5,89,27,0,116,220,25,361
1125012,11,0,11,70,38,0,108,211,28,347
1125013,12,9,21,70,42,4,116,297,39,452
1125014,30,3,33,0,14,0,14,311,23,348
1125015,0,0,0,66,21,4,91,148,9,248
1125016,14,3,17,74,27,3,104,191,26,321
1125017,3,52,55,63,49,9,121,325,124,570
1125018,6,38,44,23,10,0,33,150,79,262
1125019,4,3,7,15,18,0,33,274,43,350
1125020,8,3,11,76,25,6,107,363,67,537
1125021,10,7,17,46,20,0,66,320,48,434
1125022,9,0,9,52,31,3,86,167,12,265
1125101,13,12,25,64,27,3,94,211,34,339
1125102,3,0,3,50,16,0,66,111,0,177
1125103,13,0,13,81,37,6,124,227,23,374
1125104,8,3,11,38,18,0,56,163,26,245
1125105,15,8,23,112,23,4,139,271,40,450
1125106,7,5,12,31,13,6,50,148,29,227
1125107,11,0,11,53,32,4,89,235,29,353
1125108,15,9,24,108,32,6,146,268,40,454
1125109,0,3,3,3,5,0,8,43,7,58
1125110,0,0,0,0,0,0,0,6,0,6
1125111,30,4,34,60,30,9,99,236,29,364
1125112,0,0,0,49,19,0,68,137,27,232
1125113,10,0,10,69,35,6,110,230,22,362
1125114,7,0,7,56,15,6,77,181,25,283
1125115,4,4,8,132,35,8,175,281,17,473
1125116,100,15,118,3,9,0,12,292,47,351
1125117,6,0,6,38,18,0,56,157,11,224
1125118,0,0,0,0,3,0,3,0,0,3
1125119,66,6,72,60,30,6,96,280,31,407
1125120,0,0,0,60,13,3,76,183,12,271
1125121,12,3,15,67,29,6,102,200,30,332
1125122,7,0,7,93,25,0,118,265,24,407
1125123,0,0,0,53,8,4,65,77,12,154
1125201,6,0,6,39,24,12,75,146,34,255
1125202,0,0,0,37,19,0,56,128,7,191
1125203,0,0,0,82,38,6,126,220,35,381
1125204,0,0,0,35,16,4,55,109,10,174
1125205,0,0,0,56,22,3,81,270,27,378
1125206,0,0,0,76,27,4,107,164,28,299
1125207,0,0,0,32,6,0,38,127,17,182
1125208,3,0,3,51,18,3,72,123,3,198
1125209,3,3,6,38,9,3,50,120,15,185
1125210,6,0,6,44,19,10,73,181,20,274
1125211,4,0,4,46,20,0,66,134,19,219
1125212,3,0,3,59,30,9,98,195,27,320
1125213,4,0,4,37,12,6,55,168,18,241
1125214,0,0,0,43,23,0,66,176,30,272
1125215,3,0,3,29,14,6,49,101,17,167
1125216,0,0,0,33,8,4,45,106,4,155
1125217,0,0,0,40,9,0,49,147,25,221
1125218,3,0,3,44,20,0,64,183,22,269
1125219,3,0,3,39,19,6,64,166,27,257
1125220,7,4,11,48,22,0,70,183,22,275
1125221,7,0,7,34,10,6,50,123,19,192
1125222,6,0,6,58,17,9,84,154,16,254
1125223,0,0,0,30,19,4,53,113,18,184
1125224,3,0,3,43,17,0,60,180,22,262
1125225,0,0,0,39,16,4,59,145,22,226
1125226,3,0,3,55,22,0,77,154,9,240
1125227,0,0,0,63,25,0,88,184,17,289
1125228,0,0,0,25,19,3,47,107,15,169
1125229,8,0,8,73,25,3,101,275,15,391
1125230,0,0,0,37,10,3,50,96,24,170
1125231,0,0,0,49,16,4,69,131,21,221
1125232,0,0,0,47,18,0,65,134,23,222
1125301,0,3,3,63,30,6,99,182,21,302
1125302,6,3,12,57,27,3,87,203,24,314
1125303,0,0,0,77,30,7,114,236,27,377
1125304,0,7,7,44,23,0,67,136,28,231
1125305,0,0,0,111,25,6,142,130,18,290
1125306,3,0,3,39,12,3,54,168,24,246
1125307,0,0,0,34,24,3,61,141,29,231
1125308,0,0,0,208,19,12,239,172,11,422
1125309,68,0,68,187,45,4,236,489,27,752
1125310,6,6,12,84,17,12,113,238,22,373
1125311,3,0,3,58,30,3,91,265,21,377
1125312,7,0,7,94,26,5,125,180,6,311
1125313,0,0,0,76,20,0,96,205,12,313
1125314,11,0,11,86,42,7,135,299,38,472
1125315,7,0,7,73,15,12,100,203,14,317
1125316,0,0,0,86,24,6,116,290,32,438
1125317,4,0,4,61,9,4,74,149,21,244
1125318,3,0,3,62,29,3,94,180,24,298
1125319,0,0,0,0,0,0,0,0,0,0
1125320,10,6,16,36,36,4,76,406,59,541
1125321,4,0,4,42,23,0,65,132,21,218
1125322,3,0,3,38,24,0,62,133,22,217
1125323,3,0,3,118,40,11,169,241,27,437
1125324,0,0,0,0,0,0,0,0,0,0
1125325,3,0,3,92,25,8,125,213,18,356
1125326,0,0,0,53,29,3,85,167,15,267
1125327,0,0,0,88,26,5,119,230,24,373
1125328,0,0,0,98,34,9,141,217,17,375
1125329,0,0,0,118,25,3,146,223,25,394
1125401,36,16,52,24,19,0,43,296,51,390
1125402,76,7,83,12,12,0,24,300,42,366
1125403,8,0,8,0,3,0,3,124,21,148
1125404,18,11,29,9,9,0,18,141,76,235
1125405,68,14,82,26,13,0,39,319,43,401
1125406,8,0,8,60,17,6,83,137,20,240
1125407,0,0,0,60,36,6,102,158,21,281
1125408,19,4,23,54,28,0,82,320,45,447
1125409,16,6,22,28,19,3,50,174,32,256
1125410,24,4,31,32,12,0,44,263,58,365
1125411,20,4,24,27,9,0,36,264,58,358
1125412,13,0,13,11,22,0,33,308,11,352
1125413,5,0,5,21,15,0,36,166,18,220
1125414,10,0,10,61,23,0,84,212,22,318
1125415,14,0,14,48,30,3,81,246,33,360
1125416,9,3,12,12,19,0,31,160,12,203
1125417,0,0,0,34,23,3,60,100,27,187
1125418,3,0,3,58,35,7,100,216,32,348
1125419,0,0,0,63,22,3,88,141,18,247
1125420,7,0,7,50,9,6,65,236,33,334
1125421,6,3,9,65,16,0,81,262,34,377
1125422,7,0,7,95,19,10,124,245,22,391
1125423,0,0,0,63,16,7,86,151,9,246
1125424,6,0,6,86,22,5,113,208,13,334
1125425,6,0,6,80,21,0,101,208,17,326
1125426,4,0,4,75,23,0,98,219,6,323
1125427,3,0,3,40,10,0,50,122,4,176
1125428,0,0,0,39,21,4,64,150,34,248
1125429,3,3,6,76,24,0,100,194,71,365
1125430,5,0,5,27,26,3,56,172,9,237
1125431,8,4,12,48,26,3,77,249,30,356
1125432,11,4,15,71,27,3,101,320,38,459
1125433,35,3,38,60,18,5,83,330,24,437
1125434,0,0,0,45,25,0,70,171,18,259
1125435,0,7,7,112,34,10,156,305,31,492
1125436,5,0,5,35,12,3,50,136,33,219
1125437,3,3,6,17,0,0,17,102,21,140
1125438,6,3,9,56,19,4,79,234,49,362
1125439,8,9,17,36,27,0,63,223,47,333
1125440,6,6,12,132,35,9,176,397,51,624
1125441,37,3,40,0,13,0,13,418,59,490
1125442,18,10,28,22,24,0,46,329,108,483
1125443,0,0,0,45,21,3,69,139,7,215
1125444,3,0,3,103,30,6,139,308,20,467
1125445,22,21,43,55,15,3,73,144,52,269
1125446,20,3,23,68,38,3,109,324,40,473
1125447,12,0,12,36,26,0,62,267,35,364
1125501,11,6,17,110,42,8,160,343,34,537
1125502,0,3,3,87,21,3,111,162,36,309
1125503,3,3,6,78,22,3,103,183,14,300
1125504,0,0,0,27,21,0,48,141,6,195
1125505,0,0,0,0,0,0,0,0,0,0
1125506,9,6,15,34,21,3,58,176,15,249
1125507,4,0,4,78,22,7,107,150,18,275
1125508,6,0,6,88,31,9,128,277,18,423
1125509,0,0,3,29,9,3,41,101,12,154
1125510,7,6,16,51,28,12,91,155,27,273
1125511,32,10,42,79,56,0,135,348,59,542
1125512,3,0,3,45,27,0,72,169,9,250
1125513,10,12,22,61,30,0,91,454,96,641
1125514,7,6,13,25,18,6,49,171,33,253
1125515,6,0,6,56,14,4,74,155,5,234
1125516,6,3,12,104,44,6,154,263,16,433
1125517,0,3,3,27,9,3,39,113,16,168
1125518,16,3,19,67,33,3,103,348,50,501
1125519,50,8,58,19,7,6,32,185,16,233
1125520,8,0,8,25,23,4,52,209,22,283
1125521,3,3,6,80,39,9,128,282,27,437
1125522,28,7,35,8,18,0,26,176,37,239
1125523,0,0,0,0,0,0,0,6,0,6
1125524,16,0,16,80,40,0,120,288,21,429
1125525,48,22,70,25,15,0,40,326,68,434
1125526,14,6,20,21,22,0,43,218,25,286
1125527,3,0,3,43,18,0,61,168,20,249
1125528,8,3,11,66,29,0,95,322,24,441
1125529,3,3,6,29,18,3,50,102,18,170
1125530,9,0,9,84,38,3,125,269,26,420
1125531,6,0,6,88,35,0,123,301,31,455
1125532,13,3,16,84,31,0,115,175,28,318
1125533,0,0,0,50,18,9,77,169,9,255
1125534,3,0,3,59,19,0,78,153,8,239
1125535,0,0,0,0,0,0,0,0,0,0
1125536,4,0,4,78,24,3,105,203,38,346
1125537,54,0,54,9,12,6,27,134,12,173
1125538,0,0,0,56,9,4,69,126,10,205
1125539,3,0,3,72,18,0,90,174,16,280
1125540,7,3,10,7,20,3,30,141,17,188
1125541,83,19,102,6,13,0,19,292,51,362
1125542,8,0,8,73,29,4,106,239,30,375
1125543,13,0,13,76,53,0,129,354,25,508
1125544,123,13,136,24,6,3,33,412,52,497
1125545,56,6,62,21,13,0,34,235,24,293
1125546,6,3,9,45,33,6,84,223,22,329
1125547,17,3,23,50,19,4,73,301,30,404
1125548,0,0,0,71,12,4,87,113,8,208
1125549,7,6,13,39,13,0,52,107,17,176
1125550,6,0,6,93,39,0,132,263,20,415
1125551,5,0,5,51,28,0,79,202,15,296
1125552,3,0,3,31,19,0,50,198,55,303
1125553,5,0,5,85,17,6,108,248,18,374
1125554,10,0,10,103,40,3,146,266,11,423
1125555,4,0,4,32,24,9,65,151,10,226
1125556,8,0,8,54,28,0,82,193,6,281
1125557,11,6,17,60,23,0,83,248,31,362
1125558,20,8,28,33,24,0,57,376,72,505
1125559,0,0,0,18,15,6,39,201,36,276
1125560,18,10,28,106,34,3,143,410,60,613
1125561,41,9,50,0,24,0,24,398,58,480
1125562,12,3,15,37,25,3,65,315,39,419
1125563,53,12,65,20,6,0,26,223,36,285
1125564,9,0,9,93,19,8,120,200,33,353
1125565,0,0,0,30,19,0,49,175,7,231
1125566,6,0,6,75,42,0,117,332,27,476
1125567,4,6,10,102,22,6,130,248,66,444
1125601,6,0,6,53,25,0,78,162,21,261
1125602,7,0,7,58,8,3,69,120,17,206
1125603,6,3,9,19,6,0,25,179,31,235
1125604,5,3,8,34,18,0,52,167,85,304
1125605,6,0,6,29,14,3,46,152,32,230
1125606,0,0,0,73,37,6,116,217,29,362
1125607,14,0,14,97,47,0,144,320,32,496
1125608,4,3,7,87,21,8,116,257,47,420
1125609,37,0,37,42,21,3,66,232,18,316
1125610,3,0,3,37,10,4,51,117,29,197
1125611,4,0,4,36,12,0,48,145,36,229
1125612,3,0,3,45,8,9,62,121,11,194
1125613,12,0,12,86,39,3,128,272,27,427
1125614,14,8,22,96,50,7,153,309,29,491
1125615,0,0,0,59,27,0,86,172,23,281
1125616,4,0,4,136,30,0,166,225,39,430
1125617,6,0,6,48,24,3,75,173,19,267
1125618,0,0,0,7,0,0,7,8,5,20
1125619,3,0,3,75,21,6,102,146,13,261
1125620,0,0,3,115,22,0,137,135,33,305
1125621,3,0,3,78,42,0,120,262,43,425
1125622,8,3,11,60,32,6,98,246,40,384
1125623,3,3,6,72,30,0,102,242,94,438
1125624,20,8,28,70,38,5,113,269,37,419
1125625,11,6,17,75,33,0,108,196,36,340
1125626,20,4,24,49,24,0,73,224,46,343
1125627,7,0,7,67,38,4,109,214,14,337
1125628,4,6,10,57,27,0,84,173,33,290
1125629,7,0,10,161,38,3,202,303,74,579
1125630,3,0,3,100,22,0,122,163,22,307
1125631,0,0,3,28,18,0,46,107,9,162
1125632,0,0,0,45,21,0,66,156,25,247
1125633,4,3,7,39,15,0,54,144,48,246
1125634,3,0,3,98,19,3,120,292,101,513
1125635,14,45,59,46,18,0,64,234,90,388
1125636,0,0,3,40,15,0,55,169,42,266
1125637,0,0,0,70,30,0,100,276,45,421
1125638,46,0,49,53,32,3,88,290,22,400
1125639,3,0,3,51,12,3,66,154,30,250
1125640,3,3,6,34,24,0,58,159,21,238
1125641,0,3,3,17,5,0,22,76,16,114
1125642,0,0,0,104,21,3,128,188,39,355
1125643,3,0,3,51,9,3,63,99,14,176
1125644,0,0,0,46,18,3,67,164,32,263
1125645,0,0,0,53,13,0,66,74,20,160
1125701,0,0,0,52,12,0,64,101,17,182
1125702,4,0,4,36,6,0,42,73,5,120
1125703,5,0,5,86,29,0,115,242,18,375
1125704,3,0,3,55,17,3,75,149,12,236
1125705,0,0,0,23,9,0,32,69,12,113
1125706,6,3,9,38,6,0,44,97,10,151
1125707,0,0,0,70,18,13,101,200,20,321
1125708,3,3,6,53,18,0,71,136,21,228
1125709,6,0,6,79,29,3,111,193,21,325
1125710,0,0,0,75,25,0,100,196,27,323
1125711,3,3,6,72,26,4,102,226,21,349
1125712,9,0,9,70,27,0,97,264,16,377
1125713,15,0,15,39,28,6,73,136,12,221
1125714,0,3,3,43,19,0,62,104,16,182
1125715,3,0,3,55,15,3,73,121,15,209
1125716,0,0,0,41,15,0,56,89,9,154
1125717,0,0,0,57,20,3,80,129,15,224
1125718,0,0,0,43,18,3,64,148,7,219
1125719,0,0,0,27,6,0,33,103,0,136
1125720,8,3,11,46,24,7,77,217,30,324
1125721,3,0,3,53,14,0,67,171,10,248
1125722,0,0,0,107,20,0,127,119,0,246
1125723,0,0,0,67,15,0,82,136,16,234
1125724,3,0,3,43,10,0,53,104,6,163
1125725,0,0,0,43,29,6,78,103,15,196
1125726,6,3,9,94,26,0,120,211,31,362
1125727,0,6,6,49,21,0,70,138,16,224
1125728,6,0,6,65,14,4,83,168,14,265
1125729,4,0,4,44,8,4,56,83,0,139
1125730,0,0,0,69,20,7,96,173,28,297
1125731,0,0,0,25,6,0,31,118,32,181
1125732,0,0,0,88,21,0,109,231,35,375
1125733,0,0,0,37,15,0,52,148,34,234
1125734,6,0,6,53,22,7,82,172,11,265
1125735,0,0,0,33,24,0,57,153,16,226
1125736,11,0,11,42,12,5,59,202,18,279
1125737,6,0,6,29,16,3,48,119,17,184
1125738,4,0,4,54,8,0,62,121,19,202
1125739,0,0,0,0,0,0,0,0,0,0
1125740,0,0,0,55,11,0,66,98,9,173
1125741,3,3,6,79,24,6,109,187,24,320
1125742,0,0,0,37,12,0,49,89,9,147
1125801,18,3,21,27,15,3,45,160,16,221
1125802,10,3,13,81,43,9,133,302,15,450
1125803,0,0,0,9,6,0,15,0,0,15
1125804,12,3,15,40,18,0,58,241,36,335
1125805,3,0,3,38,16,0,54,142,35,231
1125806,0,0,0,12,3,0,15,20,0,35
1125807,0,0,0,54,9,0,63,133,19,215
1125808,3,0,3,18,12,6,36,96,14,146
1125809,0,3,3,43,18,0,61,160,27,248
1125810,0,0,0,63,17,4,84,154,21,259
1125811,6,3,9,36,31,0,67,198,48,313
1125812,3,0,3,11,12,3,26,48,27,101
1125813,0,3,3,57,22,3,82,118,15,215
1125814,3,0,3,39,19,6,64,109,15,188
1125815,0,0,0,49,16,3,68,140,39,247
1125816,0,0,0,55,18,3,76,154,37,267
1125817,6,5,11,55,24,0,79,153,28,260
1125818,3,0,3,95,38,0,133,228,28,389
1125819,0,0,0,35,15,3,53,102,13,168
1125820,6,0,6,55,27,3,85,172,23,280
1125821,3,3,6,77,23,9,109,160,20,289
1125822,3,0,3,48,20,0,68,160,16,244
1125823,0,0,0,38,30,0,68,111,9,188
1125824,3,0,3,47,26,0,73,152,18,243
1125825,0,0,0,45,0,0,45,104,19,168
1125826,9,8,17,67,28,3,98,181,37,316
1125827,22,8,30,70,17,0,87,310,27,424
1125828,6,0,6,46,30,6,82,159,76,317
1125829,6,0,6,80,34,6,120,224,15,359
1125830,0,0,0,19,11,0,30,137,137,304
1125831,0,0,0,39,9,0,48,94,3,145
1125901,20,8,28,27,24,0,51,155,27,233
1125902,10,3,13,45,29,4,78,191,39,308
1125903,8,0,8,43,28,0,71,175,19,265
1125904,3,3,6,16,18,6,40,114,18,172
1125905,9,3,12,71,41,0,112,205,35,352
1125906,26,0,26,15,12,4,31,127,16,174
1125907,0,6,6,62,26,3,91,212,47,350
1125908,7,0,7,49,24,3,76,170,11,257
1125909,3,0,3,60,30,3,93,212,19,324
1125910,0,0,0,69,15,3,87,148,5,240
1125911,0,0,0,42,18,0,60,87,13,160
1125912,0,0,0,25,9,6,40,78,22,140
1125913,9,0,9,36,14,3,53,173,22,248
1125914,9,3,12,28,18,6,52,98,16,166
1125915,4,0,4,33,12,0,45,113,14,172
1125916,4,0,4,32,10,3,45,97,11,153
1125917,6,0,9,32,31,0,63,122,26,211
1125918,0,0,0,33,12,3,48,86,27,161
1125919,9,0,9,43,18,6,67,147,20,234
1125920,0,0,0,0,0,0,0,0,0,0
1125921,3,0,3,29,21,0,50,108,28,186
1125922,6,0,6,60,35,3,98,204,27,329
1126001,9,0,9,60,27,9,96,272,21,389
1126002,17,6,23,68,20,0,88,263,48,399
1126003,3,3,6,55,14,6,75,137,26,238
1126004,6,3,9,25,9,0,34,153,10,197
1126005,0,0,0,31,16,0,47,116,135,298
1126006,0,0,0,40,17,0,57,106,6,169
1126007,0,3,3,38,17,0,55,161,32,248
1126008,0,0,0,6,0,0,6,6,0,12
1126009,7,0,7,38,15,0,53,137,9,199
1126010,0,0,0,6,0,0,6,0,0,6
1126011,0,0,0,3,0,0,3,15,0,18
1126012,0,4,4,50,3,0,53,204,17,274
1126013,0,0,0,37,16,4,57,120,6,183
1126014,22,0,22,19,0,4,23,99,3,125
1126101,9,0,9,52,28,0,80,194,21,295
1126102,3,0,3,73,22,6,101,234,21,356
1126103,3,6,9,72,32,0,104,233,33,370
1126104,9,0,9,58,18,4,80,190,32,302
1126105,3,3,6,77,24,3,104,189,46,339
1126106,6,0,6,65,19,3,87,171,14,272
1126107,5,0,5,36,12,0,48,122,6,176
1126108,3,0,3,75,12,0,87,177,33,297
1126109,3,6,9,28,9,6,43,109,23,175
1126110,10,3,13,40,29,3,72,175,27,274
1126111,0,0,0,69,34,3,106,184,21,311
1126112,5,4,9,71,30,6,107,222,29,358
1126113,6,3,12,70,13,0,83,219,24,326
1126114,28,6,34,29,21,9,59,198,24,281
1126115,6,0,6,73,20,6,99,182,26,307
1126116,0,0,0,47,20,3,70,99,13,182
1126117,47,7,54,16,10,3,29,168,18,215
1126118,4,0,4,19,10,0,29,93,9,131
1126119,0,0,0,0,0,0,0,8,0,8
1126120,0,0,0,9,6,3,18,22,0,40
1126201,11,3,14,28,9,3,40,190,18,248
1126202,3,0,3,17,12,0,29,144,0,173
1126203,0,0,0,56,33,0,89,219,15,323
1126204,0,0,0,19,20,0,39,128,5,172
1126205,3,6,9,57,22,3,82,175,27,284
1126206,0,3,3,69,13,0,82,115,12,209
1126207,0,3,6,33,9,0,42,72,13,127
1126208,5,0,5,53,11,0,64,127,15,206
1126209,0,0,0,16,6,0,22,77,12,111
1126210,0,0,0,37,12,3,52,118,3,173
1126211,0,0,0,50,33,3,86,135,6,227
1126212,4,0,4,86,26,0,112,205,19,336
1126213,3,0,3,42,10,0,52,118,10,180
1126214,11,0,11,68,26,9,103,217,29,349
1126215,9,4,13,49,15,3,67,245,26,338
1126216,4,0,4,53,18,0,71,169,21,261
1126301,0,3,3,90,34,8,132,215,45,392
1126302,76,4,80,49,30,6,85,390,32,507
1126303,7,0,7,34,16,6,56,135,31,222
1126304,9,0,9,65,36,0,101,267,26,394
1126305,4,3,7,55,32,3,90,209,32,331
1126306,0,0,0,39,40,0,79,198,27,304
1126307,0,0,0,36,9,0,45,126,18,189
1126308,3,0,3,44,14,3,61,147,27,235
1126309,0,0,0,63,27,6,96,145,11,252
1126310,3,0,3,31,10,0,41,115,6,162
1126311,3,3,6,81,19,6,106,248,36,390
1126312,7,0,7,50,27,6,83,142,12,237
1126313,3,0,3,70,37,4,111,254,30,395
1126314,0,0,0,17,15,0,32,104,3,139
1126315,5,0,5,55,18,6,79,140,18,237
1126316,4,0,4,47,25,3,75,172,29,276
1126317,9,6,15,48,24,3,75,166,9,250
1126318,3,8,11,40,27,0,67,165,30,262
1126319,7,0,7,57,39,7,103,205,28,336
1126320,11,0,11,34,18,0,52,168,27,247
1126321,13,4,17,34,12,0,46,207,21,274
1126322,0,0,0,0,0,0,0,0,0,0
1126401,4,3,7,52,29,6,87,128,17,232
1126402,12,7,19,44,11,7,62,194,27,283
1126403,9,0,9,17,17,6,40,138,31,209
1126404,10,0,10,42,12,3,57,167,24,248
1126405,7,5,12,23,18,0,41,164,23,228
1126406,6,0,6,66,29,0,95,240,21,356
1126407,9,0,9,56,29,6,91,169,9,269
1126408,0,0,0,83,30,3,116,171,22,309
1126409,3,3,6,60,22,0,82,165,33,280
1126410,0,0,0,48,8,5,61,163,34,258
1126411,3,0,3,43,0,0,43,99,0,142
1126501,6,3,9,50,32,0,82,168,40,290
1126502,3,3,6,43,16,0,59,112,10,181
1126503,11,3,14,58,22,3,83,221,55,359
1126504,3,0,3,44,29,3,76,151,15,242
1126505,18,8,26,76,38,3,117,232,29,378
1126506,6,3,9,70,24,0,94,204,28,326
1126507,3,0,3,32,12,3,47,136,15,198
1126508,0,0,0,0,0,0,0,3,0,3
1126509,0,0,0,6,6,0,12,24,745,781
1126510,7,5,12,83,27,0,110,163,31,304
1126511,3,0,3,43,15,3,61,87,19,167
1126512,4,3,7,69,31,0,100,225,29,354
1126513,3,0,3,30,5,4,39,90,3,132
1126514,6,3,9,70,25,3,98,289,40,427
1126515,0,0,0,86,15,0,101,208,22,331
1126516,3,0,6,49,19,9,77,136,12,225
1126517,0,0,0,0,0,0,0,0,0,0
1126601,0,0,0,0,0,0,0,0,0,0
1126602,3,3,6,18,16,6,40,76,21,137
1126603,0,0,0,29,19,9,57,101,6,164
1126604,0,3,3,42,21,0,63,169,24,256
1126605,12,8,20,34,26,3,63,222,23,308
1126606,0,0,0,47,29,3,79,97,3,179
1126607,6,0,6,57,35,3,95,206,19,320
1126608,4,0,4,36,33,3,72,192,18,282
1126609,5,4,9,44,27,0,71,164,12,247
1126610,3,0,6,18,17,0,35,118,14,167
1126611,13,5,18,17,9,0,26,141,17,184
1126612,7,3,10,60,21,3,84,217,24,325
1126613,8,0,8,44,21,0,65,178,5,248
1126614,6,3,9,37,16,0,53,171,21,245
1126615,48,3,51,54,5,4,63,220,30,313
1126616,3,0,3,57,26,0,83,124,15,222
1126617,6,0,6,64,16,0,80,105,7,192
1126618,0,0,0,66,27,0,93,165,17,275
1126619,4,0,4,70,31,8,109,171,25,305
1126620,8,0,8,36,14,7,57,226,17,300
1126621,3,0,3,36,16,0,52,98,21,171
1126622,10,0,10,38,8,3,49,148,23,220
1126701,3,0,3,51,19,6,76,141,14,231
1126702,7,3,10,46,26,6,78,174,24,276
1126703,3,0,3,54,28,0,82,188,21,291
1126704,0,0,0,58,25,0,83,144,12,239
1126705,3,0,3,26,16,0,42,162,6,210
1126706,0,0,0,0,0,0,0,0,0,0
1126707,6,0,6,57,38,0,95,163,25,283
1126708,6,0,6,69,29,0,98,214,24,336
1126709,0,3,3,91,34,8,133,220,30,383
1126710,6,3,9,50,26,9,85,178,15,278
1126711,10,0,10,69,35,4,108,241,9,358
1126712,0,0,0,61,33,3,97,200,15,312
1126713,3,3,6,37,27,3,67,129,28,224
1126714,5,0,5,94,36,6,136,202,14,352
1126715,0,0,0,68,43,3,114,183,3,300
1126716,0,0,0,32,21,0,53,169,6,228
1126717,9,0,9,71,29,9,109,243,25,377
1126718,0,6,6,87,27,3,117,202,26,345
1126719,6,0,6,85,25,3,113,183,9,305
1126720,3,0,3,60,18,3,81,104,10,195
1126721,3,3,6,58,51,0,109,266,15,390
1126722,8,0,8,57,24,3,84,152,12,248
1126723,6,3,9,64,12,4,80,254,33,367
1126724,5,0,5,47,27,3,77,122,7,206
1126725,0,0,0,94,46,6,146,263,11,420
1126726,3,0,3,20,24,3,47,169,15,231
1126727,0,4,4,71,27,4,102,297,33,432
1126728,4,0,4,47,19,7,73,158,11,242
1126729,0,0,0,55,24,0,79,228,21,328
1126730,3,0,3,32,16,0,48,115,7,170
1126731,7,0,7,66,32,0,98,167,7,272
1126732,5,0,5,67,42,3,112,215,21,348
1126733,4,0,4,55,33,3,91,186,13,290
1126734,3,0,3,45,22,0,67,154,16,237
1126735,4,0,4,36,16,6,58,104,6,168
1126736,58,0,58,63,33,3,99,291,12,402
1126737,3,0,3,70,22,8,100,227,21,348
1126738,0,0,0,88,9,6,103,115,4,222
1126739,0,0,0,147,33,12,192,226,7,425
1126740,0,0,0,39,22,0,61,136,7,204
1126741,4,3,7,98,29,0,127,230,30,387
1126742,3,0,3,33,18,0,51,134,15,200
1126743,6,0,6,59,31,3,93,315,10,418
1126801,3,0,3,87,27,0,114,176,11,301
1126802,0,0,0,54,17,0,71,154,6,231
1126803,3,0,3,47,6,0,53,169,9,231
1126804,3,0,3,67,16,0,83,168,15,266
1126805,44,5,49,40,13,7,60,254,33,347
1126806,0,0,0,43,0,0,43,45,3,91
1126807,4,0,4,16,3,0,19,69,7,95
1126808,0,0,0,3,28,0,31,500,31,562
1126809,7,0,7,100,37,6,143,268,33,444
1126810,0,0,0,27,8,0,35,99,3,137
1126811,0,0,0,6,3,0,9,9,3,21
1126812,3,0,3,18,12,6,36,105,10,151
1126901,0,0,0,188,37,8,233,241,29,503
1126902,3,0,6,116,27,7,150,224,6,380
1126903,4,0,4,72,32,3,107,199,21,327
1126904,0,0,0,73,23,0,96,197,4,297
1126905,4,0,4,242,56,18,316,341,12,669
1126906,0,0,0,144,36,3,183,165,11,359
1126907,0,0,0,58,9,3,70,70,24,164
1126908,0,0,0,0,0,0,0,3,0,3
1126909,0,0,0,0,0,0,0,0,3,3
1126910,3,0,3,119,24,3,146,275,17,438
1126911,3,0,3,73,25,3,101,217,19,337
1126912,3,0,3,93,33,14,140,200,13,353
1126913,8,0,8,47,30,0,77,245,14,336
1126914,3,0,3,37,20,3,60,152,39,251
1126915,4,6,10,57,15,0,72,216,43,331
1126916,0,0,0,76,21,7,104,173,0,277
1126917,3,0,3,57,27,3,87,174,24,285
1126918,3,0,3,195,46,5,246,295,18,559
1126919,0,4,4,222,20,3,245,371,24,640
1126920,6,0,6,69,36,3,108,274,33,415
1126921,10,3,13,42,31,9,82,246,19,347
1126922,8,3,11,77,33,5,115,265,33,413
1126923,6,3,9,64,30,0,94,215,10,319
1126924,133,7,140,60,17,3,80,336,35,451
1126925,10,6,16,44,15,0,59,114,18,191
1126926,0,0,0,38,20,3,61,129,15,205
1126927,8,3,11,65,32,7,104,238,27,369
1126928,8,0,8,52,35,6,93,288,42,423
1126929,6,0,6,51,37,3,91,249,17,357
1126930,4,0,4,45,31,0,76,191,6,273
1126931,3,0,3,49,27,3,79,168,14,261
1126932,6,0,6,71,37,0,108,202,13,323
1126933,68,9,77,33,21,6,60,242,26,328
1126934,8,0,8,94,28,7,129,195,16,340
1126935,0,0,0,106,35,3,144,243,19,406
1126936,0,0,0,62,16,5,83,139,18,240
1126937,3,0,3,38,12,3,53,126,20,199
1126938,9,0,12,47,27,3,77,206,24,307
1126939,9,0,9,48,22,0,70,275,35,380
1126940,5,0,5,35,23,3,61,251,24,336
1126941,0,0,0,54,20,0,74,170,9,253
1126942,8,0,8,41,34,0,75,212,19,306
1126943,6,3,9,43,15,0,58,120,7,185
1126944,6,6,12,94,23,7,124,246,18,388
1126945,0,4,4,81,26,6,113,240,10,363
1126946,9,5,14,57,15,3,75,187,24,286
1126947,11,0,11,68,21,3,92,154,14,260
1126948,7,3,10,72,31,4,107,203,15,325
1126949,4,0,4,60,9,0,69,163,17,249
1127001,3,0,3,46,33,3,82,179,24,285
1127002,0,0,0,19,7,0,26,44,4,74
1127003,0,3,3,59,19,3,81,147,24,252
1127004,0,0,0,48,20,0,68,170,27,265
1127005,0,0,0,69,27,0,96,158,33,287
1127006,4,0,4,32,21,6,59,130,29,218
1127007,0,3,3,68,29,0,97,214,40,351
1127008,29,14,43,40,13,6,59,158,34,251
1127009,3,3,6,57,25,6,88,273,46,407
1127010,7,0,7,77,20,0,97,214,24,335
1127011,8,6,14,40,25,0,65,263,35,363
1127012,7,0,7,52,22,4,78,266,24,368
1127013,14,5,19,58,28,0,86,326,32,444
1127014,8,3,11,62,19,0,81,198,27,306
1127015,12,0,12,45,6,3,54,167,19,240
1127016,0,0,0,65,16,4,85,120,16,221
1127017,8,3,11,42,12,0,54,158,27,239
1127018,32,7,39,45,18,3,66,209,19,294
1127019,13,3,16,72,26,0,98,235,26,359
1127020,0,0,0,53,6,3,62,202,3,267
1127021,7,0,7,102,46,9,157,254,6,417
1127022,7,0,7,69,34,3,106,241,24,371
1127023,7,0,7,31,27,0,58,232,28,318
1127024,10,0,10,30,27,3,60,207,21,288
1127025,4,5,9,28,35,0,63,340,34,437
1127026,8,0,8,43,25,3,71,180,15,266
1127027,5,0,5,36,15,0,51,206,10,267
1127028,16,9,25,25,27,0,52,269,27,348
1127029,6,3,9,49,25,0,74,254,22,350
1127030,0,0,0,0,0,0,0,0,0,0
1127031,13,3,19,25,38,0,63,290,46,399
1127032,8,4,12,34,33,3,70,304,47,421
1127101,0,0,0,21,25,6,52,100,5,157
1127102,0,0,0,0,0,0,0,3,0,3
1127103,15,0,15,30,17,3,50,127,3,180
1127104,0,0,0,90,6,7,103,93,3,199
1127105,0,0,0,37,10,0,47,40,3,90
1127106,35,6,41,63,23,0,86,286,24,396
1127107,14,3,17,35,25,6,66,173,30,269
1127108,6,0,6,50,24,3,77,138,3,218
1127109,0,0,0,57,22,0,79,150,4,233
1127110,0,0,0,57,8,4,69,135,22,226
1127111,5,7,12,51,40,3,94,227,20,341
1127112,0,0,0,75,16,9,100,158,18,276
1127113,4,0,4,34,24,3,61,69,12,142
1127114,0,0,0,35,23,3,61,117,9,187
1127115,0,0,0,116,40,9,165,288,24,477
1127116,3,0,3,96,28,3,127,211,43,381
1127117,0,0,0,45,18,0,63,122,9,194
1127118,3,0,3,32,8,0,40,145,3,188
1127119,0,0,0,55,12,0,67,133,12,212
1127120,0,0,0,31,9,3,43,99,18,160
1127121,0,0,0,46,16,0,62,108,0,170
1127122,0,0,0,105,21,0,126,200,19,345
1127123,3,0,3,90,25,6,121,190,9,320
1127124,6,0,6,63,18,0,81,183,23,287
1127125,5,0,5,34,35,3,72,143,15,230
1127126,8,3,11,61,24,3,88,174,30,292
1127127,40,6,46,77,33,6,116,284,33,433
1127128,3,0,3,75,19,7,101,176,24,301
1127129,0,0,0,116,38,0,154,227,15,396
1127130,5,3,8,55,22,0,77,229,20,326
1127131,7,0,7,26,18,6,50,112,21,183
1127132,3,0,3,71,13,6,90,127,13,230
1127133,6,0,6,12,6,0,18,510,22,550
1127134,0,0,0,3,4,0,7,12,3,22
1127135,0,0,0,60,22,0,82,192,11,285
1127136,3,0,3,130,21,3,154,250,24,428
1127137,3,3,6,91,24,7,122,248,22,392
1127138,3,0,3,95,22,4,121,205,18,344
1127139,11,0,11,51,30,7,88,188,17,293
1127140,0,3,3,29,18,0,47,122,14,183
1127141,3,3,6,55,21,6,82,96,47,225
1127142,4,0,4,31,6,0,37,86,6,129
1127201,3,0,3,46,27,4,77,225,18,320
1127202,14,3,17,92,50,3,145,307,15,467
1127203,16,3,19,53,22,3,78,213,30,321
1127204,38,3,41,43,30,3,76,232,18,326
1127205,4,0,4,41,17,12,70,148,24,242
1127206,3,0,3,47,18,0,65,124,18,207
1127207,0,0,0,50,44,3,97,269,24,390
1127208,6,0,6,20,4,0,24,142,8,174
1127209,3,0,3,58,35,6,99,232,24,355
1127210,6,0,6,40,15,0,55,174,8,237
1127211,4,0,4,48,28,3,79,144,11,234
1127212,32,0,32,20,23,3,46,211,16,273
1127213,7,0,7,56,30,0,86,209,16,311
1127214,0,0,0,32,22,7,61,128,12,201
1127215,0,0,0,36,18,0,54,167,18,239
1127216,0,0,0,17,19,0,36,96,37,169
1127217,13,7,20,72,31,3,106,298,33,437
1127218,0,3,3,35,15,0,50,129,19,198
1127219,9,7,16,9,11,0,20,245,48,313
1127220,6,3,9,46,27,0,73,173,15,261
1127221,8,0,8,31,9,0,40,151,22,213
1127222,7,0,7,69,32,3,104,268,23,395
1127223,15,3,18,54,29,4,87,232,20,339
1127224,9,4,13,39,16,0,55,295,62,412
1127301,0,0,0,12,6,0,18,44,3,65
1127302,7,6,16,51,30,0,81,239,32,352
1127303,4,6,10,41,24,0,65,173,42,280
1127304,0,0,4,37,11,6,54,156,11,221
1127305,0,0,0,73,15,4,92,232,24,348
1127306,3,3,6,67,25,0,92,209,19,320
1127307,6,0,6,74,14,6,94,241,51,386
1127308,5,0,5,86,25,3,114,219,55,388
1127309,3,0,3,12,9,0,21,78,9,108
1127310,11,0,11,43,17,0,60,193,26,279
1127311,0,0,0,0,0,0,0,0,0,0
1127312,0,0,0,0,6,3,9,74,10,93
1127401,3,0,3,33,6,0,39,165,20,224
1127402,0,0,0,6,18,0,24,49,6,79
1127403,19,0,19,22,15,0,37,216,33,286
1127404,5,0,5,43,24,0,67,178,9,254
1127405,6,3,9,25,19,3,47,139,21,207
1127406,9,0,9,35,15,3,53,209,24,286
1127407,9,4,13,40,17,0,57,225,21,303
1127408,3,3,6,55,30,7,92,287,42,421
1127409,8,0,8,16,16,3,35,146,24,205
1127410,6,6,12,25,18,0,43,188,21,252
1127411,4,3,7,52,16,0,68,217,44,329
1127412,9,0,9,27,25,3,55,188,29,272
1127413,7,0,7,34,21,0,55,185,16,256
1127414,3,0,3,43,21,0,64,138,15,217
1127415,25,0,25,0,0,0,0,41,0,41
1127416,50,9,59,71,40,6,117,375,37,529
1127501,0,0,0,0,0,0,0,21,12,33
1127601,12,0,12,24,15,0,39,187,25,251
1127602,9,6,15,52,30,6,88,299,20,407
1127603,16,3,19,47,18,6,71,279,37,387
1127604,6,6,12,31,26,6,63,191,35,289
1127605,11,10,21,30,17,0,47,214,91,352
1127606,6,3,9,64,27,4,95,218,33,346
1127607,10,4,14,51,33,0,84,261,56,401
1127608,6,0,6,42,21,0,63,178,35,276
1127609,6,0,6,68,26,3,97,204,14,315
1127610,5,0,5,44,19,6,69,163,13,245
1127701,7,6,13,59,37,0,96,256,24,376
1127702,10,0,10,35,16,0,51,260,30,341
1127703,8,0,8,50,25,3,78,273,37,388
1127704,3,0,3,31,15,3,49,144,12,205
1127705,16,4,20,31,24,0,55,259,27,341
1127706,0,0,0,32,11,0,43,106,20,169
1127707,3,3,6,33,17,0,50,129,31,210
1127708,0,0,0,55,28,3,86,194,15,295
1127709,0,3,3,31,24,0,55,187,12,254
1127710,3,0,3,45,24,3,72,199,18,289
1127711,5,0,5,101,34,3,138,191,12,341
1127712,5,3,8,65,31,0,96,271,18,385
1127713,5,0,5,29,21,0,50,163,25,238
1127714,9,0,9,44,18,0,62,228,32,322
1127715,0,0,0,61,21,0,82,163,6,251
1127716,6,0,6,56,19,3,78,138,18,234
1127717,0,0,0,107,33,4,144,192,26,362
1127718,3,0,3,78,17,12,107,168,8,283
1127719,4,4,8,51,29,0,80,192,29,301
1127720,3,0,3,47,17,6,70,170,18,258
1127721,0,0,0,92,22,0,114,176,15,305
1127722,4,0,4,52,19,9,80,140,22,242
1127723,16,6,22,46,37,3,86,275,42,403
1127724,6,0,6,36,20,0,56,132,0,188
1127725,3,3,6,67,39,5,111,279,17,407
1127726,3,0,3,54,23,8,85,190,13,288
1127727,0,0,0,121,39,11,171,242,16,429
1127728,12,0,12,62,52,3,117,265,9,391
1127729,8,0,8,46,27,3,76,184,7,267
1127730,6,3,9,96,30,6,132,224,18,374
1127731,3,0,3,57,18,0,75,166,40,281
1127732,8,3,11,84,44,5,133,299,21,453
1127733,6,0,6,94,27,9,130,264,23,417
1127734,3,0,3,52,29,0,81,184,21,286
1127735,8,0,8,62,25,3,90,179,9,278
1127736,3,0,3,30,18,0,48,125,9,182
1127737,86,6,92,78,34,0,112,340,24,476
1127738,3,3,6,43,21,0,64,122,18,204
1127739,11,0,11,59,26,6,91,192,18,301
1127740,3,0,3,0,0,0,0,3,0,3
1127741,0,0,0,44,31,6,81,158,31,270
1127801,0,0,0,107,20,3,130,189,20,339
1127802,3,0,3,69,15,11,95,130,22,247
1127803,3,0,3,97,40,4,141,295,18,454
1127804,6,0,6,33,15,0,48,97,12,157
1127805,0,0,0,10,0,0,10,117,106,233
1127806,0,0,0,12,4,3,19,53,3,75
1127807,0,0,0,57,23,0,80,144,461,685
1127808,84,22,106,10,0,0,10,198,47,255
1127809,6,7,13,38,27,6,71,172,29,272
1127810,0,0,0,52,15,0,67,132,43,242
1127811,0,3,3,50,21,3,74,168,102,344
1127812,0,3,3,64,22,3,89,192,73,354
1127813,3,3,6,78,36,7,121,211,34,366
1127814,27,3,30,135,63,10,208,514,40,762
1127815,10,6,19,67,43,0,110,301,83,494
1127816,28,37,65,60,24,0,84,254,95,433
1127817,11,4,15,47,19,3,69,163,43,275
1127818,6,0,6,54,21,0,75,158,45,278
1127819,4,3,7,34,17,3,54,178,67,299
1127820,3,0,3,75,12,4,91,167,12,270
1127821,30,0,30,39,29,0,68,266,38,372
1127822,0,0,0,75,38,4,117,232,15,364
1127823,0,5,5,25,31,0,56,133,11,200
1127824,0,0,0,10,6,3,19,39,3,61
1127825,3,3,6,67,24,6,97,165,18,280
1127826,0,0,0,159,39,4,202,221,24,447
1127827,0,0,0,72,13,0,85,119,18,222
1127828,0,0,0,93,24,9,126,184,41,351
1127829,6,3,9,102,19,3,124,169,24,317
1127830,9,0,9,30,31,0,61,176,37,274
1127831,3,0,3,32,18,3,53,106,21,180
1127832,4,0,4,87,17,3,107,197,29,333
1127833,13,0,13,37,19,0,56,196,24,276
1127834,5,0,5,31,22,3,56,175,23,254
1127835,8,0,8,59,27,0,86,236,34,356
1127836,6,4,10,51,17,5,73,147,24,244
1127837,4,0,4,40,16,0,56,141,15,212
1127838,3,3,6,35,14,9,58,100,12,170
1127839,0,0,0,74,32,4,110,244,21,375
1127840,0,0,0,68,36,3,107,321,88,516
1127841,8,3,11,48,20,3,71,186,28,285
1127842,6,0,6,41,16,6,63,208,37,308
1127843,0,0,0,54,27,0,81,160,16,257
1127844,6,0,6,59,19,0,78,168,18,264
1127845,0,0,0,62,33,12,107,160,18,285
1127846,0,0,0,91,18,8,117,185,33,335
1127901,0,0,0,0,0,0,0,0,0,0
1127902,0,0,0,0,0,0,0,0,0,0
1127903,0,0,0,0,0,0,0,0,0,0
1127904,21,4,25,75,35,8,118,347,39,504
1127905,5,0,5,73,10,8,91,160,25,276
1127906,0,0,0,23,19,0,42,131,19,192
1127907,3,0,3,45,25,0,70,142,10,222
1127908,5,0,5,68,24,5,97,190,14,301
1127909,62,0,62,29,28,3,60,268,17,345
1127910,3,0,3,56,31,0,87,194,22,303
1127911,9,0,9,124,32,9,165,270,32,467
1127912,0,0,0,30,12,4,46,170,16,232
1127913,0,4,4,76,17,3,96,152,24,272
1127914,5,0,5,33,12,0,45,123,12,180
1127915,3,3,6,61,16,3,80,235,35,350
1127916,7,3,10,93,30,0,123,223,23,369
1127917,5,0,5,60,12,9,81,159,14,254
1127918,6,0,9,33,9,0,42,143,10,195
1127919,0,0,0,26,12,0,38,98,12,148
1127920,66,21,87,4,3,0,7,263,64,334
1127921,6,0,6,51,29,0,80,187,38,305
1127922,3,3,6,72,29,3,104,248,21,373
1127923,3,3,6,68,33,3,104,320,27,451
1127924,3,0,3,19,12,0,31,63,15,109
1127925,0,6,6,36,23,3,62,148,36,246
1127926,7,3,10,22,17,6,45,145,18,208
1127927,9,0,9,66,25,6,97,257,27,381
1127928,11,0,11,52,10,0,62,223,29,314
1127929,8,4,12,45,27,0,72,215,40,327
1127930,11,0,11,40,18,3,61,192,27,280
1127931,3,0,3,54,23,0,77,221,25,323
1127932,6,8,14,35,12,0,47,208,47,302
1127933,10,0,10,33,12,3,48,202,22,272
1127934,6,0,6,77,36,3,116,266,35,417
1127935,0,0,0,38,0,6,44,125,17,186
1127936,0,0,0,91,44,0,135,226,37,398
1127937,6,0,6,74,29,9,112,206,30,348
1127938,0,0,0,0,0,0,0,0,0,0
1128001,11,0,11,13,9,3,25,127,11,163
1128002,7,7,14,29,7,0,36,138,28,202
1128003,75,6,81,39,26,0,65,359,42,466
1128004,9,3,12,37,14,0,51,211,22,284
1128005,0,0,0,39,25,6,70,231,21,322
1128006,7,3,10,29,9,0,38,280,34,352
1128007,0,0,0,0,0,0,0,3,0,3
1128008,7,0,7,39,22,3,64,171,15,250
1128009,10,4,14,30,23,7,60,187,20,267
1128010,9,6,15,21,15,6,42,208,28,278
1128011,9,3,12,19,12,0,31,207,26,264
1128012,13,3,16,12,25,0,37,246,29,312
1128013,12,5,17,24,14,0,38,209,5,252
1128014,6,0,6,27,11,4,42,161,17,220
1128101,0,0,0,41,21,0,62,181,5,248
1128102,3,0,3,48,19,6,73,163,18,254
1128103,0,0,0,77,19,3,99,208,31,338
1128104,3,0,3,68,25,4,97,206,32,335
1128105,4,3,7,59,19,0,78,169,15,262
1128106,9,0,9,28,13,0,41,154,15,210
1128107,0,0,0,44,15,0,59,158,23,240
1128108,0,3,3,52,21,0,73,166,34,273
1128109,3,0,3,50,19,3,72,151,3,226
1128110,3,0,3,69,33,3,105,209,12,326
1128201,0,0,0,0,0,0,0,0,0,0
1128202,11,8,19,39,18,0,57,236,46,339
1128203,7,0,7,113,36,6,155,304,20,479
1128204,10,0,10,92,25,3,120,303,10,433
1128205,15,3,18,44,15,3,62,267,47,376
1128206,3,3,6,55,12,3,70,177,9,256
1128207,11,0,11,23,26,6,55,139,13,207
1128208,6,0,6,39,21,0,60,219,22,301
1128209,11,0,11,27,25,0,52,176,19,247
1128210,13,3,16,51,28,0,79,211,24,314
1128211,7,3,13,45,12,0,57,210,24,291
1128212,3,0,3,66,20,0,86,259,21,366
1128213,12,0,12,31,14,3,48,116,13,177
1128214,15,0,15,44,16,3,63,219,18,300
1128215,8,0,8,73,28,0,101,231,15,347
1128216,0,0,0,28,15,6,49,125,33,207
1128217,5,0,5,61,19,6,86,167,18,271
1128218,3,0,3,35,26,0,61,117,14,192
1128219,11,0,11,39,21,6,66,306,56,428
1128220,8,0,8,24,19,0,43,200,19,262
1128221,6,0,6,64,38,0,102,239,27,368
1128222,7,0,7,54,9,0,63,182,29,274
1128223,10,7,17,48,9,3,60,229,25,314
1128224,8,0,8,60,24,0,84,223,26,333
1128225,58,43,101,25,18,0,43,199,92,334
1128226,7,6,13,61,26,0,87,228,45,360
1128227,10,0,10,66,19,4,89,259,27,375
1128228,7,0,7,65,14,4,83,216,17,316
1128229,10,3,13,55,27,0,82,262,16,360
1128230,18,5,23,40,23,6,69,247,28,344
1128231,14,3,17,61,22,3,86,295,32,413
1128232,4,6,10,32,24,0,56,157,18,231
1128233,6,0,6,52,20,0,72,202,11,285
1128234,9,0,9,30,23,3,56,162,18,236
1128235,16,8,24,59,23,6,88,277,34,399
1128236,6,0,6,27,9,0,36,171,14,221
1128237,4,0,4,67,25,3,95,222,26,343
1128238,10,8,18,22,12,0,34,227,24,285
1128239,9,0,9,28,13,6,47,142,30,219
1128301,3,3,6,23,10,0,33,126,6,165
1128302,0,0,0,44,23,0,67,245,24,336
1128303,0,0,0,40,9,0,49,139,18,206
1128304,6,0,6,61,18,3,82,222,32,336
1128305,8,0,8,105,36,0,141,316,17,474
1128306,10,6,16,55,19,4,78,176,25,279
1128307,8,4,12,30,29,0,59,280,11,350
1128308,0,0,0,23,25,3,51,121,13,185
1128309,6,0,6,49,38,0,87,163,16,266
1128310,0,0,0,26,14,6,46,105,9,160
1128311,0,0,0,0,0,0,0,0,0,0
1128312,0,0,0,6,3,0,9,6,6,21
1128313,3,0,3,51,9,3,63,135,12,210
1128314,9,3,12,54,23,0,77,245,20,342
1128315,0,0,0,22,12,4,38,132,6,176
1128316,5,3,8,16,17,0,33,137,15,185
1128317,0,0,0,36,19,4,59,140,11,210
1128401,15,4,19,43,30,6,79,183,27,289
1128402,21,0,21,50,23,3,76,178,15,269
1128403,0,0,0,52,24,3,79,150,15,244
1128404,0,0,0,80,21,4,105,177,19,301
1128405,14,0,14,67,47,6,120,301,39,460
1128406,8,0,8,82,17,7,106,162,9,277
1128407,6,3,9,79,24,11,114,219,19,352
1128408,9,3,12,54,25,3,82,175,12,269
1128409,8,0,8,141,40,3,184,288,23,495
1128410,3,0,3,17,11,4,32,103,3,138
1128411,6,0,6,96,26,4,126,182,21,329
1128412,6,0,6,48,23,3,74,189,13,276
1128413,58,5,63,49,35,0,84,300,29,413
1128414,12,50,62,16,13,0,29,179,86,294
1128415,3,0,3,46,22,3,71,239,16,326
1128416,6,3,9,79,17,0,96,210,20,326
1128417,17,3,20,42,8,3,53,186,17,256
1128418,6,3,9,62,25,5,92,216,23,331
1128419,15,5,20,49,21,0,70,215,25,310
1128420,0,0,0,47,33,0,80,170,14,264
1128421,5,0,5,47,20,0,67,227,18,312
1128422,15,8,23,73,57,0,130,366,28,524
1128423,8,0,8,42,24,0,66,209,9,284
1128424,95,5,100,36,15,3,54,335,16,405
1128425,3,0,7,43,33,0,76,190,14,280
1128426,7,0,7,78,37,5,120,305,24,449
1128427,33,3,36,34,22,3,59,202,27,288
1128428,3,3,9,64,30,3,97,180,24,301
1128429,0,0,0,17,6,0,23,65,6,94
1128430,17,4,21,90,27,0,117,329,35,481
1128431,51,6,57,32,28,0,60,336,27,423
1128501,0,0,0,59,18,0,77,171,4,252
1128502,3,0,3,73,19,4,96,174,9,279
1128503,3,0,3,47,6,6,59,100,21,180
1128504,0,0,0,73,10,6,89,154,38,281
1128505,0,6,6,98,25,3,126,193,33,352
1128506,0,0,0,108,37,9,154,256,36,446
1128507,4,0,4,86,34,6,126,172,19,317
1128508,0,0,0,57,22,6,85,141,12,238
1128509,0,0,0,79,18,9,106,157,19,282
1128510,0,0,0,72,27,6,105,161,12,278
1128511,3,0,3,71,21,3,95,136,15,246
1128512,0,0,0,33,12,4,49,80,4,133
1128513,3,3,6,129,27,6,162,250,34,446
1128514,0,0,0,55,18,0,73,132,12,217
1128515,6,0,6,61,19,0,80,173,16,269
1128516,0,0,0,0,5,0,5,29,3,37
1128601,7,0,7,52,20,0,72,218,23,313
1128602,0,0,0,0,0,0,0,0,0,0
1128603,0,3,3,48,33,0,81,156,25,262
1128604,8,3,11,64,20,6,90,227,13,330
1128605,4,0,4,62,23,0,85,188,14,287
1128606,0,3,3,63,24,3,90,208,27,325
1128607,30,4,34,62,30,3,95,307,55,457
1128608,0,0,0,26,11,0,37,156,22,215
1128609,6,3,9,46,27,4,77,160,27,264
1128610,11,9,20,56,32,3,91,278,29,398
1128611,3,0,3,51,40,3,94,212,21,327
1128612,0,0,0,0,0,0,0,0,0,0
1128613,7,3,10,76,29,6,111,242,23,376
1128614,16,4,20,53,48,6,107,381,36,524
1128615,10,0,10,94,34,0,128,283,29,440
1128616,9,32,41,30,21,0,51,125,72,248
1128617,0,0,0,54,13,0,67,124,18,209
1128618,0,0,0,47,19,0,66,127,8,201
1128619,8,4,12,79,27,0,106,231,41,378
1128620,0,0,0,88,36,0,124,236,18,378
1128621,0,0,0,33,17,0,50,109,17,176
1128622,0,0,0,55,29,3,87,148,11,246
1128623,6,0,6,41,20,0,61,123,12,196
1128701,9,0,9,54,33,3,90,195,18,303
1128702,6,0,6,69,25,0,94,196,12,302
1128703,4,3,7,91,33,12,136,327,21,484
1128704,14,0,14,111,20,7,138,339,27,504
1128705,3,0,3,83,28,6,117,162,35,314
1128706,4,0,4,40,27,0,67,126,15,208
1128707,3,7,10,60,30,11,101,232,7,340
1128708,4,3,7,71,32,3,106,242,35,383
1128709,6,0,6,54,22,3,79,217,18,314
1128710,0,0,0,58,10,4,72,206,21,299
1128711,3,0,3,32,20,0,52,161,33,246
1128712,5,3,8,20,7,0,27,106,15,148
1128713,0,0,0,38,8,0,46,114,21,181
1128714,7,0,7,151,60,13,224,351,28,603
1128715,0,0,0,14,6,0,20,29,0,49
1128716,89,5,94,62,24,0,86,324,18,428
1128717,16,4,20,41,14,3,58,259,26,343
1128718,4,0,4,46,22,0,68,188,10,266
1128719,0,0,0,61,18,3,82,157,4,243
1128720,0,3,3,30,12,0,42,95,73,210
1128721,4,0,4,118,46,0,164,212,22,398
1128722,0,0,0,0,0,0,0,0,0,0
1128723,3,6,9,55,23,0,78,193,9,280
1128724,6,0,6,41,16,0,57,129,9,195
1128725,0,0,0,19,9,0,28,70,3,101
1128726,0,0,0,3,3,0,6,12,3,21
1128801,0,0,0,23,12,3,38,82,9,129
1128802,0,0,0,42,18,3,63,124,15,202
1128803,0,0,0,49,20,0,69,98,7,174
1128804,6,0,6,34,30,0,64,184,20,268
1128805,3,0,3,46,25,3,74,167,20,261
1128806,0,0,0,41,20,8,69,124,9,202
1128807,6,0,6,61,40,3,104,319,19,442
1128808,3,0,3,22,27,0,49,100,3,152
1128809,0,0,0,41,16,0,57,134,12,203
1128810,0,0,0,6,0,0,6,3,0,9
1128811,3,3,6,29,14,0,43,110,15,168
1128812,5,0,5,170,27,9,206,259,32,497
1128901,8,3,11,77,41,6,124,362,26,512
1128902,3,0,3,63,28,3,94,167,30,291
1128903,4,3,7,87,44,3,134,267,36,437
1128904,3,6,9,91,40,3,134,210,32,376
1128905,0,0,0,21,10,3,34,80,6,120
1128906,0,0,0,58,29,8,95,199,16,310
1128907,4,0,4,44,16,3,63,139,12,214
1128908,3,0,3,34,12,0,46,108,3,157
1128909,7,0,7,36,19,0,55,192,8,255
1128910,0,3,3,32,17,6,55,150,3,208
1128911,0,0,0,19,6,3,28,90,9,127
1128912,3,3,6,21,18,0,39,78,6,123
1128913,3,0,3,36,28,3,67,191,13,271
1128914,54,3,57,58,22,10,90,284,15,389
1128915,4,0,4,50,9,3,62,156,12,230
1128916,4,0,4,47,24,0,71,262,26,359
1128917,8,0,8,47,18,6,71,190,24,285
1128918,6,0,6,51,30,3,84,130,13,227
1128919,3,0,3,22,7,3,32,130,16,178
1129001,7,0,7,117,34,0,151,230,22,403
1129002,0,0,0,125,34,4,163,359,35,557
1129003,6,0,6,101,23,0,124,271,23,418
1129004,9,0,9,97,34,0,131,268,26,425
1129005,3,0,3,140,29,0,169,306,22,497
1129006,3,0,3,84,31,7,122,149,21,292
1129007,0,0,0,70,21,3,94,122,8,224
1129008,10,0,10,101,47,9,157,312,9,478
1129009,0,0,0,92,30,3,125,202,12,339
1129010,0,0,0,102,50,0,152,220,0,372
1129011,0,0,0,78,18,9,105,152,4,261
1129012,3,0,3,95,36,6,137,236,4,377
1129013,6,0,6,125,34,0,159,260,6,425
1129014,6,0,6,121,12,4,137,215,12,364
1129015,0,0,0,85,21,3,109,211,13,333
1129016,6,3,9,132,55,7,194,229,19,442
1129017,6,0,6,63,24,3,90,118,11,219
1129018,0,3,3,124,34,3,161,216,27,404
1129019,0,3,3,59,34,6,99,158,9,266
1129020,6,3,9,62,40,0,102,219,18,339
1129021,3,0,3,102,25,4,131,252,21,404
1129022,8,0,8,80,29,0,109,211,15,335
1129023,3,0,3,80,18,3,101,162,0,263
1129024,3,3,6,107,35,0,142,245,16,403
1129025,3,0,3,55,31,0,86,113,0,199
1129026,6,0,6,116,26,12,154,273,5,432
1129027,7,3,10,61,35,0,96,175,6,277
1129028,3,3,6,122,28,6,156,210,32,398
1129029,7,0,7,103,46,4,153,248,12,413
1129030,3,0,3,71,29,0,100,155,0,255
1129031,3,0,3,103,26,0,129,275,16,420
1129032,125,7,132,93,34,6,133,430,24,587
1129033,7,0,7,146,51,5,202,305,29,536
1129034,0,0,0,49,18,4,71,86,9,166
1129035,8,0,8,100,30,4,134,251,21,406
1129036,4,0,4,68,25,4,97,232,12,341
1129037,4,0,4,151,31,0,182,329,21,532
1129038,3,0,3,62,12,0,74,149,27,250
1129039,0,0,0,31,15,4,50,120,0,170
1129040,12,0,12,83,44,6,133,228,14,375
1129041,7,0,7,66,15,3,84,150,14,248
1129042,6,0,6,101,40,3,144,207,21,372
1129043,6,3,12,130,31,3,164,258,23,445
1129044,3,0,3,68,22,4,94,106,9,209
1129045,5,0,5,93,60,10,163,287,10,460
1129046,3,0,3,46,7,0,53,92,12,157
1129047,4,0,4,51,18,3,72,128,9,209
1129101,0,0,0,55,31,0,86,183,34,303
1129102,0,0,0,60,17,3,80,222,10,312
1129103,0,0,0,67,42,0,109,313,28,450
1129104,0,0,0,63,40,3,106,204,15,325
1129105,0,3,3,73,26,0,99,272,12,383
1129106,0,0,0,64,30,0,94,220,16,330
1129107,0,0,0,38,9,0,47,158,7,212
1129108,0,0,0,84,30,3,117,258,9,384
1129109,3,0,3,90,27,0,117,255,12,384
1129110,3,0,3,93,30,3,126,268,15,409
1129111,3,0,6,103,37,6,146,264,15,425
1129112,4,0,4,63,19,0,82,206,18,306
1129113,3,0,3,49,24,6,79,116,6,201
1129114,3,0,3,81,36,3,120,164,15,299
1129115,0,0,0,73,39,0,112,216,13,341
1129116,3,0,3,127,58,5,190,238,8,436
1129117,0,0,0,54,18,0,72,190,6,268
1129118,0,0,0,81,33,0,114,183,12,309
1129119,0,0,0,106,36,3,145,189,4,338
1129120,3,0,3,82,16,3,101,219,7,327
1129121,0,0,0,76,40,0,116,226,11,353
1129122,0,0,0,54,23,0,77,124,6,207
1129123,0,0,0,58,22,4,84,218,9,311
1129124,0,0,0,43,20,0,63,171,12,246
1129125,13,3,16,13,30,0,43,224,27,294
1129126,3,0,3,220,47,0,267,507,33,807
1129127,0,6,6,0,0,0,0,3,9,12
1129128,3,0,3,88,27,0,115,312,15,442
1129129,4,0,4,83,28,8,119,340,10,469
1129130,3,0,3,40,14,0,54,102,3,159
1129131,0,0,0,77,18,12,107,159,5,271
1129132,0,0,0,50,15,3,68,97,6,171
1129133,3,3,6,87,43,6,136,223,9,368
1129134,0,0,0,44,7,6,57,132,9,198
1129135,0,0,0,47,21,3,71,183,0,254
1129136,0,3,3,35,18,3,56,123,6,185
1129137,0,0,0,80,26,0,106,247,9,362
1129138,0,0,0,0,0,0,0,0,0,0
1129139,3,0,3,54,32,4,90,230,0,320
1129140,0,0,0,111,25,3,139,214,3,356
1129141,3,0,3,62,21,6,89,184,15,288
1129142,6,0,6,101,44,3,148,231,6,385
1129143,5,0,5,106,34,5,145,405,9,559
1129144,0,0,0,87,31,0,118,226,17,361
1129145,0,0,0,112,31,3,146,197,22,365
1129146,3,0,3,72,22,0,94,212,9,315
1129147,0,0,0,0,0,0,0,3,3,6
1129201,3,3,6,55,19,0,74,132,24,230
1129202,6,0,6,73,31,3,107,292,13,412
1129203,0,0,0,61,27,4,92,217,12,321
1129204,0,3,3,61,31,3,95,287,21,403
1129205,3,0,3,60,11,4,75,156,5,236
1129206,0,6,6,71,33,3,107,267,25,399
1129207,3,3,6,52,31,0,83,162,17,262
1129208,0,0,0,37,28,4,69,139,13,221
1129209,7,0,7,80,23,6,109,179,18,306
1129210,0,0,0,91,52,0,143,255,15,413
1129211,25,11,36,42,22,0,64,237,35,336
1129212,6,0,6,78,52,0,130,234,35,399
1129213,0,0,0,100,42,3,145,311,11,467
1129214,0,0,0,0,0,0,0,0,0,0
1129215,0,0,0,49,23,3,75,149,0,224
1129216,4,0,4,56,29,3,88,106,0,194
1129217,5,0,5,121,29,8,158,280,9,447
1129218,0,4,4,103,32,9,144,330,14,488
1129219,3,0,3,103,41,3,147,294,29,470
1129220,0,0,0,92,23,0,115,226,18,359
1129221,0,0,0,104,25,4,133,186,9,328
1129222,3,0,3,53,20,3,76,207,3,286
1129223,3,0,3,50,21,4,75,180,7,262
1129224,3,0,3,61,15,3,79,179,6,264
1129225,6,0,6,163,36,0,199,270,12,481
1129226,3,0,3,39,14,0,53,115,8,176
1129227,5,0,5,105,33,0,138,293,12,443
1129228,0,0,0,98,35,8,141,278,4,423
1129229,0,0,0,50,10,0,60,135,15,210
1129230,6,0,6,105,35,3,143,312,27,482
1129231,3,0,3,82,23,0,105,306,8,419
1129232,0,0,0,29,17,0,46,133,18,197
1129233,3,0,3,66,39,3,108,221,9,338
1129234,6,0,6,59,27,3,89,223,13,325
1129235,6,3,9,78,28,0,106,203,9,318
1129236,0,0,0,76,20,4,100,209,6,315
1129237,6,0,6,91,36,6,133,290,31,454
1129238,0,0,3,76,45,6,127,258,12,397
1129239,3,0,3,66,50,3,119,245,13,377
1129240,3,6,9,76,30,6,112,220,19,351
1129241,10,3,13,121,32,0,153,382,23,558
1129242,10,0,10,112,42,6,160,235,31,426
1129243,0,0,0,0,0,0,0,12,0,12
1129244,4,0,4,49,38,3,90,175,16,281
1129245,5,0,5,97,40,7,144,249,16,409
1129246,9,6,15,104,46,0,150,300,24,474
1129247,0,0,0,71,15,7,93,220,15,328
1129248,7,3,10,104,33,0,137,395,26,558
1129249,3,3,6,93,45,0,138,380,48,566
1129250,6,0,6,88,25,3,116,218,15,349
1129251,4,0,4,118,44,0,162,330,37,529
1129252,0,0,0,0,0,0,0,0,0,0
1129253,6,0,6,61,47,3,111,174,15,300
1129254,3,0,3,67,24,4,95,186,3,284
1129255,0,0,3,32,30,0,62,168,11,241
1129256,4,3,7,31,17,3,51,196,16,263
1129257,0,0,0,82,17,0,99,258,15,372
1129258,29,0,29,84,15,3,102,251,3,356
1129259,3,0,3,87,48,3,138,242,18,398
1129260,4,3,7,62,24,3,89,228,27,344
1129261,7,0,7,199,61,4,264,555,109,928
1129262,5,0,5,96,33,14,143,250,4,397
1129263,0,0,0,46,7,6,59,113,9,181
1129264,0,0,0,41,19,0,60,150,0,210
1129301,3,3,6,75,13,0,88,205,3,296
1129302,0,0,0,79,23,0,102,203,7,312
1129303,3,0,3,89,38,0,127,362,4,493
1129304,6,0,6,47,25,3,75,157,10,242
1129305,6,0,6,91,24,0,115,307,11,433
1129306,3,0,3,54,33,3,90,169,10,269
1129307,0,0,0,64,31,0,95,164,7,266
1129308,16,0,16,86,31,3,120,251,18,389
1129309,0,0,0,33,19,0,52,129,3,184
1129310,0,0,0,48,11,0,59,218,3,280
1129311,0,0,0,48,18,0,66,163,3,232
1129312,3,0,3,30,18,0,48,117,9,174
1129313,3,0,3,54,13,6,73,151,9,233
1129314,0,0,0,56,11,0,67,136,6,209
1129315,5,0,5,90,7,5,102,287,8,397
1129316,0,0,0,67,6,0,73,155,9,237
1129317,0,0,0,95,29,0,124,254,8,386
1129318,0,0,0,45,28,0,73,143,15,231
1129319,0,0,0,62,27,9,98,223,3,324
1129320,6,0,6,56,26,0,82,207,7,296
1129321,28,3,31,57,23,0,80,240,21,341
1129322,0,0,0,45,23,0,68,153,9,230
1129323,6,0,6,28,19,0,47,112,0,159
1129324,0,0,0,35,12,3,50,138,3,191
1129325,3,0,3,43,31,3,77,290,3,370
1129326,0,0,0,32,9,3,44,130,0,174
1129327,3,0,3,63,20,3,86,236,6,328
1129328,0,3,3,50,24,0,74,197,15,286
1129329,3,0,3,48,13,0,61,218,6,285
1129330,6,0,6,60,20,0,80,191,24,295
1129331,0,0,3,95,35,0,130,227,28,385
1129332,0,0,0,74,10,0,84,187,23,294
1129333,3,0,3,107,15,3,125,201,35,361
1129334,0,4,4,94,16,4,114,209,13,336
1129335,0,3,3,54,18,3,75,168,3,246
1129336,0,0,0,97,37,0,134,260,13,407
1129337,0,0,0,120,40,3,163,307,20,490
1129338,0,0,0,66,32,4,102,173,9,284
1129339,3,0,3,54,39,0,93,262,6,361
1129340,6,0,6,45,39,6,90,191,9,290
1129341,3,0,3,47,9,0,56,137,9,202
1129342,106,9,115,20,6,0,26,218,18,262
1129343,0,0,0,0,0,0,0,0,0,0
1129344,104,5,109,36,13,0,49,292,11,352
1129345,530,260,793,3,28,0,31,1044,429,1504
1129346,0,0,0,0,0,0,0,0,0,0
1129347,0,0,0,101,29,0,130,193,6,329
1129348,3,0,3,76,23,3,102,238,12,352
1129349,3,0,3,53,24,3,80,121,0,201
1129350,3,0,3,42,26,0,68,106,9,183
1129351,7,0,7,113,53,4,170,312,3,485
1129352,0,0,0,84,26,3,113,227,5,345
1129353,0,0,0,61,4,5,70,196,12,278
1129354,0,0,0,63,12,3,78,148,6,232
1129355,0,0,0,68,9,0,77,146,13,236
1129356,0,0,0,71,13,6,90,251,18,359
1129357,3,0,3,62,17,6,85,249,16,350
1129358,0,3,3,95,23,6,124,231,6,361
1129359,0,0,0,65,19,0,84,191,16,291
1129360,0,0,0,77,15,12,104,182,7,293
1129361,0,0,0,52,5,0,57,128,10,195
1129362,0,0,0,94,19,0,113,243,16,372
1129363,3,0,3,80,32,0,112,370,6,488
1129364,0,0,0,72,8,0,80,186,0,266
1129401,0,0,0,101,30,3,134,316,24,474
1129402,6,0,6,55,28,6,89,197,6,292
1129403,17,0,17,20,26,0,46,165,14,225
1129404,0,0,0,13,12,6,31,31,9,71
1129405,15,0,15,46,38,3,87,212,23,322
1129406,0,0,0,60,13,0,73,175,9,257
1129407,0,0,0,57,26,3,86,140,9,235
1129408,0,0,0,82,23,0,105,278,10,393
1129409,0,0,0,39,25,7,71,196,15,282
1129410,3,0,3,50,12,6,68,144,15,227
1129411,0,0,0,35,7,6,48,118,6,172
1129412,3,0,6,67,20,0,87,246,15,348
1129413,4,0,4,114,40,3,157,311,27,495
1129414,3,0,3,67,30,3,100,185,6,291
1129415,43,0,43,42,31,0,73,250,16,339
1129416,0,0,0,93,21,3,117,225,9,351
1129501,0,0,0,35,16,6,57,108,12,177
1129502,0,0,0,116,21,0,137,248,11,396
1129503,5,0,5,94,42,6,142,182,12,336
1129504,3,0,3,124,38,6,168,261,24,453
1129505,0,0,0,144,44,3,191,309,14,514
1129506,0,0,0,91,30,6,127,248,15,390
1129507,0,0,0,61,15,0,76,173,16,265
1129508,4,0,4,89,16,0,105,160,13,278
1129509,0,0,0,184,43,9,236,263,11,510
1129510,0,0,0,117,22,0,139,193,13,345
1129511,0,3,3,94,27,0,121,158,12,291
1129512,0,0,0,122,32,3,157,327,18,502
1129513,3,0,3,93,3,0,96,185,10,291
1129514,0,0,0,120,23,7,150,263,26,439
1129515,3,0,3,124,31,0,155,241,20,416
1129516,3,0,3,139,33,7,179,326,6,511
1129517,3,0,3,55,6,0,61,147,6,214
1129518,7,0,7,96,27,10,133,226,21,380
1129519,3,0,3,114,30,5,149,216,4,369
1129520,0,0,0,106,26,3,135,211,30,376
1129521,3,0,3,52,29,0,81,154,6,241
1129522,6,0,6,148,30,4,182,269,41,492
1129523,3,0,3,125,35,10,170,237,9,416
1129524,8,0,8,132,36,3,171,285,13,469
1129525,3,0,3,109,25,4,138,249,6,393
1129526,0,0,0,73,10,4,87,213,18,318
1129527,0,0,0,127,12,3,142,221,8,371
1129528,0,0,0,80,16,14,110,147,6,263
1129529,0,0,0,109,23,8,140,188,6,334
1129530,3,0,3,89,28,0,117,262,5,384
1129531,0,0,0,49,13,0,62,140,3,205
1129532,0,0,0,62,8,6,76,171,18,265
1129533,3,0,3,80,36,6,122,203,12,337
1129534,3,0,3,76,7,0,83,195,6,284
1129535,0,3,3,187,28,4,219,371,15,605
1129536,3,0,3,104,19,0,123,192,9,324
1129537,0,0,0,148,36,4,188,192,9,389
1129538,0,0,0,129,24,3,156,243,21,420
1129539,3,0,3,88,12,0,100,126,9,235
1129540,9,0,9,65,37,0,102,246,23,371
1129541,0,0,0,55,20,3,78,148,7,233
1129542,4,0,4,102,25,9,136,223,27,386
1129543,7,0,7,86,30,6,122,211,32,365
1129544,5,0,5,111,42,6,159,252,14,425
1129545,0,0,0,117,50,6,173,232,3,408
1129546,0,0,0,171,45,7,223,313,53,589
1129547,3,0,3,94,21,3,118,183,18,319
1129548,0,0,0,102,26,3,131,267,28,426
1129601,0,0,0,56,21,6,83,172,6,261
1129602,0,3,3,53,18,3,74,176,6,256
1129603,16,3,19,68,19,0,87,227,15,329
1129604,3,0,3,36,6,3,45,141,6,192
1129605,0,0,0,62,25,4,91,196,4,291
1129606,6,0,6,62,46,3,111,268,0,379
1129607,3,0,3,37,17,3,57,155,6,218
1129608,0,0,0,64,16,0,80,125,0,205
1129609,0,3,3,70,25,0,95,160,12,267
1129610,0,5,5,105,35,0,140,325,11,476
1129611,0,0,0,77,29,5,111,208,6,325
1129612,3,0,3,53,25,0,78,196,7,281
1129613,0,0,0,58,39,3,100,191,3,294
1129614,0,0,0,116,52,6,174,342,0,516
1129615,4,3,7,65,32,3,100,256,13,369
1129616,4,0,4,69,21,6,96,253,11,360
1129617,0,0,0,65,10,9,84,213,12,309
1129618,58,6,64,14,14,0,28,184,17,229
1129619,6,0,6,59,32,0,91,258,0,349
1129620,3,0,3,76,24,7,107,309,12,428
1129621,0,3,3,69,46,0,115,176,9,300
1129622,6,0,6,110,46,0,156,309,15,480
1129623,3,0,3,72,33,0,105,185,12,302
1129624,0,0,0,40,23,7,70,138,0,208
1129625,3,0,3,84,34,6,124,225,15,364
1129626,3,0,6,25,19,0,44,167,9,220
1129627,3,0,3,77,23,0,100,193,23,316
1129628,4,0,4,63,41,0,104,326,6,436
1129629,3,0,3,71,32,3,106,260,7,373
1129630,0,0,0,48,22,0,70,188,8,266
1129631,3,0,3,54,31,4,89,205,3,297
1129632,0,0,0,76,30,5,111,262,12,385
1129701,3,0,3,72,22,0,94,213,0,307
1129702,3,0,3,66,19,6,91,166,18,275
1129703,0,0,0,76,29,6,111,203,16,330
1129704,3,3,6,38,29,3,70,202,16,288
1129705,0,0,0,52,15,3,70,172,6,248
1129706,3,0,3,36,20,0,56,91,6,153
1129707,0,0,0,47,24,4,75,113,0,188
1129708,0,0,0,48,21,0,69,135,0,204
1129709,3,0,3,73,28,4,105,225,14,344
1129710,3,0,6,63,27,0,90,207,10,307
1129711,4,0,4,28,15,0,43,130,9,182
1129712,3,5,8,55,24,0,79,182,17,278
1129713,97,12,109,62,32,0,94,353,51,498
1129714,7,0,7,73,33,0,106,281,24,411
1129715,3,0,3,58,20,4,82,185,18,285
1129716,3,0,3,39,13,7,59,104,10,173
1129717,0,3,3,36,25,3,64,128,12,204
1129718,6,0,6,60,23,6,89,176,25,290
1129719,3,0,6,40,21,0,61,225,22,308
1129720,0,3,3,60,20,6,86,164,14,264
1129721,3,0,3,38,13,3,54,141,13,208
1129722,8,0,8,66,31,9,106,248,7,361
1129723,0,4,4,25,24,3,52,180,28,260
1129724,3,0,3,52,16,0,68,126,7,201
1129725,6,3,9,49,25,4,78,155,3,236
1129726,4,0,4,43,19,6,68,145,18,231
1129727,0,0,0,24,6,3,33,100,23,156
1129728,3,4,7,63,17,6,86,140,13,239
1129729,0,0,0,47,18,3,68,149,18,235
1129730,0,0,0,39,17,0,56,116,14,186
1129731,0,0,0,40,28,0,68,189,15,272
1129732,5,3,8,71,41,6,118,218,6,342
1129733,7,0,7,69,22,0,91,182,23,296
1129734,5,0,5,99,42,12,153,240,18,411
1129735,30,0,30,46,28,3,77,219,6,302
1129736,0,0,0,76,29,3,108,253,6,367
1129737,0,0,0,85,19,3,107,235,9,351
1129738,9,0,9,45,21,0,66,189,9,264
1129739,5,0,5,49,33,3,85,207,12,304
1129740,12,0,12,34,24,3,61,134,3,198
1129741,6,0,6,48,25,6,79,124,8,211
1129742,0,0,0,47,19,7,73,147,9,229
1129743,3,0,3,65,10,4,79,211,6,296
1129744,0,0,0,86,15,3,104,173,12,289
1129745,0,0,0,43,16,0,59,159,0,218
1129746,0,0,0,51,26,0,77,216,3,296
1129747,0,0,0,93,26,5,124,189,18,331
1129748,5,0,5,63,25,3,91,260,28,379
1129749,6,3,9,58,38,0,96,172,33,301
1129750,6,0,6,64,27,3,94,191,45,330
1129751,4,0,4,59,26,0,85,234,15,334
1129752,3,0,3,70,35,0,105,212,23,340
1129753,6,0,6,90,33,4,127,249,23,399
1129754,8,0,8,59,32,0,91,198,19,308
1129755,5,0,5,65,16,4,85,204,4,293
1129756,6,0,6,104,9,0,113,195,23,331
1129757,0,0,0,51,11,0,62,100,3,165
1129758,6,0,6,51,27,0,78,140,0,218
1129801,0,0,0,43,33,0,76,178,5,259
1129802,0,3,3,39,36,0,75,152,6,233
1129803,0,3,3,79,36,6,121,171,20,312
1129804,3,0,3,45,24,3,72,141,6,219
1129805,3,0,3,35,22,0,57,95,8,160
1129806,34,0,34,57,40,4,101,218,11,330
1129807,3,0,6,73,35,6,114,206,12,332
1129808,0,4,4,48,20,3,71,174,11,256
1129809,3,0,3,52,25,6,83,159,9,251
1129810,0,0,0,41,7,0,48,113,18,179
1129811,5,0,5,51,21,0,72,146,6,224
1129812,6,0,6,61,26,0,87,170,12,269
1129813,51,5,56,0,6,0,6,119,15,140
1129814,6,4,10,99,19,6,124,232,22,378
1129815,3,0,3,38,29,8,75,139,10,224
1129816,4,0,4,27,12,4,43,121,0,164
1129817,0,0,0,36,23,0,59,138,12,209
1129901,3,3,6,46,15,5,66,170,46,282
1129902,10,0,10,70,40,0,110,289,97,496
1129903,0,0,0,49,15,3,67,171,25,263
1129904,3,0,3,47,16,0,63,153,20,236
1129905,6,0,6,41,20,0,61,104,36,201
1129906,0,0,0,37,3,0,40,89,19,148
1129907,3,0,3,29,15,0,44,131,72,247
1129908,3,3,6,37,23,0,60,171,24,255
1130001,4,0,4,103,23,6,132,173,6,311
1130002,0,3,3,95,20,13,128,224,23,375
1130003,3,0,3,37,25,3,65,122,16,203
1130004,7,0,7,68,28,0,96,221,26,343
1130005,0,0,0,56,12,0,68,131,6,205
1130006,3,0,3,53,15,9,77,121,15,213
1130007,3,0,3,50,38,3,91,157,33,281
1130008,0,0,0,0,0,0,0,0,0,0
1130009,5,4,9,48,8,3,59,149,10,218
1130010,21,0,21,47,16,7,70,202,15,287
1130011,3,0,3,62,10,0,72,156,6,234
1130012,3,0,3,52,14,3,69,112,15,196
1130013,6,0,6,48,32,3,83,167,6,256
1130014,6,3,9,63,26,3,92,145,24,261
1130015,0,0,0,35,17,3,55,136,22,213
1130016,8,0,8,83,43,3,129,316,47,492
1130017,0,0,0,35,26,0,61,149,12,222
1130018,0,0,0,67,19,0,86,210,15,311
1130019,3,0,3,93,48,3,144,215,35,394
1130020,3,0,3,21,18,0,39,109,12,160
1130021,0,0,0,38,18,3,59,141,12,212
1130022,4,3,7,100,23,3,126,200,15,341
1130023,0,0,0,73,30,3,106,244,54,404
1130024,7,0,7,49,20,3,72,118,27,217
1130025,0,0,0,79,31,0,110,141,27,278
1130026,9,0,9,65,26,0,91,203,25,319
1130027,6,0,6,50,13,0,63,129,13,205
1130028,0,0,0,73,28,6,107,112,7,226
1130029,4,0,4,97,25,6,128,254,12,394
1130030,4,0,4,20,18,3,41,100,27,168
1130031,0,0,0,85,29,9,123,185,8,316
1130032,0,0,0,59,17,5,81,126,8,215
1130033,3,0,3,56,14,0,70,165,25,260
1130034,4,6,10,54,35,0,89,178,57,324
1130035,0,0,0,74,38,0,112,237,7,356
1130036,0,0,0,68,27,0,95,157,18,270
1130037,0,3,3,91,24,3,118,190,12,320
1130038,3,0,3,62,13,0,75,175,3,253
1130039,0,0,0,0,0,0,0,0,0,0
1130040,3,0,3,42,11,0,53,151,8,212
1130041,4,0,4,100,26,8,134,203,6,343
1130042,8,0,8,87,19,6,112,228,18,358
1130043,6,0,6,101,23,3,127,272,18,417
1130044,3,0,3,65,16,8,89,112,9,210
1130045,3,0,3,66,24,9,99,182,21,302
1130046,0,0,0,45,9,0,54,117,7,178
1130047,4,0,4,100,22,9,131,249,31,411
1130048,3,3,6,60,24,6,90,241,18,349
1130049,3,0,3,71,36,4,111,274,21,406
1130050,3,0,3,71,25,6,102,161,15,278
1130051,3,0,3,75,20,0,95,156,19,270
1130052,0,0,0,69,13,3,85,146,18,249
1130053,0,0,0,56,12,0,68,142,25,235
1130054,0,0,0,75,39,3,117,210,13,340
1130055,6,0,6,59,22,0,81,110,23,214
1130056,6,0,6,62,24,0,86,239,37,362
1130057,0,0,0,24,7,3,34,119,46,199
1130058,0,0,0,55,31,3,89,163,15,267
1130059,0,0,0,11,0,0,11,58,6,75
1130060,0,4,4,41,3,9,53,103,8,164
1130061,0,0,0,19,3,6,28,60,9,97
1130062,6,3,9,99,38,6,143,205,26,374
1130063,3,0,3,60,23,8,91,169,23,283
1130101,4,0,4,45,42,0,87,241,53,381
1130102,0,0,0,46,11,6,63,93,11,167
1130103,11,8,19,48,17,3,68,207,30,305
1130104,0,0,0,124,33,7,164,273,16,453
1130105,0,0,0,66,21,0,87,123,15,225
1130106,0,0,0,73,28,3,104,182,15,301
1130107,3,0,3,85,37,0,122,233,28,383
1130108,0,0,0,53,28,0,81,178,21,280
1130109,4,0,4,132,35,4,171,233,32,436
1130110,3,0,3,86,17,6,109,196,12,317
1130111,3,0,3,58,22,0,80,159,3,242
1130112,0,0,0,84,17,3,104,146,15,265
1130113,0,0,0,52,26,0,78,119,14,211
1130114,0,0,0,73,16,9,98,190,20,308
1130115,3,3,6,78,23,0,101,224,12,337
1130116,9,0,9,123,49,10,182,270,29,481
1130117,3,0,3,66,29,9,104,145,3,252
1130118,0,0,0,120,28,0,148,275,9,432
1130119,3,0,6,67,37,0,104,195,18,317
1130120,6,0,6,65,38,4,107,223,24,354
1130121,3,3,6,57,41,0,98,249,21,368
1130122,5,0,5,40,20,0,60,150,12,222
1130201,3,0,3,118,19,5,142,158,24,324
1130202,0,0,0,83,9,0,92,129,7,228
1130203,3,0,3,103,29,0,132,176,12,320
1130204,0,0,0,186,26,6,218,251,17,486
1130205,0,0,0,155,28,0,183,223,5,411
1130206,0,0,0,149,23,0,172,207,21,400
1130207,6,0,6,37,11,0,48,130,15,193
1130208,0,0,0,68,43,6,117,243,19,379
1130209,5,0,5,53,28,6,87,203,15,305
1130210,4,0,4,63,50,3,116,307,10,433
1130211,0,0,0,128,27,6,161,158,27,346
1130212,0,0,0,93,14,9,116,164,6,286
1130213,3,0,3,45,14,6,65,103,9,177
1130214,4,0,4,112,36,3,151,192,20,363
1130215,3,0,3,106,30,0,136,183,16,335
1130216,0,0,0,83,13,0,96,134,10,240
1130217,0,0,0,74,24,6,104,143,6,253
1130218,6,6,12,46,36,9,91,285,26,402
1130219,0,0,0,163,27,3,193,187,15,395
1130220,0,0,0,105,36,3,144,255,40,439
1130221,0,0,0,44,28,0,72,159,31,262
1130222,6,0,6,92,26,0,118,162,12,292
1130223,3,0,3,73,12,9,94,125,5,224
1130224,0,0,0,100,13,3,116,206,12,334
1130225,5,0,5,44,24,3,71,202,6,279
1130226,0,0,0,117,19,8,144,177,12,333
1130227,0,0,0,77,15,5,97,126,7,230
1130228,0,0,0,106,20,4,130,142,10,282
1130229,3,0,3,82,26,4,112,135,12,259
1130230,0,0,0,93,18,0,111,143,6,260
1130231,0,0,0,133,26,9,168,188,9,365
1130232,0,0,0,90,18,4,112,108,6,226
1130233,3,0,3,84,13,0,97,114,6,217
1130234,0,0,0,86,13,0,99,137,10,246
1130235,0,0,0,98,25,7,130,137,9,276
1130236,0,3,3,92,21,7,120,148,27,295
1130237,0,0,0,118,19,5,142,159,51,352
1130238,0,0,0,87,26,6,119,141,29,289
1130239,0,0,0,0,3,0,3,12,3,18
1130240,0,0,0,107,22,3,132,134,26,292
1130241,3,0,3,99,23,8,130,116,12,258
1130242,0,0,0,81,19,3,103,89,35,227
1130243,0,0,0,137,26,0,163,152,16,331
1130244,3,0,3,47,29,0,76,104,12,192
1130301,0,0,0,41,15,0,56,97,12,165
1130302,7,3,10,54,10,0,64,144,14,222
1130303,0,0,0,3,0,0,3,3,0,6
1130304,3,0,3,53,19,6,78,198,33,309
1130305,0,3,3,48,32,0,80,210,24,314
1130306,6,0,6,86,30,0,116,246,37,399
1130307,3,0,3,63,15,5,83,205,14,302
1130308,0,0,0,113,36,7,156,210,9,375
1130309,0,0,0,0,0,0,0,0,3,3
1130310,0,0,0,67,27,0,94,171,13,278
1130311,0,0,0,88,23,6,117,236,24,377
1130312,0,0,0,75,17,5,97,178,6,281
1130313,0,0,0,0,3,0,3,0,0,3
1130314,0,0,0,85,26,0,111,208,12,331
1130315,0,0,0,99,37,3,139,222,17,378
1130316,0,0,0,44,15,0,59,77,12,148
1130317,0,0,0,65,27,3,95,117,0,212
1130318,26,0,26,59,6,0,65,215,20,300
1130319,0,0,0,127,12,0,139,288,41,468
1130320,0,0,0,97,14,0,111,242,31,384
1130321,3,0,3,33,15,0,48,120,15,183
1130322,4,6,10,72,16,6,94,214,46,354
1130323,0,7,7,67,26,0,93,185,29,307
1130324,7,0,7,66,22,0,88,206,24,318
1130325,4,5,9,83,31,0,114,285,51,450
1130326,26,12,41,42,16,3,61,224,63,348
1130327,5,3,8,65,12,0,77,242,32,351
1130328,0,0,0,167,12,0,179,328,71,578
1130329,0,0,0,94,9,0,103,244,45,392
1130330,0,0,0,0,0,0,0,0,3,3
1130331,0,0,0,188,23,3,214,466,35,715
1130332,3,0,3,25,0,0,25,86,17,128
1130333,0,0,0,117,12,0,129,341,40,510
1130334,4,0,4,95,10,0,105,254,36,395
1130335,0,0,0,106,15,0,121,386,48,555
1130336,3,0,3,51,6,0,57,167,24,248
1130337,0,0,0,0,0,0,0,0,0,0
1130338,9,6,15,63,15,0,78,264,41,383
1130339,6,3,9,41,13,0,54,166,42,262
1130340,0,0,0,0,0,0,0,19,0,19
1130341,3,3,6,62,18,0,80,209,30,319
1130342,6,3,9,39,35,0,74,184,27,285
1130401,3,0,3,58,21,0,79,175,15,269
1130402,0,0,0,72,20,0,92,162,15,269
1130403,6,0,6,74,35,6,115,230,28,373
1130404,3,6,9,96,18,0,114,268,57,439
1130405,8,5,13,62,21,3,86,169,24,279
1130406,0,0,0,62,20,3,85,194,17,296
1130407,4,0,4,71,22,3,96,249,20,365
1130408,0,0,0,50,7,0,57,158,27,242
1130409,0,0,0,60,11,3,74,167,21,262
1130410,0,3,3,61,24,0,85,198,41,324
1130411,0,0,0,52,30,9,91,164,9,264
1130412,4,0,4,35,23,3,61,166,30,257
1130413,12,3,15,86,41,3,130,372,45,547
1130414,124,37,161,50,21,0,71,306,64,441
1130415,3,0,3,39,21,0,60,169,18,247
1130416,3,3,6,104,15,3,122,237,29,388
1130417,5,0,5,101,26,0,127,323,42,492
1130418,7,0,7,111,43,3,157,364,32,553
1130419,0,0,0,77,19,6,102,207,18,327
1130420,0,0,0,91,17,4,112,187,43,342
1130421,0,0,0,58,21,0,79,201,21,301
1130422,0,0,0,55,33,0,88,123,9,220
1130423,0,0,0,37,17,0,54,138,13,205
1130424,0,0,0,130,22,4,156,335,17,508
1130425,0,0,0,70,34,0,104,224,14,342
1130426,8,0,8,99,26,4,129,322,37,488
1130427,0,0,0,0,0,0,0,0,0,0
1130428,8,0,8,54,27,3,84,211,36,331
1130429,0,0,0,57,16,0,73,174,9,256
1130430,3,0,3,55,29,0,84,225,19,328
1130431,4,0,4,35,6,0,41,89,9,139
1130432,0,0,0,95,29,3,127,296,25,448
1130433,3,0,3,68,19,3,90,197,14,301
1130434,3,0,6,76,36,3,115,199,18,332
1130435,0,0,0,80,28,11,119,253,27,399
1130436,7,0,7,75,18,0,93,197,19,309
1130437,3,0,3,59,21,3,83,216,19,318
1130438,0,0,0,42,13,6,61,149,17,227
1130439,4,3,7,98,23,0,121,254,33,408
1130440,0,0,0,76,21,0,97,150,13,260
1130441,0,0,0,0,0,0,0,0,0,0
1130442,0,0,0,62,16,0,78,200,9,287
1130501,6,0,6,104,28,0,132,254,24,410
1130502,4,0,4,49,9,3,61,206,24,291
1130503,7,3,10,71,30,0,101,188,26,315
1130504,0,0,0,53,10,3,66,173,3,242
1130505,0,0,0,66,34,6,106,219,10,335
1130506,0,0,0,119,36,3,158,283,15,456
1130507,3,0,3,82,9,3,94,141,9,244
1130508,0,3,3,81,36,0,117,162,24,303
1130509,5,0,5,138,45,7,190,288,25,503
1130510,24,3,27,49,13,0,62,262,14,338
1130511,0,0,0,93,36,0,129,193,8,330
1130512,4,0,4,50,9,5,64,135,6,205
1130513,4,0,4,42,19,3,64,197,26,287
1130514,3,0,6,75,38,5,118,298,13,429
1130515,0,0,0,45,18,3,66,145,24,235
1130516,0,0,0,80,29,6,115,243,24,382
1130517,10,0,10,104,45,3,152,319,31,502
1130518,4,0,4,61,19,6,86,190,19,295
1130519,0,0,0,80,18,6,104,174,10,288
1130520,3,0,3,20,8,4,32,113,9,154
1130521,0,0,0,74,30,3,107,245,29,381
1130522,0,0,0,55,4,0,59,174,24,257
1130523,0,0,0,55,26,0,81,128,10,219
1130524,6,0,6,107,28,12,147,250,13,410
1130525,0,6,6,38,15,6,59,121,27,207
1130526,0,0,0,35,12,0,47,113,22,182
1130527,0,0,0,116,16,3,135,301,42,478
1130528,3,6,9,70,20,4,94,221,24,339
1130529,11,0,11,67,23,0,90,243,37,370
1130530,4,0,4,48,19,0,67,181,33,281
1130531,3,0,3,59,23,0,82,192,18,292
1130532,7,0,7,52,11,0,63,159,25,247
1130533,3,0,3,65,23,0,88,236,18,342
1130534,3,3,6,84,35,0,119,331,30,480
1130535,11,3,14,74,14,0,88,192,17,297
1130536,9,0,9,87,14,0,101,251,33,385
1130537,0,0,0,85,18,3,106,142,3,251
1130538,7,0,7,103,32,3,138,235,28,401
1130539,6,0,6,63,38,9,110,250,19,379
1130540,0,5,5,57,21,0,78,133,18,229
1130541,0,3,3,69,20,0,89,129,19,237
1130542,0,0,0,77,18,0,95,208,13,316
1130543,6,3,9,61,18,6,85,175,18,278
1130544,0,0,0,55,19,4,78,143,6,227
1130545,0,0,0,72,21,0,93,157,25,275
1130546,0,0,0,46,28,3,77,171,35,283
1130547,3,0,3,61,38,10,109,210,18,337
1130548,90,9,99,53,19,3,75,359,37,471
1130549,6,0,6,72,31,3,106,300,19,425
1130550,17,5,22,79,41,6,126,364,40,530
1130551,6,0,6,84,26,0,110,243,24,377
1130552,6,0,6,48,18,4,70,129,12,211
1130553,3,0,3,51,17,0,68,204,25,297
1130554,3,0,3,86,3,0,89,233,38,360
1130555,3,0,3,112,22,0,134,262,18,414
1130556,3,0,3,67,36,6,109,261,36,406
1130557,0,0,0,106,26,3,135,186,6,327
1130558,0,0,0,85,16,0,101,145,9,255
1130559,0,0,0,112,24,4,140,228,15,383
1130560,3,0,3,51,9,8,68,129,27,224
1130561,0,0,0,113,33,6,152,212,27,391
1130562,0,0,0,70,13,3,86,168,23,277
1130563,7,3,10,102,28,0,130,348,34,512
1130601,0,0,0,107,20,0,127,278,13,418
1130602,3,0,3,73,13,0,86,262,12,360
1130603,0,0,0,282,31,3,316,520,28,864
1130604,0,0,0,0,0,0,0,0,0,0
1130605,0,0,0,21,12,0,33,134,22,189
1130606,0,0,0,55,17,0,72,197,39,308
1130607,4,0,4,43,20,0,63,121,35,219
1130608,3,0,3,102,46,9,157,308,24,489
1130609,0,0,0,53,7,0,60,143,14,217
1130610,0,0,0,45,10,0,55,133,11,199
1130611,0,0,0,93,14,3,110,228,26,364
1130612,7,0,7,74,28,3,105,243,9,357
1130613,0,0,0,83,26,0,109,234,18,361
1130614,6,0,6,71,16,0,87,219,24,330
1130615,3,0,3,86,29,0,115,175,24,314
1130616,3,0,3,35,13,0,48,198,13,259
1130617,3,0,3,89,12,0,101,250,19,370
1130618,0,0,0,53,15,6,74,168,3,245
1130619,6,0,6,82,23,4,109,285,28,422
1130620,3,0,3,107,30,5,142,223,15,380
1130621,3,3,6,70,34,0,104,249,18,371
1130622,6,0,6,70,8,4,82,215,3,300
1130623,0,4,4,27,17,3,47,127,18,192
1130624,7,0,7,70,16,0,86,225,12,323
1130625,4,0,4,79,18,0,97,248,64,409
1130626,6,0,6,58,35,0,93,213,24,330
1130627,3,0,3,48,22,3,73,176,43,292
1130628,11,0,11,51,10,0,61,202,35,298
1130629,0,0,0,0,0,0,0,3,0,3
1130630,8,0,8,89,32,3,124,225,30,379
1130631,3,4,7,58,15,4,77,203,26,306
1130632,0,0,0,59,16,0,75,191,34,300
1130633,0,0,0,47,12,0,59,170,25,254
1130634,0,4,4,45,30,3,78,169,9,256
1130635,3,0,3,29,23,0,52,139,27,218
1130636,0,0,0,43,27,0,70,125,6,201
1130637,0,0,0,25,17,0,42,153,15,210
1130638,24,0,24,73,33,9,115,286,40,441
1130639,3,0,3,59,27,6,92,203,11,306
1130640,0,0,0,41,27,3,71,198,3,272
1130641,6,0,9,72,21,9,102,282,34,418
1130642,6,0,6,40,26,0,66,204,35,305
1130643,0,0,0,42,25,0,67,153,32,252
1130644,3,0,3,30,5,3,38,118,7,163
1130645,0,3,3,31,19,12,62,197,26,285
1130646,4,0,4,75,20,4,99,226,18,343
1130647,6,0,6,58,15,6,79,198,29,306
1130648,0,0,0,58,12,3,73,143,20,236
1130649,0,0,0,38,13,4,55,187,33,275
1130650,6,0,6,80,25,3,108,242,41,391
1130701,0,0,0,81,27,0,108,302,37,447
1130702,4,0,4,75,27,0,102,195,14,311
1130703,0,0,0,104,12,3,119,171,15,305
1130704,3,0,6,40,17,0,57,111,4,172
1130705,3,0,3,61,28,3,92,225,5,322
1130706,0,0,0,64,24,9,97,149,12,258
1130707,6,0,6,63,24,0,87,209,35,331
1130708,3,0,3,54,24,3,81,235,50,366
1130709,0,3,3,88,25,0,113,217,55,385
1130710,11,0,11,88,32,9,129,209,18,356
1130711,0,0,0,81,34,6,121,256,18,395
1130712,0,0,0,81,27,3,111,184,4,299
1130713,4,0,4,67,26,6,99,152,6,257
1130714,6,3,9,103,33,3,139,253,12,404
1130715,3,0,3,52,10,0,62,197,37,296
1130716,0,4,4,74,18,0,92,251,30,373
1130717,10,0,10,82,28,0,110,297,41,448
1130718,3,0,3,56,13,3,72,186,37,295
1130719,3,0,3,73,10,4,87,207,31,325
1130720,0,0,0,99,24,0,123,299,21,443
1130721,0,0,0,0,0,0,0,3,3,6
1130722,0,0,0,66,18,0,84,138,10,232
1130723,0,0,0,75,31,4,110,184,24,318
1130724,3,3,6,56,15,0,71,154,12,237
1130725,7,0,7,64,35,3,102,221,19,342
1130726,0,0,0,108,47,6,161,284,6,451
1130727,4,0,4,62,25,6,93,178,13,284
1130728,46,0,46,24,6,0,30,147,6,183
1130729,6,0,6,77,23,0,100,166,9,275
1130730,67,3,70,68,26,6,100,345,34,479
1130731,0,0,0,82,26,3,111,163,12,286
1130732,0,0,0,42,16,0,58,140,8,206
1130733,0,0,0,59,31,6,96,158,12,266
1130734,10,0,10,61,18,3,82,271,33,386
1130735,8,3,11,83,18,3,104,297,28,429
1130736,4,3,7,91,25,7,123,235,27,385
1130737,7,3,10,42,22,3,67,187,16,270
1130738,3,0,3,65,14,3,82,260,28,370
1130739,4,0,4,78,12,4,94,219,14,327
1130740,3,3,6,60,20,3,83,242,45,370
1130741,3,0,3,68,21,0,89,238,27,354
1130742,6,0,6,95,45,9,149,227,18,394
1130743,4,0,4,48,32,3,83,132,5,220
1130744,3,0,3,118,27,6,151,230,24,405
1130745,0,0,0,107,45,3,155,267,3,425
1130746,6,0,6,70,23,6,99,209,12,320
1130747,3,0,3,85,46,0,131,240,3,374
1130748,7,3,10,99,28,4,131,281,33,445
1130749,3,0,3,92,45,0,137,261,33,431
1130750,3,0,3,99,36,0,135,276,9,420
1130751,0,0,0,69,33,3,105,160,0,265
1130752,4,0,4,59,34,6,99,234,25,358
1130753,3,0,3,89,21,3,113,231,15,359
1130754,5,3,8,94,43,10,147,306,40,493
1130755,9,0,9,89,23,7,119,249,30,398
1130756,6,5,11,94,31,3,128,254,40,422
1130801,8,3,11,54,19,3,76,236,31,343
1130802,0,0,0,89,35,0,124,238,23,385
1130803,6,0,6,87,23,0,110,192,25,327
1130804,0,0,0,49,23,0,72,115,16,203
1130805,5,0,5,85,24,0,109,274,15,398
1130806,3,0,3,62,28,0,90,178,15,283
1130807,16,3,19,89,15,3,107,312,19,438
1130808,3,0,3,54,24,0,78,171,11,260
1130809,3,0,3,87,28,9,124,250,26,400
1130810,6,3,9,106,27,0,133,287,77,497
1130811,3,0,3,66,32,0,98,230,37,365
1130812,7,0,7,74,36,0,110,231,9,350
1130813,0,0,0,99,23,9,131,234,24,389
1130814,0,0,0,60,34,0,94,334,27,455
1130815,0,0,0,92,25,4,121,159,17,297
1130816,4,0,4,64,23,3,90,207,15,312
1130817,4,0,4,54,17,0,71,207,9,287
1130818,0,0,0,4,0,0,4,22,12,38
1130819,0,0,3,45,19,6,70,182,8,260
1130820,8,0,8,111,31,6,148,280,32,460
1130821,4,3,7,96,26,0,122,268,27,417
1130822,6,3,9,51,28,0,79,180,15,274
1130823,14,0,14,108,34,0,142,374,38,554
1130824,3,3,6,38,25,0,63,147,19,229
1130825,5,0,5,39,11,0,50,154,9,213
1130826,3,3,6,82,28,3,113,168,33,314
1130827,4,0,4,110,49,0,159,268,5,432
1130828,3,0,3,96,27,3,126,260,25,411
1130829,4,0,4,135,24,6,165,326,27,518
1130830,14,0,14,65,14,0,79,259,53,391
1130831,0,0,0,68,6,0,74,133,4,211
1130832,0,0,0,105,20,0,125,253,36,414
1130833,6,0,6,68,37,3,108,353,28,489
1130834,0,3,3,83,3,4,90,221,15,326
1130835,0,0,3,80,32,3,115,141,12,268
1130836,6,0,6,53,26,6,85,271,23,379
1130837,9,4,13,90,18,6,114,259,45,418
1130838,3,0,3,84,32,6,122,245,25,392
1130839,3,0,3,74,22,0,96,132,17,245
1130840,3,0,3,46,27,0,73,203,20,296
1130841,0,0,0,0,0,0,0,0,0,0
1130842,3,0,3,125,36,0,161,254,27,442
1130843,3,0,3,83,36,3,122,280,15,417
1130844,0,0,0,88,23,3,114,281,21,416
1130845,8,0,8,107,44,7,158,293,12,463
1130846,0,0,0,103,23,0,126,259,33,418
1130847,4,0,4,72,23,0,95,147,20,262
1130848,6,0,6,69,12,3,84,277,41,402
1130849,3,0,3,104,36,6,146,260,33,439
1130850,3,0,3,65,26,0,91,211,23,325
1130851,8,0,8,51,28,0,79,230,32,341
1130901,6,0,6,104,9,9,122,244,24,390
1130902,6,0,6,89,17,0,106,185,29,320
1130903,0,0,0,103,20,5,128,125,4,257
1130904,0,0,0,99,16,0,115,167,12,294
1130905,0,0,0,84,11,4,99,212,18,329
1130906,0,0,0,112,31,5,148,235,27,410
1130907,0,0,0,85,24,0,109,148,5,262
1130908,0,0,0,93,17,4,114,155,12,281
1130909,0,0,0,78,6,6,90,139,3,232
1130910,0,0,0,74,27,0,101,225,25,351
1130911,0,0,0,78,18,9,105,184,0,289
1130912,3,0,3,118,30,0,148,225,11,384
1130913,0,0,0,54,16,0,70,147,0,217
1130914,0,3,3,154,22,4,180,227,28,435
1130915,3,0,3,80,27,3,110,94,12,216
1130916,4,0,4,52,18,0,70,151,6,227
1130917,0,0,0,80,10,0,90,164,0,254
1130918,0,0,0,140,15,12,167,258,9,434
1130919,0,0,0,120,19,3,142,280,23,445
1130920,0,0,0,66,11,3,80,118,8,206
1130921,0,0,0,82,12,0,94,137,9,240
1130922,3,0,3,152,28,0,180,323,30,533
1130923,0,0,0,103,5,3,111,143,16,270
1130924,0,6,9,173,31,9,213,254,21,488
1130925,4,0,4,96,28,8,132,255,15,402
1130926,0,0,0,63,18,0,81,107,3,191
1130927,0,0,0,69,15,3,87,108,12,207
1130928,0,0,0,121,22,3,146,242,3,391
1130929,3,0,3,83,31,0,114,230,15,359
1130930,0,0,0,111,10,3,124,179,3,306
1130931,0,0,0,87,27,0,114,216,12,342
1130932,0,0,0,79,25,3,107,192,15,314
1130933,0,0,0,55,0,0,55,112,4,171
1130934,0,0,0,98,14,3,115,173,15,303
1130935,0,0,0,79,15,3,97,119,8,224
1130936,3,0,3,75,7,0,82,178,0,260
1131001,3,0,3,283,58,9,350,451,18,819
1131002,0,0,0,185,38,5,228,434,19,681
1131003,0,0,3,512,94,9,615,741,57,1413
1131004,3,0,3,108,30,4,142,267,25,434
1131005,3,3,6,136,28,8,172,213,22,407
1131006,3,0,3,60,15,3,78,81,3,162
1131007,0,0,0,66,12,0,78,103,3,184
1131008,0,0,0,106,14,3,123,175,15,313
1131009,0,0,0,246,27,11,284,374,26,684
1131010,3,0,3,308,51,11,370,372,9,751
1131011,3,0,3,72,7,3,82,118,12,212
1131012,12,0,12,15,30,0,45,286,21,352
1131013,0,0,0,96,18,3,117,141,0,258
1131014,3,3,6,99,13,9,121,163,12,296
1131015,0,0,0,99,11,3,113,135,10,258
1131016,0,0,0,241,41,9,291,420,23,734
1131017,0,0,0,134,21,0,155,212,10,377
1131018,0,0,0,144,23,0,167,217,21,405
1131019,0,0,0,118,32,5,155,215,19,389
1131020,0,0,0,115,18,11,144,140,21,305
1131021,3,0,3,74,17,0,91,114,15,220
1131022,0,0,0,88,21,0,109,139,11,259
1131023,0,0,0,237,53,11,301,429,25,755
1131024,0,0,0,0,0,0,0,0,734,734
1131025,0,0,0,124,27,6,157,229,9,395
1131026,3,0,3,301,43,15,359,598,60,1017
1131027,3,0,3,141,18,4,163,147,6,316
1131028,0,0,0,487,72,21,580,583,40,1203
1131029,4,0,4,212,31,6,249,255,15,519
1131030,3,0,3,94,10,4,108,224,19,351
1131031,0,0,3,380,46,18,444,515,35,994
1131101,4,0,4,150,42,0,192,305,15,512
1131102,6,3,9,102,37,0,139,261,22,422
1131103,3,0,3,152,26,9,187,260,18,465
1131104,3,0,3,123,31,3,157,295,20,472
1131105,0,0,0,109,22,0,131,206,18,355
1131106,0,0,0,46,8,4,58,94,3,155
1131107,0,0,0,83,11,4,98,168,18,284
1131108,0,0,0,98,26,6,130,217,9,356
1131109,3,0,3,126,22,13,161,162,12,335
1131110,0,0,0,80,23,9,112,203,21,336
1131111,0,0,0,60,25,3,88,157,6,251
1131112,0,0,0,109,31,6,146,223,11,380
1131113,0,0,0,9,6,0,15,67,18,100
1131114,0,0,3,154,24,3,181,239,24,444
1131115,3,0,3,110,4,3,117,180,12,309
1131116,0,0,0,226,31,7,264,346,26,636
1131117,3,0,3,83,21,0,104,198,3,305
1131118,3,0,3,102,24,0,126,271,14,411
1131119,0,0,0,53,8,8,69,136,0,205
1131120,3,0,3,89,19,3,111,198,18,327
1131121,0,0,0,92,26,3,121,287,15,423
1131122,0,0,0,95,9,10,114,164,16,294
1131123,0,0,0,82,29,3,114,230,21,365
1131124,0,0,0,134,20,6,160,267,19,446
1131125,3,0,3,61,15,0,76,156,15,247
1131126,0,0,0,79,16,6,101,231,20,352
1131127,3,4,7,94,27,6,127,231,12,370
1131128,0,0,0,65,19,0,84,165,8,257
1131129,4,0,4,70,28,0,98,196,16,310
1131130,0,0,0,57,29,0,86,189,9,284
1131131,0,0,0,84,23,6,113,198,15,326
1131132,3,0,3,77,10,0,87,121,12,220
1131133,0,0,0,108,10,3,121,224,28,373
1131134,3,0,3,44,22,0,66,125,10,201
1131135,5,0,5,62,16,0,78,161,9,248
1131136,0,0,0,57,13,5,75,145,6,226
1131137,3,0,3,93,15,6,114,245,15,374
1131138,0,0,0,93,40,3,136,177,16,329
1131139,3,0,3,82,30,0,112,207,13,332
1131140,0,0,0,129,28,0,157,270,13,440
1131141,0,0,0,71,12,3,86,95,14,195
1131142,3,0,3,64,9,4,77,144,3,224
1131143,0,0,0,85,13,6,104,185,12,301
1131144,0,0,0,74,19,9,102,191,18,311
1131145,4,0,4,136,29,0,165,246,24,435
1131146,6,3,9,81,19,0,100,160,14,274
1131147,0,0,0,78,10,0,88,119,9,216
1131148,3,0,3,70,23,0,93,162,10,265
1131149,0,0,0,82,11,3,96,150,39,285
1131150,0,0,0,101,24,0,125,164,15,304
1131151,3,0,3,145,35,13,193,227,32,452
1131152,4,0,4,87,25,3,115,227,19,361
1131153,3,0,3,149,24,12,185,228,13,426
1131154,0,0,0,64,12,5,81,120,10,211
1131155,0,0,0,92,28,5,125,241,9,375
1131156,32,0,32,115,19,0,134,283,24,441
1131157,0,0,0,108,35,6,149,200,8,357
1131158,0,0,0,163,40,10,213,302,14,529
1131201,0,0,0,35,14,0,49,114,7,170
1131202,0,0,0,99,18,6,123,359,35,517
1131203,0,0,0,16,19,3,38,85,23,146
1131204,4,0,4,66,28,3,97,182,40,319
1131205,3,3,6,79,28,6,113,189,48,350
1131206,8,3,11,37,16,3,56,176,21,253
1131207,3,3,6,61,14,3,78,170,19,267
1131208,0,0,0,63,26,4,93,174,27,294
1131209,4,0,4,62,35,6,103,187,38,328
1131210,3,0,3,77,36,3,116,246,36,398
1131211,0,0,0,44,12,0,56,109,29,194
1131212,0,0,0,26,9,6,41,89,15,145
1131213,7,0,7,57,22,0,79,175,30,284
1131214,0,0,0,67,26,0,93,157,23,273
1131215,6,3,9,84,43,7,134,213,20,367
1131216,0,0,0,60,12,3,75,114,15,204
1131217,6,0,6,109,21,3,133,179,24,336
1131218,9,0,9,59,24,0,83,140,12,235
1131219,3,0,3,48,7,0,55,128,20,203
1131220,0,0,0,63,27,6,96,195,36,327
1131221,0,0,0,0,0,0,0,9,0,9
1131222,6,0,6,59,28,0,87,209,24,320
1131223,3,0,3,37,34,3,74,178,5,257
1131224,4,0,4,45,16,0,61,179,21,261
1131225,0,0,0,0,0,0,0,0,0,0
1131226,6,0,6,106,37,9,152,279,26,457
1131227,3,0,3,51,18,0,69,246,29,344
1131228,4,0,4,29,15,3,47,110,21,178
1131229,3,0,3,42,23,3,68,184,31,283
1131230,0,0,0,50,8,0,58,180,18,256
1131231,11,0,11,48,33,4,85,220,0,305
1131232,5,0,5,78,28,0,106,248,27,381
1131233,3,0,3,68,22,0,90,205,9,304
1131301,0,0,0,33,10,3,46,96,21,163
1131302,0,0,0,30,9,0,39,102,24,165
1131303,0,0,0,81,34,0,115,247,39,401
1131304,0,0,0,76,26,0,102,234,48,384
1131305,0,0,0,60,26,3,89,217,26,332
1131306,0,0,0,51,22,7,80,179,32,291
1131307,3,0,3,59,20,0,79,172,26,277
1131308,0,0,0,38,17,0,55,115,12,182
1131309,0,0,0,57,28,0,85,206,25,316
1131310,0,0,0,66,21,0,87,228,46,361
1131311,0,0,0,50,29,0,79,130,30,239
1131312,0,0,0,48,11,0,59,140,31,230
1131313,3,0,3,28,19,0,47,117,20,184
1131314,0,0,0,57,30,6,93,230,20,343
1131315,6,0,6,38,9,4,51,114,35,200
1131316,0,0,0,27,12,0,39,112,32,183
1131317,0,0,0,59,22,0,81,193,41,315
1131318,0,0,0,67,25,3,95,225,66,386
1131319,6,0,6,61,24,4,89,149,14,252
1131320,0,0,0,79,30,0,109,203,24,336
1131321,0,0,0,49,7,0,56,131,20,207
1131322,0,5,5,63,28,11,102,160,10,272
1131323,0,0,0,39,19,4,62,127,58,247
1131324,0,0,0,0,0,0,0,0,0,0
1131325,3,0,3,74,27,0,101,186,77,364
1131326,0,0,0,35,21,0,56,87,9,152
1131327,0,0,0,95,20,4,119,260,31,410
1131328,0,0,0,68,30,6,104,262,13,379
1131329,0,0,0,0,0,0,0,0,0,0
1131330,0,0,0,33,12,3,48,126,27,201
1131331,0,0,0,0,0,0,0,0,0,0
1131332,0,3,3,62,17,3,82,182,43,307
1131333,0,0,0,72,33,5,110,182,30,322
1131334,0,0,0,23,20,0,43,139,3,185
1131335,3,0,3,74,33,3,110,175,27,312
1131336,0,0,0,71,24,9,104,266,58,428
1131337,3,0,3,52,9,0,61,160,19,240
1131338,0,0,0,53,20,9,82,170,21,273
1131339,0,0,0,41,9,3,53,153,10,216
1131340,0,0,0,20,11,0,31,92,25,148
1131341,0,0,0,53,19,0,72,154,30,256
1131342,0,3,3,68,31,3,102,223,46,371
1131343,0,0,0,31,16,0,47,111,21,179
1131344,0,0,0,0,0,0,0,0,0,0
1131345,0,0,0,63,32,3,98,186,26,310
1131346,0,0,0,49,21,3,73,159,44,276
1131347,0,3,3,86,27,12,125,228,35,388
1131348,6,0,6,45,30,0,75,185,18,278
1131349,0,0,0,87,29,0,116,199,21,336
1131350,3,3,6,98,29,6,133,287,37,457
1131351,0,0,0,62,30,3,95,177,12,284
1131352,0,0,0,36,7,0,43,94,15,152
1131401,0,0,0,107,21,0,128,188,12,328
1131402,0,0,0,109,18,0,127,223,33,383
1131403,0,0,0,100,15,0,115,167,4,286
1131404,0,0,0,83,21,3,107,177,12,296
1131405,0,0,0,129,25,6,160,186,20,366
1131406,3,0,3,87,17,3,107,189,21,317
1131407,0,0,0,111,23,0,134,170,17,321
1131408,0,0,0,115,21,0,136,208,17,361
1131409,0,0,0,82,9,3,94,118,0,212
1131410,0,0,0,67,12,0,79,122,15,216
1131411,4,0,4,123,28,0,151,214,29,394
1131412,0,0,0,87,18,6,111,165,17,293
1131413,3,0,3,60,24,0,84,158,19,261
1131414,0,0,0,61,10,0,71,125,13,209
1131415,0,0,0,88,21,0,109,203,32,344
1131416,57,7,64,31,3,0,34,207,11,252
1131417,0,0,0,71,25,3,99,251,24,374
1131418,0,0,0,0,0,0,0,0,0,0
1131419,0,0,0,59,12,6,77,174,6,257
1131420,0,0,0,0,0,0,0,3,0,3
1131421,0,0,0,0,0,0,0,6,0,6
1131422,0,0,0,107,10,0,117,116,6,239
1131423,0,0,0,93,21,0,114,131,0,245
1131501,3,0,3,76,19,0,95,154,3,252
1131502,0,0,0,89,15,3,107,132,15,254
1131503,3,0,3,44,18,0,62,138,0,200
1131504,0,0,0,90,30,0,120,261,19,400
1131505,3,0,3,89,25,0,114,200,23,337
1131506,0,0,0,146,18,3,167,309,22,498
1131507,0,0,0,0,0,0,0,0,0,0
1131508,3,0,3,59,24,0,83,171,6,260
1131509,0,0,0,46,7,6,59,134,18,211
1131510,0,0,0,67,17,0,84,166,16,266
1131511,3,0,3,54,12,3,69,117,15,201
1131512,3,0,3,79,15,0,94,253,25,372
1131513,3,0,3,84,23,3,110,158,52,320
1131514,0,0,0,115,28,6,149,284,40,473
1131515,0,0,0,83,18,0,101,185,31,317
1131516,0,0,0,117,22,0,139,243,28,410
1131517,0,0,0,83,33,6,122,215,18,355
1131518,3,0,3,88,18,9,115,191,30,336
1131519,0,0,0,65,12,4,81,142,22,245
1131520,0,0,0,125,23,0,148,251,66,465
1131521,0,0,0,74,4,0,78,184,21,283
1131522,4,0,4,83,15,3,101,233,34,368
1131523,0,0,0,97,26,0,123,271,35,429
1131524,0,0,0,75,29,3,107,251,17,375
1131525,4,0,4,71,29,0,100,223,13,336
1131526,0,0,0,41,3,3,47,125,12,184
1131527,0,0,0,80,23,3,106,182,9,297
1131528,3,0,3,63,9,3,75,201,18,294
1131529,0,3,3,108,15,4,127,192,21,340
1131530,0,0,0,83,14,3,100,208,6,314
1131531,0,0,0,69,4,3,76,113,6,195
1131532,3,0,3,90,26,0,116,167,7,290
1131533,0,0,0,98,38,6,142,220,17,379
1131534,0,0,0,64,9,0,73,107,23,203
1131535,0,0,0,108,33,0,141,264,32,437
1131536,23,3,29,52,16,0,68,176,18,262
1131537,0,0,0,134,27,0,161,254,21,436
1131538,3,0,3,62,18,3,83,171,12,266
1131539,0,0,0,94,21,3,118,207,18,343
1131540,3,0,3,82,22,0,104,172,26,302
1131541,0,0,0,66,5,3,74,160,15,249
1131542,0,0,0,91,22,4,117,170,31,318
1131543,0,0,0,101,22,12,135,218,8,361
1131544,10,3,13,121,16,0,137,280,31,448
1131545,0,5,5,57,12,6,75,182,26,283
1131546,0,0,0,88,24,0,112,185,39,336
1131601,0,0,0,0,0,0,0,0,0,0
1131602,0,0,0,31,15,0,46,76,19,141
1131603,0,0,0,32,15,0,47,96,16,159
1131604,0,0,0,322,73,15,410,675,40,1125
1131605,3,0,3,80,24,3,107,233,32,372
1131606,0,0,0,58,30,9,97,181,44,322
1131607,0,0,0,48,18,5,71,162,31,264
1131608,0,0,0,38,28,9,75,135,22,232
1131609,0,0,0,33,10,6,49,116,23,188
1131610,0,0,0,70,14,6,90,188,35,313
1131611,0,0,0,49,21,3,73,164,27,264
1131612,0,0,0,54,12,0,66,125,18,209
1131613,5,0,5,57,29,0,86,230,34,350
1131614,0,0,0,34,26,4,64,137,14,215
1131615,0,0,0,45,28,3,76,176,26,278
1131616,0,0,0,53,11,0,64,124,18,206
1131617,6,0,6,70,32,6,108,245,56,409
1131618,0,0,0,45,8,3,56,149,45,250
1131619,0,0,0,45,20,0,65,131,29,225
1131620,0,0,0,49,23,0,72,147,46,265
1131621,3,0,3,45,15,0,60,133,34,227
1131622,0,0,0,57,24,4,85,156,34,275
1131623,3,0,3,100,39,0,139,302,16,457
1131624,0,0,0,57,21,3,81,158,29,268
1131625,0,0,0,43,16,0,59,129,52,240
1131626,0,0,0,56,41,4,101,141,40,282
1131627,0,0,0,41,12,6,59,119,26,204
1131628,0,0,0,37,15,3,55,119,28,202
1131629,3,0,3,37,13,0,50,150,30,230
1131630,6,0,6,66,20,0,86,185,57,328
1131631,0,0,0,52,31,0,83,138,33,254
1131632,6,0,6,64,26,3,93,203,72,368
1131633,0,3,3,43,25,3,71,171,38,280
1131634,6,3,9,80,32,0,112,250,54,416
1131635,0,0,0,26,10,0,36,75,19,130
1131636,0,3,3,60,15,0,75,220,62,357
1131637,0,0,0,0,0,0,0,0,0,0
1131638,0,0,0,49,45,4,98,216,42,356
1131639,3,0,3,63,19,3,85,218,43,346
1131640,0,0,0,84,28,0,112,222,44,378
1131641,3,0,3,57,22,3,82,174,41,297
1131701,0,0,0,0,0,0,0,3,0,3
1131702,6,3,9,78,19,0,97,275,41,413
1131703,4,0,4,72,21,3,96,246,29,371
1131704,3,0,3,187,15,0,202,463,72,737
1131705,0,0,0,47,21,0,68,161,21,250
1131706,3,0,3,62,27,3,92,198,34,324
1131707,6,0,6,84,27,4,115,263,36,414
1131708,3,0,3,62,30,3,95,171,45,311
1131709,3,0,3,58,25,6,89,262,53,404
1131710,3,0,3,80,27,0,107,234,40,381
1131711,6,0,6,93,24,3,120,274,47,441
1131712,3,0,3,61,24,0,85,153,21,259
1131713,0,0,0,0,0,0,0,6,6,12
1131714,0,0,0,49,19,3,71,179,48,298
1131715,0,0,0,62,16,0,78,230,30,338
1131716,0,0,0,0,0,0,0,0,0,0
1131717,9,0,9,85,20,3,108,361,46,515
1131718,4,3,10,60,24,0,84,210,29,323
1131719,0,0,0,84,16,0,100,269,23,392
1131720,5,0,5,87,26,0,113,272,40,425
1131721,3,0,3,70,19,3,92,263,47,402
1131722,5,0,5,103,39,6,148,308,45,501
1131723,0,0,0,31,12,3,46,114,16,176
1131724,0,0,3,46,21,0,67,158,15,240
1131725,3,3,6,47,19,0,66,192,50,308
1131726,3,0,3,83,46,6,135,265,44,444
1131727,3,0,3,49,17,0,66,132,21,219
1131728,7,0,7,62,30,4,96,203,21,320
1131729,3,3,6,40,23,0,63,172,34,269
1131730,0,0,0,84,12,3,99,212,23,334
1131731,4,7,11,66,32,15,113,250,37,400
1131732,4,0,4,49,17,7,73,168,33,274
1131733,3,3,6,53,38,3,94,297,47,438
1131734,0,0,0,103,15,0,118,209,43,370
1131735,3,3,6,146,16,3,165,241,37,443
1131736,0,0,0,71,22,6,99,165,21,285
1131737,0,0,0,99,13,0,112,154,18,284
1131738,0,0,0,88,10,0,98,189,6,293
1131739,0,0,0,101,24,3,128,254,20,402
1131740,5,0,5,120,17,0,137,260,26,423
1131741,0,0,0,125,12,0,137,328,46,511
1131742,0,0,0,101,16,3,120,241,37,398
1131743,0,0,0,123,15,6,144,325,48,517
1131744,0,0,0,105,4,3,112,179,32,323
1131745,0,0,0,140,26,9,175,318,33,526
1131746,0,0,0,99,18,0,117,206,23,346
1131801,0,0,0,0,0,0,0,12,0,12
1131802,0,0,0,0,0,0,0,0,6,6
1131803,0,0,0,0,0,0,0,0,0,0
1131901,3,0,3,55,21,4,80,186,13,279
1131902,0,0,0,60,18,0,78,182,9,269
1131903,0,0,0,72,20,0,92,156,7,255
1131904,0,0,0,30,21,0,51,121,7,179
1131905,0,0,0,60,11,3,74,217,22,313
1131906,0,0,0,63,18,0,81,144,22,247
1131907,4,0,4,57,21,3,81,177,20,278
1131908,6,0,6,70,15,0,85,224,30,339
1131909,0,0,0,108,23,0,131,255,23,409
1131910,0,0,0,0,0,0,0,10,0,10
1131911,0,0,0,3,0,0,3,0,3,6
1131912,6,0,6,57,13,0,70,166,15,251
1131913,43,0,43,146,21,3,170,308,33,511
1131914,0,0,0,122,22,0,144,290,24,458
1131915,4,0,4,60,43,3,106,224,21,351
1131916,0,0,0,86,29,3,118,200,28,346
1131917,4,3,7,89,34,7,130,238,25,393
1131918,8,0,8,58,35,3,96,250,15,361
1131919,3,43,46,36,9,0,45,102,108,255
1131920,0,0,0,6,0,0,6,9,3,18
1131921,3,0,3,89,45,0,134,332,45,511
1131922,10,0,10,72,39,3,114,335,67,516
1131923,3,0,3,64,38,9,111,230,17,358
1131924,6,0,6,58,24,0,82,174,24,280
1131925,6,6,12,55,29,3,87,167,39,293
1131926,4,0,4,55,16,0,71,148,13,232
1131927,0,0,0,56,12,4,72,151,21,244
1131928,7,0,7,112,27,0,139,321,44,504
1131929,0,0,0,81,30,7,118,284,28,430
1131930,3,3,6,62,17,0,79,157,12,248
1131931,0,0,0,130,15,3,148,331,22,501
1131932,183,0,183,62,17,6,85,492,31,608
1131933,6,0,6,48,30,3,81,220,21,322
1131934,0,0,0,66,38,3,107,212,21,340
1131935,3,0,3,112,39,6,157,243,14,414
1131936,0,0,0,51,20,6,77,177,6,260
1131937,3,0,3,118,16,7,141,294,31,466
1131938,4,0,4,65,20,0,85,177,16,278
1131939,0,0,0,72,15,0,87,203,28,318
1131940,0,0,0,60,20,0,80,206,32,318
1131941,0,0,0,68,18,3,89,229,28,346
1131942,0,0,0,63,19,3,85,176,19,280
1131943,0,0,0,59,18,7,84,108,23,215
1131944,0,0,0,64,16,0,80,128,16,224
1131945,3,0,3,87,5,0,92,136,15,243
1131946,0,0,0,84,18,0,102,276,28,406
1131947,0,0,0,61,15,0,76,152,14,242
1131948,0,3,3,93,34,6,133,231,45,409
1132001,0,0,0,0,3,0,3,6,0,9
1132002,0,0,0,0,0,0,0,4,0,4
1132003,0,0,0,0,0,0,0,0,0,0
1132101,6,0,6,169,48,10,227,360,26,613
1132102,0,0,0,46,7,0,53,119,21,193
1132103,6,4,10,84,25,9,118,153,10,281
1132104,6,0,9,120,35,4,159,220,7,386
1132105,6,0,6,61,23,0,84,204,28,316
1132106,6,0,6,76,30,9,115,302,27,444
1132107,4,0,4,152,31,6,189,339,34,562
1132108,6,3,9,81,37,0,118,237,24,379
1132109,0,0,0,78,21,9,108,175,20,303
1132110,3,0,3,58,9,7,74,169,3,246
1132111,3,0,3,142,28,3,173,253,51,477
1132112,6,0,6,78,38,0,116,205,32,353
1132113,3,0,3,75,27,4,106,228,14,348
1132114,4,0,4,84,29,3,116,238,37,391
1132115,73,0,73,48,14,0,62,282,28,372
1132116,0,0,0,45,31,3,79,202,53,334
1132117,0,3,3,43,12,4,59,90,23,172
1132118,6,0,6,58,18,6,82,182,35,299
1132119,6,0,6,165,18,0,183,279,18,480
1132120,0,0,0,5,0,0,5,3,0,8
1132121,0,0,0,0,0,0,0,0,0,0
1132122,0,0,0,0,0,0,0,0,0,0
1132123,0,0,0,0,0,0,0,4,0,4
1132201,0,0,0,87,23,0,110,247,24,381
1132202,3,0,3,40,12,0,52,216,19,287
1132203,8,6,14,69,29,0,98,251,27,376
1132204,6,0,6,56,3,0,59,160,21,240
1132205,4,0,4,57,21,0,78,210,30,318
1132206,4,0,4,45,5,0,50,190,32,272
1132207,0,3,3,38,14,0,52,112,24,188
1132208,4,0,4,55,19,0,74,176,22,272
1132209,4,0,4,65,17,0,82,336,62,480
1132210,3,3,9,58,23,3,84,184,25,293
1132211,0,0,0,89,29,3,121,268,24,413
1132212,3,0,3,42,10,6,58,153,15,226
1132213,6,0,6,66,40,6,112,215,14,341
1132214,3,0,3,33,9,0,42,135,19,196
1132215,0,0,0,85,26,7,118,301,25,444
1132216,4,0,4,101,24,0,125,450,41,616
1132217,0,0,0,0,0,0,0,0,0,0
1132218,4,3,7,63,24,3,90,320,30,440
1132219,3,0,3,157,35,0,192,1118,119,1429
1132220,15,0,15,6,10,0,16,148,29,193
1132221,3,0,3,120,23,0,143,250,49,442
1132222,0,0,0,53,4,0,57,180,18,255
1132223,0,0,0,82,3,0,85,183,27,295
1132224,8,0,8,37,12,0,49,251,57,357
1132225,3,0,7,31,21,0,52,130,13,195
1132226,4,3,7,51,21,6,78,112,12,202
1132227,8,3,11,98,47,0,145,350,43,538
1132228,13,0,13,56,24,0,80,188,18,286
1132229,3,0,3,74,18,3,95,235,15,345
1132230,5,3,8,45,3,0,48,162,40,250
1132231,4,0,4,95,18,0,113,254,45,412
1132232,16,0,16,37,21,0,58,277,69,404
1132233,6,0,6,77,5,0,82,194,31,307
1132234,0,0,0,101,14,0,115,265,54,434
1132235,6,6,12,80,16,9,105,245,41,391
1132236,10,0,10,73,23,0,96,297,33,426
1132237,7,0,7,74,24,0,98,222,12,332
1132238,6,0,6,60,20,3,83,258,30,371
1132239,0,0,0,82,41,0,123,226,32,381
1132240,3,0,3,56,11,5,72,248,45,365
1132241,3,3,6,64,35,0,99,236,63,398
1132242,6,0,6,53,16,0,69,247,39,355
1132243,4,3,7,51,9,0,60,110,21,191
1132244,6,3,9,96,25,0,121,233,9,363
1132245,3,0,3,34,20,0,54,184,17,255
1132246,0,3,3,36,17,3,56,174,24,254
1132247,6,3,9,53,30,0,83,170,27,280
1132248,0,0,0,0,0,0,0,0,0,0
1132301,5,0,5,44,21,3,68,204,15,287
1132302,8,0,8,55,21,0,76,121,8,205
1132303,12,6,18,58,34,0,92,257,32,381
1132304,9,0,9,53,13,3,69,194,20,283
1132305,5,3,8,79,40,3,122,255,63,440
1132306,16,8,24,30,25,3,58,331,62,451
1132307,4,0,4,40,16,0,56,120,6,182
1132308,51,8,59,30,12,0,42,280,79,401
1132309,3,0,3,71,14,0,85,249,32,366
1132310,3,0,3,71,8,0,79,217,23,319
1132311,0,0,0,61,11,0,72,219,19,310
1132312,4,0,4,58,10,0,68,195,14,277
1132313,3,0,3,81,15,3,99,216,16,331
1132314,4,0,4,70,19,3,92,228,28,348
1132315,9,3,12,58,22,4,84,187,15,286
1132316,3,0,3,85,9,0,94,161,11,266
1132317,11,0,11,89,17,0,106,264,27,397
1132318,6,0,6,38,6,9,53,131,13,197
1132319,17,0,17,51,24,0,75,190,5,270
1132320,13,3,16,79,19,0,98,281,29,408
1132321,0,0,0,0,0,0,0,0,0,0
1132322,3,0,3,69,12,0,81,275,13,369
1132323,4,4,8,51,12,4,67,229,30,326
1132324,0,0,0,0,0,0,0,0,0,0
1132325,0,0,0,67,21,0,88,250,26,364
1132326,0,0,0,43,18,3,64,186,13,263
1132327,4,0,4,106,15,5,126,289,25,440
1132328,6,0,6,86,18,0,104,221,44,369
1132329,5,0,5,44,30,0,74,115,7,196
1132401,0,0,0,0,0,0,0,3,0,3
1132501,0,0,0,0,0,0,0,3,0,3
1132601,3,0,3,39,14,0,53,210,33,296
1132602,4,3,7,60,31,0,91,223,41,355
1132603,3,0,3,41,3,0,44,138,8,190
1132604,4,11,15,55,25,8,88,198,43,329
1132605,3,0,6,56,23,0,79,258,36,373
1132606,3,0,3,71,9,3,83,333,41,457
1132607,6,0,6,114,36,5,155,265,50,470
1132608,3,0,3,64,13,0,77,283,41,401
1132609,0,0,0,76,9,0,85,260,46,391
1132610,6,0,6,73,11,4,88,284,41,413
1132611,4,0,4,87,38,3,128,353,34,515
1132612,6,0,6,57,18,0,75,200,40,315
1132613,0,0,0,64,20,6,90,207,15,312
1132614,3,0,3,40,22,0,62,209,34,305
1132615,26,0,26,51,19,0,70,291,33,394
1132616,5,0,5,69,20,0,89,303,30,422
1132617,0,0,0,52,6,0,58,205,33,296
1132618,22,9,31,57,27,0,84,245,31,360
1132619,3,0,3,66,28,3,97,246,24,367
1132620,8,3,11,94,35,6,135,280,41,456
1132621,4,0,4,45,6,0,51,183,15,249
1132622,3,0,3,95,24,4,123,269,21,413
1132623,3,0,3,88,23,7,118,477,29,624
1132624,7,0,7,46,24,0,70,206,33,309
1132625,3,3,6,59,24,3,86,194,28,308
1132626,0,0,0,32,15,0,47,174,20,241
1132627,0,0,0,74,15,3,92,199,42,333
1132628,5,0,5,64,18,3,85,258,41,384
1132629,6,6,12,75,30,3,108,256,43,407
1132630,3,0,3,67,14,6,87,246,43,376
1132631,0,0,0,29,27,0,56,179,26,261
1132632,3,3,6,93,21,6,120,225,19,364
1132633,0,0,0,68,21,0,89,257,41,387
1132634,0,0,0,31,15,0,46,138,3,187
1132635,0,0,0,32,15,0,47,165,6,218
1132636,6,3,9,32,18,0,50,176,19,245
1132637,3,0,3,47,26,5,78,179,15,272
1132638,4,0,4,55,16,7,78,215,25,318
1132639,0,0,0,32,18,0,50,178,19,247
1132640,3,0,3,54,15,4,73,195,21,289
1132641,0,0,0,17,6,3,26,119,18,163
1132642,0,0,0,38,9,0,47,149,12,208
1132643,3,0,3,64,12,14,90,211,26,327
1132644,6,3,9,61,24,0,85,282,16,383
1132645,4,0,4,57,22,4,83,171,17,271
1132646,0,3,3,17,9,3,29,122,27,178
1132647,3,0,3,74,24,3,101,290,51,442
1132648,4,0,4,73,28,0,101,305,45,451
1132649,49,0,49,51,9,0,60,287,13,360
1132650,53,3,56,42,13,0,55,270,16,341
1132651,6,0,6,91,40,0,131,282,35,448
1132652,8,6,14,67,26,3,96,345,47,488
1132653,0,0,0,53,24,4,81,346,45,472
1132654,0,0,0,35,12,3,50,152,12,214
1132655,0,0,0,48,12,3,63,189,48,300
1132656,0,0,0,50,21,0,71,241,43,355
1132657,6,0,9,62,21,3,86,210,15,311
1132658,0,0,0,0,0,0,0,26,0,26
1132659,6,0,6,75,15,0,90,209,23,322
1132660,0,0,0,37,18,3,58,149,25,232
1132661,0,5,5,65,18,4,87,225,9,321
1132662,0,0,0,57,21,0,78,351,27,456
1132701,4,3,7,76,26,0,102,172,22,296
1132702,0,0,0,52,26,0,78,222,21,321
1132703,0,0,0,44,13,0,57,231,34,322
1132704,3,0,3,83,14,0,97,248,12,357
1132705,3,0,3,48,16,0,64,254,6,324
1132706,6,0,6,67,33,8,108,380,28,516
1132707,0,6,6,76,24,11,111,266,32,409
1132708,0,3,3,83,22,0,105,285,51,441
1132709,3,0,3,39,29,0,68,304,50,422
1132710,0,0,0,79,10,7,96,192,20,308
1132711,3,0,3,73,23,3,99,300,30,429
1132712,0,0,0,46,4,0,50,122,12,184
1132713,12,0,12,83,25,0,108,265,27,400
1132714,9,0,9,36,19,0,55,349,21,425
1132715,6,0,6,43,12,4,59,167,15,241
1132716,3,0,3,78,19,0,97,228,15,340
1132717,3,0,3,22,6,0,28,127,14,169
1132718,3,3,6,116,15,4,135,227,53,415
1132719,5,0,5,59,15,3,77,199,44,320
1132720,0,0,0,50,13,0,63,155,18,236
1132721,0,0,0,30,16,6,52,212,37,301
1132722,6,0,6,62,5,3,70,148,9,227
1132723,3,0,3,47,14,0,61,269,10,340
1132724,0,0,0,47,23,6,76,185,3,264
1132725,17,0,17,51,26,0,77,431,29,537
1132726,0,0,0,38,7,0,45,129,13,187
1132727,0,0,0,22,7,3,32,157,17,206
1132728,6,0,6,36,19,0,55,188,17,260
1132729,0,0,0,68,18,4,90,235,33,358
1132730,3,0,3,41,20,6,67,152,30,249
1132731,0,0,0,49,24,3,76,215,25,316
1132732,3,0,3,66,11,3,80,256,10,346
1132733,6,0,6,71,16,0,87,241,34,362
1132734,3,3,6,51,15,3,69,243,35,347
1132735,6,0,6,39,18,0,57,189,3,249
1132736,6,0,6,44,18,0,62,157,24,243
1132737,4,0,4,62,17,6,85,298,34,417
1132738,3,0,3,52,23,3,78,329,43,450
1132739,3,0,3,53,13,3,69,243,40,352
1132740,3,0,3,28,6,4,38,196,36,270
1132741,3,0,3,21,14,0,35,139,17,191
1132742,3,0,3,50,19,5,74,267,10,351
1132743,6,0,9,47,19,0,66,228,16,310
1132744,0,0,0,35,7,0,42,127,30,199
1132745,3,0,3,28,20,0,48,196,65,309
1132746,3,0,3,26,9,3,38,176,10,224
1132747,4,0,4,35,10,0,45,214,107,366
1132748,0,0,0,43,16,0,59,204,30,293
1132749,0,0,0,64,19,0,83,263,46,392
1132750,0,0,0,57,19,0,76,244,22,342
1132801,8,3,11,60,24,0,84,284,31,399
1132802,6,0,6,56,21,0,77,235,34,346
1132803,0,0,0,25,0,0,25,140,34,199
1132804,0,0,0,28,13,0,41,151,24,216
1132805,0,4,4,3,0,0,3,14,22,39
1132806,0,0,0,37,11,0,48,194,26,268
1132807,3,3,6,84,26,3,113,287,63,463
1132808,3,3,6,52,13,3,68,173,24,265
1132809,3,6,9,43,18,0,61,96,15,172
1132810,3,0,3,85,30,9,124,258,33,415
1132811,0,3,3,81,15,7,103,269,37,409
1132812,3,0,3,44,13,0,57,225,16,298
1132813,0,0,0,0,0,0,0,3,3,6
1132814,0,0,0,53,12,0,65,164,31,260
1132815,0,0,0,39,16,0,55,176,29,260
1132816,0,0,0,0,0,0,0,0,0,0
1132817,6,0,6,74,28,0,102,266,66,434
1132818,0,0,0,29,9,3,41,183,15,239
1132819,6,0,6,42,10,0,52,199,25,276
1132820,0,0,0,42,15,0,57,276,24,357
1132821,3,0,3,74,33,0,107,296,53,456
1132822,7,0,7,53,24,6,83,258,27,368
1132901,0,0,0,19,16,0,35,250,27,312
1132902,0,0,0,0,0,0,0,3,11,14
1132903,4,0,4,18,10,0,28,418,121,567
1132904,0,0,0,16,6,0,22,228,20,270
1132905,3,0,3,8,8,0,16,312,40,368
1132906,3,7,10,25,9,3,37,167,50,254
1132907,4,0,4,8,6,0,14,289,75,378
1132908,0,0,0,10,7,0,17,247,64,328
1132909,0,0,0,9,4,0,13,572,122,707
1132910,0,0,0,15,18,0,33,282,66,381
1132911,0,0,0,12,3,0,15,143,38,196
1132912,0,0,0,20,17,3,40,251,45,336
1132913,0,0,0,38,24,0,62,264,15,341
1132914,0,0,0,33,11,7,51,280,18,349
1132915,0,0,0,3,3,0,6,102,58,166
1132916,0,0,0,9,12,0,21,178,23,222
1132917,4,0,4,12,19,0,31,310,54,395
1132918,6,0,6,11,6,0,17,265,25,307
1132919,0,0,0,27,21,0,48,341,50,439
1132920,5,0,5,16,3,0,19,240,45,304
1132921,0,0,0,14,18,0,32,403,70,505
1132922,0,0,0,25,16,0,41,320,35,396
1132923,3,0,3,18,4,0,22,192,56,270
1132924,0,0,0,20,13,0,33,286,39,358
1132925,0,0,0,18,9,0,27,165,38,230
1132926,0,0,0,62,21,0,83,280,72,435
1132927,3,0,3,13,18,0,31,417,66,514
1132928,0,0,0,6,8,0,14,223,55,292
1133001,0,0,0,30,10,4,44,260,4,308
1133002,0,0,0,75,36,0,111,581,14,706
1133003,4,3,7,53,12,8,73,300,37,410
1133004,0,0,0,58,10,0,68,323,17,408
1133005,0,0,0,48,3,3,54,123,6,183
1133006,4,0,4,78,21,0,99,218,30,347
1133007,0,0,0,46,10,6,62,230,32,324
1133008,4,0,4,90,10,6,106,295,52,453
1133009,0,0,0,18,15,3,36,357,90,483
1133010,0,0,0,76,28,0,104,322,7,433
1133011,3,0,3,38,19,0,57,361,45,463
1133012,4,0,4,117,37,6,160,418,50,628
1133013,0,0,0,6,12,0,18,259,15,292
1133014,0,0,0,0,4,0,4,0,0,4
1133015,6,0,6,38,10,0,48,280,17,345
1133016,0,0,0,77,22,3,102,345,37,484
1133017,0,0,0,59,9,6,74,179,3,256
1133018,0,0,0,3,9,0,12,17,3,32
1133019,0,3,3,69,15,3,87,465,25,577
1133020,0,0,0,0,0,0,0,0,0,0
1133021,0,0,0,26,10,0,36,214,3,253
1133022,0,0,0,28,4,0,32,193,25,250
1133023,0,3,3,27,10,0,37,184,35,256
1133024,0,0,0,50,31,0,81,579,31,691
1133025,6,3,9,97,23,7,127,417,33,577
1133026,3,3,6,78,18,11,107,281,15,403
1133027,0,0,0,40,18,3,61,271,24,356
1133028,0,0,0,86,27,4,117,349,9,475
1133029,0,0,0,45,24,6,75,299,39,413
1133030,0,0,0,70,22,7,99,301,27,427
1133031,0,0,0,63,23,3,89,516,18,623
1133032,0,0,0,72,20,0,92,449,14,555
1133101,0,0,0,0,0,0,0,0,0,0
1133102,3,0,3,38,12,0,50,164,30,244
1133103,0,0,0,41,18,0,59,338,35,432
1133104,0,0,0,55,43,6,104,804,123,1031
1133105,0,0,0,40,15,0,55,231,26,312
1133106,6,0,6,19,18,0,37,217,78,332
1133107,0,0,0,14,10,0,24,195,60,279
1133108,7,0,7,35,23,0,58,221,51,330
1133109,0,0,0,30,18,3,51,210,39,300
1133110,0,0,0,11,17,0,28,184,18,230
1133111,0,0,0,50,10,3,63,312,41,416
1133112,3,0,3,36,9,3,48,196,14,258
1133113,4,0,4,26,13,0,39,300,34,373
1133114,3,0,3,26,26,0,52,284,31,367
1133115,0,0,0,21,10,0,31,293,52,376
1133116,3,0,3,36,31,0,67,291,13,371
1133117,3,3,6,50,19,4,73,370,56,499
1133118,6,0,6,36,21,6,63,353,22,438
1133119,3,3,9,49,23,0,72,270,50,392
1133120,3,3,6,56,25,3,84,277,36,397
1133121,0,0,0,56,21,3,80,228,17,325
1133122,3,3,6,34,15,0,49,177,25,251
1133123,0,0,0,45,15,0,60,272,45,377
1133124,0,0,0,90,24,3,117,327,25,469
1133125,0,0,0,39,9,0,48,215,13,276
1133126,0,0,0,37,19,3,59,419,40,518
1133127,0,0,0,44,13,9,66,269,54,389
1133128,0,0,0,0,0,0,0,0,0,0
1133129,0,0,0,10,9,0,19,181,25,225
1133130,3,4,7,28,17,0,45,366,94,505
1133131,9,0,9,41,22,6,69,329,52,450
1133132,0,0,0,32,19,3,54,273,41,368
1133133,3,3,6,17,29,0,46,351,77,474
1133134,3,3,6,23,22,0,45,248,63,356
1133135,8,0,8,50,17,3,70,217,28,315
1133136,5,0,5,39,14,3,56,273,21,350
1133137,3,3,6,33,15,4,52,177,62,291
1133138,0,0,0,34,25,0,59,192,21,272
1133139,0,0,0,48,9,0,57,278,19,354
1133140,6,3,9,47,11,0,58,245,27,330
1133141,0,0,0,27,10,5,42,272,38,352
1133142,17,0,17,37,21,0,58,282,23,363
1133201,0,0,0,24,9,0,33,303,62,398
1133202,7,0,7,21,46,3,70,912,159,1141
1133203,0,0,0,0,0,0,0,0,0,0
1133204,0,0,0,35,21,0,56,372,17,445
1133205,0,0,0,21,30,6,57,313,42,412
1133206,0,3,3,70,12,9,91,365,28,484
1133207,0,0,0,41,12,6,59,213,21,293
1133208,3,0,3,44,19,10,73,331,34,438
1133209,0,0,0,31,10,3,44,278,29,351
1133210,0,0,0,31,12,0,43,184,16,243
1133211,3,3,6,15,8,0,23,264,42,329
1133212,0,0,0,40,14,3,57,285,16,358
1133213,0,0,0,46,26,9,81,179,14,274
1133214,0,0,0,0,10,3,13,271,176,460
1133215,4,0,4,38,13,0,51,179,28,258
1133216,0,0,0,24,21,3,48,237,34,319
1133217,0,0,0,26,12,0,38,300,22,360
1133218,0,0,0,35,15,4,54,176,29,259
1133219,0,0,0,52,14,0,66,232,12,310
1133220,0,0,0,63,23,9,95,263,37,395
1133221,0,0,0,46,23,0,69,191,25,285
1133222,3,3,6,47,10,6,63,334,50,447
1133223,0,0,0,46,15,0,61,348,65,474
1133224,3,0,3,60,24,6,90,335,65,490
1133225,0,0,0,48,11,6,65,173,15,253
1133226,3,0,3,68,21,3,92,299,36,427
1133227,6,0,6,40,15,0,55,357,67,479
1133228,0,3,3,45,11,9,65,241,35,341
1133229,5,0,5,49,18,3,70,253,9,332
1133230,3,3,6,41,9,0,50,289,58,397
1133231,8,0,8,47,15,6,68,220,7,295
1133232,0,0,0,31,20,0,51,340,50,441
1133233,0,0,0,23,18,0,41,189,24,254
1133234,0,0,0,63,30,5,98,327,38,463
1133235,3,0,3,55,21,9,85,246,26,357
1133236,3,0,6,77,18,0,95,267,55,417
1133237,3,0,3,40,9,3,52,204,38,294
1133238,3,0,3,55,9,0,64,218,14,296
1133239,6,0,6,36,7,0,43,238,39,320
1133240,3,0,3,47,17,3,67,494,44,605
1133241,0,0,0,49,15,3,67,209,27,303
1133242,3,0,3,35,12,0,47,216,41,304
1133243,0,0,0,62,21,0,83,298,12,393
1133244,0,0,0,25,12,0,37,249,39,325
1133245,0,0,0,44,24,3,71,326,33,430
1133246,0,0,0,36,15,0,51,161,14,226
1133247,0,0,0,53,21,6,80,255,15,350
1133248,0,0,0,19,22,0,41,334,29,404
1133249,3,0,6,55,21,0,76,445,43,564
1133250,3,0,3,49,14,0,63,270,45,378
1133251,3,0,3,14,15,0,29,290,32,351
1133252,4,0,4,48,15,0,63,227,45,335
1133301,0,0,0,0,0,0,0,83,12,95
1133302,5,0,5,20,13,0,33,223,30,286
1133303,3,0,3,3,14,0,17,169,38,224
1133304,0,0,0,6,9,3,18,162,59,239
1133305,4,0,4,22,25,0,47,427,135,609
1133306,0,0,0,22,15,0,37,398,105,540
1133307,0,0,0,15,12,0,27,385,121,533
1133308,3,0,3,9,4,0,13,253,59,325
1133309,3,0,3,6,6,0,12,155,60,227
1133310,0,0,0,26,20,0,46,352,99,497
1133311,6,3,9,10,4,0,14,236,91,341
1133312,0,0,0,7,8,0,15,263,19,297
1133313,0,0,0,19,14,0,33,376,86,495
1133314,3,0,3,35,22,0,57,391,34,482
1133315,3,0,3,5,15,0,20,178,21,219
1133316,3,0,3,3,15,0,18,166,29,213
1133317,0,0,0,13,3,3,19,331,49,399
1133318,0,0,0,21,17,0,38,260,16,314
1133319,3,0,3,15,18,0,33,267,55,355
1133320,0,0,0,29,4,0,33,373,113,519
1133321,0,0,0,12,9,0,21,191,89,301
1133322,0,0,0,20,9,6,35,263,55,353
1133323,3,0,3,26,10,0,36,225,50,311
1133324,0,0,0,18,11,0,29,262,65,356
1133325,0,0,0,29,26,0,55,256,60,371
1133326,0,0,0,10,14,0,24,200,61,285
1133327,0,0,0,9,3,0,12,80,24,116
1133328,0,0,3,22,12,0,34,111,44,189
1133329,17,4,21,42,29,0,71,331,27,429
1133330,4,0,4,16,12,0,28,238,6,272
1133331,0,0,0,34,21,0,55,349,34,438
1133332,3,0,6,16,15,3,34,107,23,164
1133333,3,0,3,35,25,0,60,237,81,378
1133334,3,3,6,27,7,0,34,290,53,377
1133335,0,3,3,20,11,0,31,129,28,188
1133336,3,0,3,9,10,0,19,249,107,375
1133337,50,0,50,10,0,0,10,193,11,214
1133338,4,0,4,19,19,0,38,379,31,448
1133339,6,0,6,10,15,0,25,225,22,272
1133340,0,3,3,25,12,0,37,273,74,384
1133341,0,0,0,27,16,0,43,239,62,344
1133342,0,0,0,23,13,0,36,294,48,378
1133343,8,5,13,22,12,0,34,347,39,420
1133344,6,3,9,19,11,0,30,191,46,267
1133345,13,0,13,47,24,0,71,445,50,566
1133346,0,4,4,12,18,0,30,269,99,398
1133347,34,105,139,15,9,0,24,391,201,616
1133348,0,0,0,21,31,0,52,339,90,481
1133349,4,0,4,23,3,0,26,274,24,324
1133401,0,0,0,11,20,0,31,115,7,153
1133402,0,0,0,49,20,0,69,400,82,551
1133403,0,3,3,59,22,0,81,403,90,574
1133404,0,0,0,33,3,0,36,231,36,303
1133405,0,0,0,9,8,0,17,258,53,328
1133406,0,3,3,42,7,0,49,279,88,416
1133407,3,0,3,56,20,0,76,607,103,786
1133408,0,0,0,39,15,0,54,293,79,426
1133409,0,0,0,21,7,0,28,303,43,374
1133410,0,0,0,23,22,0,45,367,46,458
1133411,0,0,0,43,12,0,55,276,27,358
1133412,3,0,3,104,38,3,145,458,55,658
1133413,0,0,0,50,12,0,62,253,42,357
1133414,0,0,0,0,0,0,0,0,0,0
1133415,6,0,6,97,36,0,133,733,90,956
1133416,0,0,0,40,46,4,90,314,32,436
1133417,0,0,0,91,41,3,135,408,49,592
1133418,0,0,0,54,16,0,70,558,33,661
1133419,0,0,0,55,21,0,76,221,21,318
1133420,0,0,0,12,3,3,18,79,12,109
1133421,8,0,8,61,13,3,77,272,31,380
1133422,3,0,3,48,15,0,63,213,47,323
1133423,0,0,0,29,9,0,38,311,32,381
1133424,0,0,0,9,7,0,16,426,147,589
1133425,0,0,0,16,14,0,30,251,92,373
1133426,0,0,0,23,15,0,38,635,177,850
1133427,0,0,0,22,6,0,28,466,111,605
1133428,0,0,0,25,4,0,29,472,107,608
1133429,8,3,11,17,6,3,26,238,45,309
1133430,0,0,0,43,14,0,57,348,86,491
1133431,3,3,6,56,11,0,67,373,54,494
1133432,3,0,3,54,7,0,61,317,100,478
1133433,0,0,0,11,9,0,20,144,19,183
1133434,3,0,3,52,21,0,73,452,79,604
1133435,0,0,0,33,18,0,51,391,356,798
1133436,0,0,0,35,13,0,48,241,33,322
1133437,3,0,3,8,5,0,13,90,0,103
1133438,0,0,0,61,3,0,64,266,177,507
1133439,0,0,0,4,7,0,11,53,15,79
1133501,4,0,4,37,8,0,45,255,51,351
1133502,0,0,0,53,20,0,73,271,81,425
1133503,0,0,0,40,28,0,68,522,30,620
1133504,0,0,0,14,15,0,29,156,18,203
1133505,3,6,9,38,19,3,60,378,27,465
1133506,3,0,3,42,12,3,57,250,23,330
1133507,0,4,4,46,21,3,70,278,70,418
1133508,0,0,0,0,0,0,0,0,0,0
1133509,0,0,0,31,3,0,34,177,18,229
1133510,0,3,3,25,19,0,44,354,52,450
1133511,0,0,0,17,9,3,29,209,18,256
1133512,0,0,0,3,3,0,6,103,67,176
1133513,0,0,0,15,12,0,27,459,67,553
1133514,0,0,0,24,16,0,40,343,45,428
1133515,3,0,3,16,6,0,22,232,42,296
1133516,3,0,3,32,12,0,44,409,31,484
1133517,3,0,3,17,3,0,20,249,33,302
1133518,4,0,4,25,13,3,41,376,88,505
1133519,3,0,3,19,12,3,34,280,55,369
1133520,0,0,0,3,0,0,3,126,11,140
1133521,3,0,3,52,13,0,65,307,96,468
1133522,3,0,3,27,12,3,42,246,52,340
1133523,0,0,0,18,18,0,36,274,39,349
1133524,0,0,0,0,0,0,0,0,0,0
1133525,0,3,3,25,19,3,47,246,59,352
1133526,0,0,0,25,15,0,40,248,51,339
1133527,26,13,39,16,22,0,38,457,141,636
1133528,0,0,0,16,3,0,19,216,57,292
1133529,3,3,6,19,0,4,23,166,33,222
1133530,0,0,0,15,4,0,19,181,43,243
1133531,10,7,17,36,22,3,61,447,94,602
1133532,3,0,3,45,18,0,63,373,90,526
1133533,4,0,4,52,8,0,60,314,57,431
1133534,3,0,3,33,21,0,54,286,163,503
1133535,0,0,0,35,13,0,48,606,76,730
1133536,0,0,0,34,18,0,52,312,50,414
1133537,3,4,7,25,12,0,37,252,46,335
1133538,10,5,15,3,16,0,19,228,143,390
1133539,0,6,6,23,16,0,39,207,42,288
1133540,5,6,11,32,18,0,50,229,39,318
1133541,9,0,9,29,13,0,42,272,17,331
1133542,0,3,3,44,27,6,77,321,20,418
1133601,0,0,0,0,0,0,0,0,0,0
1133602,0,0,0,30,9,0,39,262,39,340
1133603,3,0,3,20,12,0,32,305,36,373
1133604,3,3,6,46,25,0,71,498,49,618
1133605,3,0,3,36,21,0,57,289,37,383
1133606,3,0,3,29,11,5,45,395,49,489
1133607,0,3,3,33,12,0,45,366,41,452
1133608,0,0,0,22,10,0,32,345,30,407
1133609,34,18,52,19,20,0,39,471,179,689
1133610,3,0,3,16,15,0,31,327,45,403
1133611,0,0,0,10,18,0,28,244,70,342
1133612,0,6,6,7,6,0,13,292,86,391
1133613,110,0,110,18,7,0,25,410,78,513
1133614,3,0,3,27,13,0,40,300,31,371
1133615,0,0,0,11,11,0,22,269,20,311
1133616,0,0,0,37,15,0,52,424,53,529
1133617,3,3,6,22,0,3,25,314,76,415
1133618,3,0,3,17,14,0,31,282,100,413
1133619,7,6,13,10,10,0,20,333,85,438
1133620,0,3,3,0,11,0,11,360,147,518
1133621,0,0,0,22,9,0,31,483,31,545
1133622,6,3,9,20,10,3,33,291,96,420
1133623,0,0,0,9,6,0,15,182,38,235
1133624,3,3,6,13,12,0,25,146,20,191
1133625,0,0,0,34,13,0,47,360,66,473
1133626,0,0,0,37,11,0,48,248,24,320
1133627,3,0,3,22,16,0,38,419,312,769
1133628,0,0,0,32,18,0,50,436,34,520
1133629,0,0,0,25,6,3,34,255,10,299
1133630,0,0,0,26,18,0,44,269,52,365
1133631,3,4,7,36,16,0,52,215,11,278
1133632,3,0,3,40,15,3,58,192,17,267
1133633,0,0,0,22,4,0,26,299,31,356
1133634,0,0,0,47,21,4,72,263,90,425
1133635,0,0,0,14,15,0,29,195,20,244
1133636,0,4,4,36,20,3,59,367,36,462
1133701,3,0,3,19,0,0,19,381,95,495
1133702,0,0,0,4,0,0,4,100,28,132
1133703,0,3,3,54,15,0,69,846,177,1092
1133704,6,3,9,22,3,0,25,103,98,226
1133705,0,0,0,25,0,0,25,279,126,430
1133706,3,0,3,19,18,3,40,372,58,470
1133707,0,0,0,40,6,0,46,415,317,778
1133708,0,3,3,20,5,0,25,234,39,298
1133709,0,0,0,32,0,0,32,659,207,898
1133710,4,0,4,23,12,3,38,392,59,489
1133711,3,0,3,36,15,0,51,583,124,758
1133712,0,0,0,97,25,0,122,1411,331,1864
1133713,0,0,0,0,0,0,0,0,0,0
1133714,0,3,3,27,12,0,39,438,108,585
1133715,0,4,4,78,31,4,113,761,91,965
1133716,0,0,0,36,7,0,43,507,87,637
1133717,8,4,12,28,9,0,37,286,119,442
1133718,0,0,0,34,9,0,43,384,240,667
1133719,0,0,0,32,19,0,51,478,114,643
1133720,0,0,0,0,0,0,0,3,3,6
1133721,0,0,0,103,22,0,125,1083,162,1370
1133722,3,0,3,46,23,0,69,193,37,299
1133723,9,0,9,14,20,0,34,174,21,229
1133724,0,0,0,27,15,3,45,177,69,291
1133725,4,3,7,9,10,0,19,142,34,195
1133726,0,0,0,10,13,0,23,188,95,306
1133727,0,0,0,10,6,0,16,52,39,107
1133728,3,0,3,9,0,0,9,42,18,69
1133729,3,0,3,15,6,0,21,171,98,290
1133730,0,3,3,6,4,0,10,46,15,71
1133731,0,0,0,0,0,0,0,0,0,0
1133732,0,0,0,0,0,0,0,0,0,0
1133733,0,0,0,15,0,0,15,257,63,335
1133734,0,0,0,26,9,0,35,326,119,480
1133735,0,0,0,7,0,0,7,180,62,249
1133736,0,0,0,24,3,0,27,322,99,448
1133737,0,0,0,29,22,0,51,528,166,745
1133738,0,0,0,42,13,0,55,659,128,842
1133739,0,0,0,0,0,0,0,0,0,0
1133740,0,0,0,9,3,0,12,145,43,200
1133741,0,0,0,0,0,0,0,0,0,0
1133742,8,3,11,45,41,0,86,485,127,698
1133743,0,0,0,17,13,3,33,187,51,271
1133744,0,0,0,14,9,0,23,237,88,348
1133745,0,0,0,0,0,0,0,0,0,0
1133746,3,0,3,14,0,0,14,181,73,268
1133747,3,0,3,22,9,0,31,362,79,472
1133748,0,0,0,12,6,0,18,125,91,234
1133749,0,0,0,26,14,0,40,235,189,464
1133750,0,0,0,0,0,0,0,0,0,0
1133751,0,0,0,28,22,0,50,260,75,385
1133752,3,3,6,6,3,0,9,124,53,186
1133801,10,0,10,12,7,0,19,189,52,260
1133802,25,7,32,15,12,0,27,362,167,556
1133803,0,0,0,43,15,0,58,419,25,502
1133804,0,0,0,40,19,0,59,283,94,436
1133805,0,3,3,32,16,3,51,192,71,314
1133806,7,0,7,12,3,0,15,128,31,174
1133807,0,0,0,83,22,4,109,674,96,879
1133808,0,0,0,37,15,0,52,214,28,294
1133809,0,0,0,44,17,0,61,323,56,440
1133810,0,0,0,39,8,0,47,179,13,239
1133811,0,0,0,50,4,3,57,348,57,462
1133812,0,0,0,15,3,0,18,62,14,94
1133813,0,0,0,41,15,0,56,269,52,377
1133814,0,0,0,69,30,3,102,255,62,419
1133815,0,0,0,36,12,0,48,160,10,218
1133816,0,0,0,52,9,0,61,186,36,283
1133817,0,0,0,82,26,0,108,317,71,496
1133818,0,0,0,49,25,0,74,323,42,439
1133819,0,0,0,0,0,0,0,3,0,3
1133820,0,0,0,123,44,0,167,773,115,1055
1133821,5,3,8,72,33,0,105,207,34,346
1133822,0,0,0,39,12,0,51,444,119,614
1133823,0,0,0,81,21,3,105,703,101,909
1133824,7,3,10,82,29,6,117,245,26,388
1133825,6,0,9,309,65,3,377,933,288,1598
1133826,18,0,18,103,29,6,138,329,35,502
1133827,8,0,8,73,54,0,127,321,56,504
1133828,0,3,3,35,11,0,46,490,122,658
1133829,3,0,3,61,15,0,76,464,115,655
1133830,0,0,0,41,21,0,62,708,110,880
1133831,0,0,0,33,3,0,36,229,70,335
1133832,0,3,3,26,0,3,29,180,31,240
1133833,0,0,0,31,6,0,37,210,44,291
1133834,0,0,0,13,5,0,18,206,31,255
1133835,4,0,4,40,19,0,59,340,52,451
1133836,0,4,4,16,15,0,31,161,41,233
1133837,3,0,3,37,18,0,55,294,50,399
1133838,14,11,25,7,10,3,20,305,149,474
1133839,26,11,37,20,16,0,36,368,167,571
1133840,4,0,4,18,15,0,33,148,53,234
1133841,8,3,11,30,21,0,51,317,129,497
1133901,10,0,10,82,19,3,104,311,20,435
1133902,7,0,7,71,15,7,93,182,4,279
1133903,0,0,0,53,16,0,69,120,42,231
1133904,6,0,6,71,31,3,105,303,57,465
1133905,8,3,11,93,30,6,129,190,28,347
1133906,3,0,3,63,18,0,81,214,26,321
1133907,4,0,4,66,36,3,105,136,24,265
1133908,3,6,9,71,17,6,94,216,46,356
1133909,0,0,0,0,0,0,0,0,0,0
1133910,0,4,4,68,35,3,106,215,52,373
1133911,0,0,0,94,28,0,122,261,76,459
1133912,3,0,3,58,21,3,82,239,111,432
1133913,4,0,4,64,13,0,77,159,16,252
1133914,3,0,3,51,23,0,74,146,59,279
1133915,3,0,3,44,24,0,68,181,45,294
1133916,0,0,0,0,0,0,0,0,0,0
1133917,3,3,6,42,15,6,63,188,38,289
1133918,5,0,5,38,24,0,62,109,19,190
1133919,11,4,15,49,29,3,81,218,48,347
1133920,6,3,9,48,16,0,64,91,19,174
1133921,6,0,6,78,15,0,93,186,13,292
1133922,3,0,3,41,21,0,62,276,54,392
1133923,10,3,13,77,45,3,125,365,48,538
1133924,4,0,4,38,15,4,57,180,23,260
1133925,5,0,5,32,12,3,47,130,36,213
1133926,5,0,5,56,12,6,74,127,28,229
1133927,3,3,6,69,15,0,84,217,55,356
1133928,3,0,3,49,18,3,70,112,38,220
1133929,0,0,0,27,17,0,44,173,116,333
1133930,0,0,0,55,15,3,73,163,60,296
1133931,3,0,3,36,14,6,56,82,28,166
1133932,4,0,4,53,15,0,68,158,15,241
1133933,18,7,25,61,22,6,89,322,76,487
1133934,12,3,15,50,21,0,71,389,95,555
1133935,15,0,15,37,27,0,64,381,116,561
1133936,4,8,12,37,20,6,63,304,49,416
1133937,6,0,6,44,15,0,59,255,36,350
1133938,10,0,10,41,21,6,68,251,62,381
1133939,5,0,5,36,22,3,61,283,47,391
1133940,5,0,5,67,21,0,88,355,62,505
1133941,3,3,6,34,13,3,50,136,47,233
1133942,8,0,8,41,14,3,58,205,17,280
1133943,9,3,12,44,14,6,64,291,71,426
1133944,8,0,8,57,22,3,82,272,108,462
1133945,3,0,3,26,10,0,36,235,131,402
1133946,3,3,6,15,12,4,31,136,48,215
1133947,0,0,0,66,19,0,85,138,36,259
1134001,3,6,9,20,18,3,41,188,65,294
1134002,0,0,0,28,12,7,47,186,16,249
1134003,4,0,4,75,16,4,95,298,104,497
1134004,3,0,3,29,19,0,48,334,53,435
1134005,0,6,6,65,27,3,95,324,37,456
1134006,0,4,4,67,18,10,95,193,48,336
1134007,0,0,4,51,24,0,75,291,67,433
1134008,4,0,4,47,25,3,75,388,56,519
1134009,0,4,4,35,24,6,65,222,86,373
1134010,6,0,6,36,19,3,58,304,41,403
1134011,11,7,18,50,21,0,71,406,121,598
1134012,0,0,0,51,13,0,64,367,93,524
1134013,6,0,6,52,21,4,77,378,61,516
1134014,5,0,5,74,28,7,109,320,60,489
1134015,3,3,6,60,21,9,90,230,87,407
1134016,0,0,0,21,18,0,39,195,47,281
1134017,3,0,3,46,27,0,73,274,66,413
1134018,13,6,19,66,31,0,97,377,89,563
1134019,0,0,0,37,12,0,49,114,38,201
1134020,0,0,0,44,6,6,56,132,15,203
1134021,7,0,7,41,29,0,70,257,43,370
1134022,3,0,3,49,16,5,70,181,33,284
1134023,3,0,3,38,9,3,50,186,22,258
1134024,14,3,17,38,13,0,51,265,58,374
1134025,8,0,8,86,19,3,108,267,59,434
1134026,0,3,3,85,19,9,113,225,83,421
1134027,8,0,8,84,20,5,109,185,11,305
1134028,8,0,8,74,17,0,91,129,31,251
1134029,7,0,7,131,28,6,165,175,28,368
1134030,4,0,4,111,21,6,138,303,37,478
1134031,3,0,3,75,22,3,100,373,45,518
1134032,4,0,4,63,23,6,92,179,54,325
1134033,8,0,8,80,25,3,108,375,73,556
1134034,0,0,0,0,0,0,0,0,0,0
1134035,3,3,6,10,6,0,16,78,52,146
1134036,4,0,4,55,13,0,68,186,73,327
1134037,6,6,12,37,12,6,55,128,19,202
1134038,0,0,0,80,19,4,103,171,30,304
1134039,5,0,5,96,22,12,130,200,31,361
1134040,14,0,14,65,20,0,85,144,17,246
1134041,3,4,7,34,14,0,48,94,15,157
1134042,8,0,8,115,30,0,145,305,69,519
1134043,8,6,14,104,26,0,130,260,27,417
1134044,0,0,0,59,15,0,74,106,10,190
1134045,3,3,6,31,9,3,43,124,21,188
1134046,0,0,0,0,0,0,0,0,0,0
1134047,3,0,3,71,6,4,81,240,34,355
1134101,0,0,0,35,10,7,52,161,10,223
1134102,10,28,38,28,3,0,31,144,71,246
1134103,7,7,14,96,22,4,122,330,54,506
1134104,3,3,6,82,16,6,104,109,31,244
1134105,6,0,6,17,3,0,20,157,79,256
1134106,8,3,14,15,15,0,30,232,89,351
1134107,3,4,7,87,20,3,110,168,32,310
1134108,6,0,6,72,12,6,90,274,52,416
1134109,14,8,22,29,17,0,46,270,103,419
1134110,7,0,7,71,29,0,100,197,48,345
1134111,28,0,28,40,18,0,58,203,32,293
1134112,8,3,11,93,29,0,122,216,28,366
1134113,3,0,3,43,6,0,49,148,28,225
1134114,8,0,8,54,13,3,70,236,29,335
1134115,0,0,0,91,27,3,121,185,26,332
1134116,6,5,11,38,20,0,58,336,95,489
1134117,25,4,29,28,35,3,66,392,89,547
1134118,3,0,7,36,8,0,44,128,31,203
1134119,11,5,19,36,10,0,46,191,22,259
1134120,4,3,7,36,15,3,54,285,41,380
1134121,3,3,6,52,16,5,73,294,78,445
1134122,27,27,54,18,16,3,37,187,80,304
1134123,4,0,4,49,15,0,64,211,43,318
1134124,14,3,17,44,19,0,63,241,48,352
1134125,0,0,0,18,6,0,24,143,72,239
1134126,19,3,22,68,35,6,109,307,63,479
1134127,5,0,5,58,28,6,92,360,94,546
1134128,4,0,4,154,14,16,184,249,25,458
1134129,6,0,6,86,16,9,111,175,22,308
1134130,3,3,9,54,32,3,89,154,39,282
1134131,3,6,9,95,25,4,124,215,18,357
1134132,0,3,3,59,10,3,72,114,18,204
1134133,11,0,11,71,23,3,97,331,49,477
1134134,8,3,11,58,12,0,70,238,47,355
1134135,27,14,41,89,18,3,110,322,43,475
1134136,0,0,0,0,0,0,0,3,0,3
1134137,5,0,5,51,12,4,67,168,20,255
1134138,56,3,59,80,23,3,106,365,52,523
1134139,38,6,47,45,18,0,63,212,65,340
1134201,0,0,0,0,0,0,0,0,0,0
1134301,23,12,35,32,25,0,57,224,54,335
1134302,27,12,39,59,53,4,116,334,67,517
1134303,17,14,31,57,24,0,81,274,51,406
1134304,18,4,22,44,29,4,77,296,41,414
1134305,21,8,29,26,30,0,56,202,62,320
1134306,17,6,23,38,25,0,63,219,66,348
1134307,33,9,42,68,40,0,108,382,66,556
1134308,15,0,15,69,34,4,107,458,57,622
1134309,8,0,8,30,15,0,45,219,15,279
1134310,16,8,24,7,7,0,14,85,32,131
1134311,16,4,20,37,20,0,57,232,58,347
1134312,9,0,9,72,41,4,117,275,32,424
1134313,11,4,15,103,33,5,141,209,48,398
1134314,3,0,9,86,26,6,118,163,29,310
1134315,4,0,4,34,17,3,54,178,27,259
1134316,3,4,7,55,16,4,75,196,35,306
1134317,17,9,26,59,15,3,77,284,132,493
1134318,5,0,5,37,19,3,59,160,27,246
1134319,12,0,12,56,36,3,95,220,65,380
1134320,3,0,3,49,15,0,64,212,61,337
1134321,6,0,6,48,25,6,79,184,34,297
1134322,9,3,12,55,23,0,78,237,188,503
1134323,7,3,10,48,22,0,70,98,34,202
1134324,3,6,9,57,23,0,80,272,72,424
1134325,13,3,16,34,30,0,64,245,76,385
1134326,0,0,0,18,8,0,26,229,44,299
1134327,7,0,7,67,25,0,92,298,46,436
1134328,13,0,13,43,33,6,82,256,27,365
1134329,41,4,45,28,20,0,48,219,10,277
1134330,0,0,0,45,16,0,61,168,32,261
1134331,15,0,15,44,42,0,86,242,41,369
1134332,7,0,7,94,39,6,139,273,78,490
1134333,3,0,3,84,33,9,126,200,16,342
1134334,0,0,0,26,25,0,51,84,27,162
1134335,9,0,9,65,34,3,102,279,108,489
1134336,3,3,6,44,26,0,70,207,44,321
1134337,11,0,11,37,21,0,58,214,33,305
1134338,20,3,23,52,31,3,86,327,67,480
1134339,9,6,18,41,26,0,67,185,17,269
1134340,4,7,11,72,21,4,97,254,34,385
1134341,3,0,3,49,17,6,72,103,29,204
1134342,9,0,9,55,19,0,74,166,27,267
1134343,0,0,0,37,16,4,57,197,40,294
1134344,0,0,0,35,22,3,60,106,24,190
1134345,0,0,0,79,27,3,109,129,12,250
1134346,10,0,10,91,37,4,132,244,29,405
1134347,26,9,38,62,42,0,104,382,72,558
1134348,15,7,22,51,37,0,88,215,63,366
1134349,14,6,23,58,38,0,96,277,144,517
1134350,6,3,9,83,28,0,111,166,16,293
1134351,6,0,6,64,17,0,81,181,22,284
1134352,11,3,14,51,16,0,67,208,47,322
1134353,0,3,3,72,27,3,102,237,22,361
1134354,11,8,19,33,29,4,66,179,91,336
1134355,14,0,14,57,32,0,89,323,62,474
1134356,17,3,20,75,22,0,97,418,72,587
1134357,3,6,9,45,22,0,67,197,34,298
1134401,17,0,17,102,49,4,155,357,23,535
1134402,10,0,10,74,22,4,100,167,18,285
1134403,0,0,0,84,30,0,114,222,28,364
1134404,6,0,6,73,16,3,92,248,34,374
1134405,6,3,9,72,24,3,99,218,15,332
1134406,3,0,3,72,24,0,96,285,30,411
1134407,9,3,12,75,16,4,95,273,37,405
1134408,6,0,6,71,34,6,111,247,30,388
1134409,10,0,10,58,21,3,82,215,50,347
1134410,3,0,3,64,17,0,81,144,25,250
1134411,5,0,5,70,22,0,92,182,21,295
1134412,41,9,50,92,34,6,132,408,60,600
1134413,7,0,7,60,23,3,86,177,18,281
1134414,6,0,6,63,30,0,93,197,39,329
1134415,22,0,22,52,24,4,80,200,10,290
1134416,16,3,19,73,21,3,97,201,15,313
1134417,7,0,7,52,24,0,76,172,13,261
1134418,7,0,7,84,44,0,128,282,34,444
1134419,7,0,7,63,23,0,86,185,21,292
1134420,3,0,3,71,17,0,88,115,24,227
1134421,6,0,6,78,19,0,97,179,24,300
1134422,10,3,13,86,28,4,118,263,17,398
1134423,5,6,11,65,24,3,92,165,9,266
1134424,5,3,8,121,35,0,156,286,41,483
1134501,0,0,0,48,21,0,69,333,67,469
1134502,0,0,0,66,19,0,85,333,43,461
1134503,0,3,3,48,30,0,78,208,30,316
1134504,6,0,6,52,12,0,64,278,30,372
1134505,3,0,3,71,21,0,92,300,41,433
1134506,0,7,7,34,14,0,48,186,48,282
1134507,6,3,9,65,21,3,89,275,61,425
1134508,0,0,0,70,11,6,87,263,73,423
1134509,0,3,3,62,30,3,95,268,57,420
1134510,3,0,6,37,22,0,59,227,53,339
1134511,4,0,4,43,18,0,61,137,28,226
1134512,6,0,6,86,17,3,106,316,23,445
1134513,0,0,0,45,14,0,59,148,14,221
1134514,0,0,0,0,0,0,0,0,0,0
1134515,0,0,0,0,0,0,0,0,0,0
1134516,3,0,3,64,20,3,87,261,26,374
1134517,0,0,0,47,26,0,73,148,22,243
1134518,0,0,0,34,8,0,42,278,25,345
1134519,17,36,53,37,16,3,56,252,89,397
1134520,4,0,4,40,17,7,64,391,57,512
1134521,4,0,4,66,19,0,85,171,32,288
1134522,0,0,0,3,0,0,3,0,0,3
1134523,3,0,3,41,23,0,64,246,30,340
1134524,3,0,3,39,25,0,64,270,53,387
1134525,6,0,6,31,18,0,49,159,23,231
1134526,0,3,3,49,25,0,74,329,14,417
1134527,0,0,0,47,12,3,62,230,65,357
1134528,3,3,6,59,17,0,76,262,36,374
1134529,4,3,7,82,21,3,106,252,83,441
1134530,3,3,6,77,22,0,99,301,84,484
1134531,3,0,3,56,20,0,76,236,56,368
1134532,0,0,0,32,24,5,61,48,6,115
1134533,6,0,6,51,17,0,68,229,24,321
1134534,3,0,3,36,15,0,51,208,36,295
1134535,4,0,4,66,16,6,88,428,96,612
1134536,3,3,6,40,22,3,65,246,50,361
1134537,0,0,0,23,28,0,51,320,53,424
1134601,16,6,22,41,19,3,63,169,57,289
1134602,3,3,6,42,12,0,54,164,18,236
1134603,12,0,12,76,23,0,99,167,30,296
1134604,6,0,6,64,17,0,81,152,14,247
1134605,7,0,7,59,14,0,73,121,27,221
1134606,6,0,9,114,36,6,156,227,30,413
1134607,0,0,0,0,0,0,0,0,0,0
1134608,8,0,8,61,20,0,81,189,15,285
1134609,7,3,10,80,40,3,123,272,29,424
1134610,0,3,3,49,8,0,57,173,26,256
1134611,0,0,0,0,0,0,0,0,0,0
1134612,16,3,19,86,20,3,109,238,38,385
1134613,10,0,13,61,24,0,85,213,34,332
1134614,4,0,4,56,13,0,69,105,21,195
1134615,9,0,9,54,27,3,84,141,35,260
1134616,8,0,8,65,26,3,94,165,23,282
1134617,7,6,13,83,30,3,116,232,30,378
1134618,10,3,13,91,40,4,135,318,54,507
1134619,0,0,0,0,0,0,0,0,0,0
1134620,12,0,12,119,58,3,180,372,60,612
1134621,36,7,43,72,33,0,105,180,16,301
1134622,11,0,11,58,29,3,90,156,24,270
1134623,0,3,3,72,14,3,89,127,9,225
1134624,3,3,6,80,47,6,133,188,16,337
1134625,13,6,19,73,43,6,122,211,30,363
1134626,6,3,9,93,17,0,110,183,56,349
1134627,7,5,12,76,24,3,103,177,54,334
1134628,19,0,19,111,28,3,142,237,42,421
1134629,0,0,0,11,3,0,14,142,25,181
1134630,6,3,9,97,21,4,122,188,26,336
1134631,7,0,7,56,24,4,84,115,28,227
1134632,14,8,22,63,23,0,86,202,57,345
1134701,7,6,13,64,32,0,96,247,69,412
1134702,8,3,14,55,35,0,90,243,64,397
1134703,51,14,65,21,7,0,28,219,33,280
1134704,13,6,19,64,36,0,100,338,38,476
1134705,8,3,14,124,44,4,172,292,43,507
1134706,17,3,20,68,31,0,99,358,51,508
1134707,4,0,4,64,21,0,85,188,20,293
1134708,0,6,6,80,36,0,116,283,33,432
1134709,9,4,13,40,15,3,58,180,31,269
1134710,10,0,10,70,27,4,101,232,18,351
1134711,6,3,9,52,12,0,64,144,31,239
1134712,0,3,3,48,15,3,66,199,50,315
1134713,32,8,40,55,16,0,71,264,43,378
1134714,3,3,6,71,37,0,108,306,34,448
1134715,14,9,23,38,29,0,67,180,34,281
1134716,28,7,35,57,28,3,88,258,24,370
1134717,4,0,4,36,8,0,44,134,9,187
1134801,6,9,15,129,39,3,171,279,72,522
1134802,0,3,3,88,21,3,112,194,29,335
1134803,3,0,3,107,25,12,144,258,37,439
1134804,47,4,51,66,24,0,90,384,74,548
1134805,0,0,0,40,10,6,56,139,9,204
1134806,0,3,3,51,19,0,70,264,46,380
1134807,4,0,4,61,24,0,85,249,25,359
1134808,3,3,6,31,3,3,37,127,25,189
1134809,0,0,0,67,16,3,86,104,15,205
1134810,6,0,6,52,16,3,71,198,26,295
1134811,4,0,4,65,18,0,83,268,34,385
1134812,3,0,3,71,23,3,97,134,12,243
1134813,8,0,8,69,31,0,100,264,55,419
1134814,5,0,5,119,27,10,156,276,14,446
1134815,4,0,4,59,15,3,77,158,18,253
1134816,10,0,10,115,21,3,139,231,22,392
1134817,11,3,14,99,20,9,128,202,16,346
1134818,10,0,10,71,14,9,94,123,7,224
1134819,6,0,6,52,23,0,75,266,23,364
1134820,3,3,6,37,15,0,52,248,91,391
1134821,3,6,9,57,27,11,95,255,43,393
1134822,4,0,4,54,12,6,72,112,4,188
1134823,4,5,9,42,19,0,61,350,57,468
1134824,4,0,4,66,33,9,108,289,63,460
1134825,4,0,4,49,15,4,68,182,15,265
1134826,6,0,6,64,33,6,103,200,23,326
1134827,18,0,18,20,22,0,42,299,67,408
1134828,6,0,6,75,12,10,97,104,7,208
1134829,0,0,0,71,25,6,102,112,30,244
1134830,6,0,6,76,19,4,99,302,44,445
1134831,8,0,8,38,16,3,57,220,18,295
1134832,4,3,7,49,28,0,77,329,32,438
1134833,6,0,9,36,21,0,57,269,61,387
1134834,3,6,9,49,6,0,55,195,20,270
1134835,6,0,6,68,15,3,86,281,30,397
1134836,8,0,8,37,25,6,68,262,27,357
1134837,6,6,12,54,19,4,77,165,21,263
1134838,7,0,7,60,16,3,79,330,46,455
1134839,6,6,12,43,18,0,61,323,24,408
1134840,8,0,8,64,21,0,85,202,38,325
1134841,5,0,5,49,23,0,72,297,53,422
1134842,9,0,9,69,26,6,101,434,73,608
1134843,6,0,9,55,27,6,88,357,36,481
1134844,6,0,6,42,22,3,67,240,35,342
1134845,5,3,8,60,23,0,83,372,76,531
1134846,3,0,3,47,24,0,71,259,27,357
1134847,6,0,6,80,22,0,102,204,17,323
1134848,7,0,7,44,33,6,83,145,21,249
1134849,6,0,6,67,20,0,87,195,33,315
1134850,0,0,0,62,6,6,74,118,12,204
1134851,3,5,8,78,9,0,87,165,24,276
1134852,3,0,3,63,17,6,86,109,19,214
1134853,0,0,0,46,17,6,69,79,15,163
1134854,10,0,10,67,17,0,84,131,40,255
1134855,0,0,0,29,0,0,29,27,3,59
1134856,3,0,3,55,6,0,61,114,10,185
1134857,3,0,3,57,9,0,66,124,15,205
1134858,3,0,3,35,7,0,42,130,18,190
1134859,14,0,14,37,21,3,61,263,62,386
1134860,3,0,3,53,19,0,72,99,18,189
1134901,6,0,6,24,22,0,46,110,12,168
1134902,6,0,6,57,28,3,88,181,7,276
1134903,0,3,3,47,12,0,59,331,49,439
1134904,4,0,4,64,17,0,81,322,86,489
1134905,0,7,7,24,6,0,30,185,49,264
1134906,0,0,0,19,0,0,19,151,47,217
1134907,0,0,0,52,25,7,84,518,30,632
1134908,0,0,0,39,9,4,52,80,0,132
1134909,6,0,6,100,23,0,123,289,33,445
1134910,44,3,47,56,25,0,81,251,30,362
1134911,0,0,0,0,0,0,0,0,0,0
1134912,3,0,3,84,18,0,102,257,40,399
1134913,3,0,3,50,27,0,77,194,17,288
1134914,4,0,4,27,7,0,34,393,61,488
1134915,6,0,6,69,15,0,84,225,15,324
1134916,5,0,5,62,22,0,84,227,36,347
1134917,4,3,7,78,17,0,95,197,25,317
1134918,5,0,5,71,22,0,93,187,41,321
1134919,5,0,5,49,22,0,71,300,43,414
1134920,0,0,3,90,24,6,120,176,31,327
1134921,7,0,7,50,29,0,79,185,18,282
1134922,10,0,10,47,27,0,74,227,19,320
1134923,5,0,5,65,17,3,85,221,17,323
1134924,7,0,7,88,27,0,115,341,31,487
1134925,8,0,8,34,12,0,46,416,57,519
1134926,0,0,0,35,5,0,40,256,58,354
1134927,4,0,4,46,10,0,56,434,32,522
1134928,0,0,0,17,0,0,17,386,54,457
1134929,3,3,6,39,9,0,48,305,99,452
1134930,12,3,15,42,20,0,62,213,37,312
1134931,6,0,6,82,25,0,107,235,34,376
1134932,14,0,14,94,11,9,114,243,19,376
1134933,11,3,14,68,18,5,91,264,26,381
1134934,9,0,9,73,28,4,105,173,11,289
1134935,0,0,0,56,22,4,82,319,51,452
1134936,7,0,7,80,26,0,106,656,115,877
1134937,4,0,4,52,13,0,65,301,28,394
1134938,6,3,9,69,30,6,105,322,59,486
1134939,0,3,3,41,9,0,50,240,27,317
1134940,0,0,0,17,30,0,47,1682,71,1800
1134941,9,0,9,32,17,3,52,169,20,241
1134942,11,0,11,55,25,0,80,390,44,514
1134943,53,4,57,28,9,3,40,367,38,445
1134944,10,4,14,83,31,0,114,238,20,372
1134945,4,0,4,54,15,3,72,129,12,213
1134946,7,0,7,62,10,0,72,149,26,247
1134947,10,3,13,62,14,0,76,298,49,423
1134948,7,4,11,79,16,3,98,391,29,518
1134949,3,3,6,47,8,3,58,144,18,220
1134950,3,0,3,60,11,0,71,216,6,293
1134951,3,3,6,54,12,6,72,424,40,536
1134952,4,0,4,52,9,0,61,325,29,415
1134953,0,0,0,19,12,0,31,220,3,254
1134954,6,0,6,40,18,0,58,422,20,500
1134955,3,0,3,46,3,0,49,595,83,727
1134956,3,3,6,41,6,0,47,265,34,346
1134957,3,0,3,36,3,0,39,280,27,346
1134958,6,0,6,8,4,3,15,307,39,361
1134959,3,0,3,42,18,3,63,204,28,295
1135001,7,0,7,66,20,0,86,206,26,318
1135002,0,10,10,67,29,6,102,228,31,361
1135003,26,0,26,77,26,6,109,315,31,455
1135004,16,0,16,59,12,0,71,175,21,267
1135005,17,3,20,103,28,3,134,353,24,511
1135006,12,0,12,68,48,3,119,251,21,391
1135007,0,0,0,6,6,3,15,54,6,75
1135008,3,3,9,71,37,6,114,166,21,301
1135009,7,3,10,90,6,12,108,172,45,325
1135010,38,0,38,42,24,0,66,216,20,302
1135011,7,0,7,63,21,3,87,199,27,313
1135012,3,0,3,77,30,5,112,197,37,346
1135013,10,7,17,34,31,0,65,285,76,426
1135014,6,3,9,36,37,0,73,133,6,212
1135015,8,0,8,66,39,0,105,197,21,323
1135016,45,51,96,150,73,12,235,646,198,1079
1135017,20,8,28,53,25,0,78,250,32,360
1135018,3,0,3,128,15,6,149,174,19,342
1135019,4,3,7,42,22,0,64,160,36,260
1135020,9,4,13,87,23,0,110,292,52,454
1135021,24,3,27,78,44,0,122,300,19,441
1135022,4,0,4,51,29,5,85,206,21,312
1135023,0,0,0,81,31,0,112,253,20,385
1135024,0,0,0,3,0,0,3,9,0,12
1135025,0,0,0,0,0,0,0,0,0,0
1135026,0,0,0,0,0,0,0,0,0,0
1135027,3,3,6,50,6,0,56,134,15,205
1135028,0,0,0,3,3,0,6,90,1306,1402
1135029,5,5,10,85,30,3,118,225,73,416
1135030,13,0,13,60,31,3,94,208,10,312
1135031,0,4,4,11,16,3,30,222,72,324
1135032,4,3,7,44,36,0,80,237,51,368
1135033,6,0,6,56,26,0,82,201,21,304
1135034,3,0,3,64,16,0,80,109,6,195
1135035,8,4,12,58,33,0,91,288,64,443
1135036,14,0,14,56,17,3,76,187,25,288
1135037,11,0,11,83,23,4,110,247,19,376
1135038,10,0,10,84,44,0,128,266,25,419
1135039,8,0,8,106,44,3,153,237,19,409
1135040,12,0,12,76,30,3,109,265,22,396
1135041,0,0,0,91,22,4,117,170,21,308
1135042,0,0,0,52,18,3,73,189,31,293
1135043,4,0,4,67,20,0,87,164,9,260
1135044,11,3,14,108,18,6,132,217,15,364
1135045,7,3,10,109,36,0,145,339,65,549
1135046,5,0,5,122,28,3,153,352,45,550
1135047,3,3,6,57,16,6,79,134,9,222
1135048,13,0,13,87,42,0,129,308,28,465
1135101,10,0,10,20,7,0,27,188,65,280
1135102,7,0,7,32,12,3,47,133,44,224
1135103,3,4,7,75,20,0,95,191,13,299
1135104,21,5,26,41,30,6,77,195,47,319
1135105,7,0,7,76,19,3,98,192,37,327
1135106,4,0,4,67,24,0,91,276,52,419
1135107,8,3,11,84,32,4,120,208,15,343
1135108,5,0,5,39,12,0,51,225,31,307
1135109,0,0,0,0,0,0,0,0,0,0
1135110,8,4,12,37,17,3,57,245,48,350
1135111,12,3,15,77,21,3,101,160,30,291
1135112,7,0,7,75,17,0,92,227,25,344
1135113,0,8,8,59,29,3,91,220,52,363
1135114,11,0,11,43,0,0,43,179,23,245
1135115,10,0,10,121,30,0,151,273,47,471
1135116,3,0,3,104,36,3,143,281,26,450
1135117,15,0,15,101,24,3,128,302,14,444
1135118,9,0,9,61,38,4,103,186,31,320
1135119,15,4,19,62,32,0,94,211,12,317
1135120,12,3,15,61,40,0,101,250,35,386
1135121,0,0,0,54,10,3,67,223,8,298
1135122,46,0,46,35,8,0,43,180,14,237
1135123,10,0,10,51,25,0,76,220,12,308
1135124,13,3,16,68,30,0,98,313,36,447
1135125,3,0,3,37,18,0,55,153,18,226
1135126,4,3,7,55,18,0,73,326,59,458
1135127,17,3,20,96,36,0,132,412,42,586
1135128,8,0,8,65,18,6,89,184,9,282
1135129,6,0,6,51,24,0,75,251,37,363
1135130,9,7,16,52,15,3,70,289,41,400
1135131,8,0,8,92,21,0,113,238,32,383
1135132,9,3,12,69,21,3,93,247,31,371
1135133,0,0,0,63,27,3,93,295,43,431
1135134,10,0,10,68,22,6,96,206,19,321
1135135,10,3,13,82,35,3,120,240,10,370
1135136,8,0,8,71,12,0,83,223,25,331
1135137,8,0,8,81,22,7,110,241,18,369
1135138,14,0,14,95,23,0,118,261,33,412
1135139,6,0,6,79,20,3,102,204,16,322
1135140,14,0,14,83,20,0,103,219,24,346
1135141,6,0,6,45,26,13,84,128,26,238
1135142,8,0,8,54,21,3,78,234,17,329
1135143,10,3,13,47,14,0,61,235,45,341
1135144,10,0,10,96,32,0,128,232,19,379
1135145,9,0,9,59,25,6,90,178,41,309
1135146,6,3,9,76,23,4,103,532,39,674
1135147,16,0,16,44,16,0,60,193,54,307
1135148,46,6,52,75,34,7,116,325,33,474
1135149,4,0,4,118,27,8,153,238,14,405
1135150,14,3,17,47,13,0,60,195,27,282
1135151,14,6,20,46,22,0,68,258,54,380
1135152,13,9,22,92,32,9,133,357,96,586
1135153,4,0,4,23,10,3,36,238,48,322
1135154,3,0,3,49,16,0,65,167,41,273
1135155,3,0,3,69,25,7,101,198,45,344
1135156,6,0,6,100,24,0,124,684,212,1020
1135157,5,3,8,45,10,0,55,191,34,280
1135158,8,0,8,78,37,3,118,442,62,622
1135159,3,6,9,63,53,9,125,204,17,346
1135160,7,0,7,89,28,6,123,282,71,476
1135161,3,3,6,85,19,7,111,293,58,462
1135162,0,0,0,50,16,3,69,286,53,408
1135163,4,0,4,95,35,0,130,162,14,306
1135164,8,4,12,79,33,0,112,347,79,538
1135165,9,0,9,55,26,0,81,286,64,431
1135166,6,3,9,61,25,0,86,156,16,258
1135167,0,3,3,61,24,3,88,167,22,277
1135201,0,0,0,3,0,0,3,35,9,47
1135202,4,0,4,44,27,3,74,193,25,292
1135203,3,0,3,110,29,0,139,150,21,310
1135204,0,0,0,46,18,0,64,183,25,272
1135205,8,3,11,58,15,0,73,492,85,650
1135206,192,11,203,28,19,0,47,390,35,472
1135207,0,0,0,68,15,9,92,113,12,217
1135208,10,0,10,12,6,0,18,148,17,183
1135209,0,0,0,33,13,6,52,227,78,357
1135210,4,0,4,39,18,0,57,307,38,402
1135211,0,0,0,65,17,0,82,216,18,316
1135212,5,0,5,41,3,3,47,145,25,217
1135213,3,0,3,98,31,4,133,234,45,412
1135214,6,3,9,48,6,0,54,130,25,209
1135215,50,7,57,82,25,0,107,226,29,362
1135216,6,0,6,44,6,0,50,71,12,133
1135217,43,0,43,81,36,6,123,350,32,505
1135218,7,0,7,84,23,0,107,183,21,311
1135219,0,0,0,80,3,3,86,196,29,311
1135220,4,0,4,56,28,8,92,265,39,396
1135221,0,0,0,59,12,0,71,213,29,313
1135222,0,0,0,74,16,3,93,431,46,570
1135223,6,3,9,49,5,9,63,294,40,397
1135224,6,3,9,32,8,0,40,188,21,249
1135225,3,0,3,68,27,0,95,300,34,429
1135226,6,3,9,57,21,0,78,252,31,361
1135227,6,4,10,42,22,0,64,350,48,462
1135228,4,3,7,32,11,0,43,175,26,244
1135229,5,3,8,63,18,6,87,218,40,345
1135230,7,3,10,78,25,4,107,396,67,570
1135231,6,0,6,59,24,0,83,228,29,340
1135232,41,0,41,40,10,0,50,248,34,332
1135233,0,0,0,29,9,3,41,166,15,222
1135234,5,3,8,82,26,9,117,326,27,470
1135235,0,0,0,57,14,4,75,166,19,260
1135236,3,0,3,62,26,0,88,244,27,359
1135237,4,0,4,49,6,0,55,196,12,263
1135238,3,0,6,70,21,0,91,296,14,401
1135239,3,3,6,57,14,3,74,216,26,316
1135240,6,3,9,52,22,0,74,241,21,336
1135241,0,0,0,66,10,3,79,173,44,296
1135242,3,0,3,38,25,6,69,384,39,492
1135243,0,0,0,44,9,0,53,128,19,200
1135244,7,0,7,47,15,0,62,242,28,332
1135245,7,0,7,77,26,0,103,300,31,434
1135246,3,0,3,44,12,0,56,247,25,328
1135247,9,3,12,107,24,6,137,245,27,409
1135248,0,0,0,56,24,4,84,166,10,260
1135249,7,0,7,97,38,9,144,262,17,423
1135250,4,0,8,82,12,9,103,221,12,336
1135251,3,0,3,47,16,6,69,109,19,197
1135252,8,0,8,57,8,0,65,184,33,282
1135253,8,0,8,57,15,0,72,215,32,319
1135254,6,0,6,64,17,0,81,149,4,234
1135255,3,3,6,61,20,3,84,235,29,348
1135256,5,0,5,80,13,5,98,350,40,488
1135257,8,0,8,70,15,6,91,183,18,292
1135258,6,0,6,65,15,4,84,108,12,204
1135259,13,6,19,113,37,7,157,341,46,544
1135260,6,0,10,78,17,0,95,192,29,316
1135261,6,3,9,90,7,3,100,477,20,597
1135262,4,0,4,74,13,0,87,252,39,378
1135263,9,3,12,80,21,0,101,299,47,447
1135264,6,0,6,107,22,6,135,251,40,426
1135265,6,0,6,51,20,0,71,297,52,420
1135266,27,0,27,44,15,0,59,275,26,360
1135267,0,0,0,96,18,4,118,236,30,384
1135268,10,0,10,37,16,3,56,171,31,258
1135301,0,0,0,51,3,0,54,136,34,224
1135302,0,0,0,0,0,0,0,0,0,0
1135303,0,0,0,83,28,0,111,250,27,388
1135304,12,0,12,127,26,6,159,337,24,520
1135305,15,0,15,49,24,0,73,230,43,346
1135306,0,0,0,0,0,0,0,0,0,0
1135307,6,0,6,44,6,0,50,179,36,265
1135308,0,0,0,0,0,0,0,9,0,9
1135309,0,0,0,57,0,0,57,91,28,176
1135310,6,3,9,255,27,6,288,617,172,1077
1135311,0,0,0,119,15,3,137,284,59,480
1135312,3,3,6,53,15,0,68,198,29,295
1135313,0,3,6,48,25,0,73,172,20,265
1135314,0,0,0,48,10,0,58,136,30,224
1135315,4,0,4,48,22,0,70,201,20,291
1135316,6,0,6,62,18,0,80,249,32,361
1135317,3,0,3,101,12,3,116,309,45,470
1135318,8,0,8,88,21,0,109,248,49,406
1135319,0,0,0,83,12,0,95,241,68,404
1135320,0,4,4,121,3,0,124,338,73,535
1135321,3,6,9,85,21,0,106,267,39,412
1135322,6,3,9,52,31,0,83,192,23,298
1135323,0,0,0,65,19,0,84,203,10,297
1135324,0,0,0,69,16,0,85,278,10,373
1135325,7,3,10,55,26,0,81,193,15,289
1135326,5,3,8,65,26,3,94,305,62,461
1135327,4,0,4,35,19,0,54,238,11,303
1135328,12,3,15,84,22,3,109,295,29,433
1135329,3,0,3,43,15,0,58,193,24,275
1135330,3,3,6,63,25,0,88,228,17,333
1135331,10,0,10,68,16,0,84,266,36,386
1135332,0,0,0,108,8,0,116,201,89,406
1135333,0,0,0,97,18,3,118,171,32,321
1135334,3,3,6,55,11,3,69,152,90,311
1135335,0,0,0,75,9,0,84,152,33,269
1135336,3,0,3,153,24,0,177,333,65,575
1135337,0,0,0,57,17,6,80,186,12,278
1135338,3,0,3,56,24,0,80,230,74,384
1135339,6,0,6,162,27,0,189,338,103,630
1135340,0,0,0,39,10,0,49,140,14,203
1135341,0,0,0,0,0,0,0,0,0,0
1135342,3,0,3,64,16,4,84,283,53,420
1135343,3,0,3,38,9,0,47,129,26,202
1135344,0,0,0,0,0,0,0,0,3,3
1135345,0,0,0,0,0,0,0,3,0,3
1135346,0,0,0,0,0,0,0,0,0,0
1135347,4,0,4,62,6,0,68,124,32,224
1135348,10,0,10,56,15,0,71,211,17,299
1135349,3,0,3,56,23,0,79,217,23,319
1135350,6,0,6,134,10,0,144,318,61,523
1135351,4,0,4,124,12,3,139,290,67,496
1135352,6,3,9,104,9,0,113,254,25,392
1135353,4,0,4,100,12,0,112,218,48,378
1135354,4,0,4,116,17,0,133,315,50,498
1135355,3,3,6,104,12,0,116,252,21,389
1135356,3,0,3,134,17,6,157,330,90,577
1135357,0,0,0,128,19,0,147,383,77,607
1135358,33,0,33,40,6,0,46,172,35,253
1135359,0,0,0,0,6,0,6,3,0,9
1135360,0,0,0,0,0,0,0,3,0,3
1135361,6,0,6,28,25,3,56,127,18,201
1135362,14,19,33,45,16,0,61,176,81,318
1135363,6,3,9,42,12,6,60,228,49,337
1135364,13,0,13,62,10,6,78,286,42,406
1135365,17,0,17,66,34,4,104,302,21,427
1135366,8,3,11,67,27,0,94,252,18,364
1135367,10,17,27,53,7,0,60,197,48,305
1135368,5,0,5,46,16,6,68,221,31,320
1135369,0,0,0,0,0,0,0,16,14,30
1135370,8,3,11,91,26,6,123,268,39,430
1135371,6,0,6,103,27,0,130,369,59,558
1135372,3,3,6,72,18,0,90,216,27,333
1135401,3,3,6,74,37,0,111,205,18,334
1135402,8,0,8,58,31,0,89,207,24,320
1135403,0,0,0,92,39,3,134,253,27,414
1135404,9,0,9,53,29,0,82,160,15,257
1135405,0,0,0,46,29,0,75,161,15,251
1135406,3,0,3,84,41,0,125,231,20,376
1135407,4,0,4,26,26,0,52,125,10,187
1135408,8,0,8,42,9,0,51,176,22,249
1135409,3,4,7,59,24,0,83,212,37,332
1135410,11,3,14,59,17,0,76,253,51,380
1135411,3,0,3,50,19,3,72,146,13,231
1135412,80,13,93,50,14,0,64,364,37,465
1135413,9,0,9,82,19,3,104,277,35,416
1135414,5,3,8,73,21,9,103,204,41,348
1135415,3,0,3,92,24,3,119,354,58,531
1135416,0,0,0,0,0,0,0,0,0,0
1135417,0,6,6,62,22,0,84,162,15,261
1135418,5,0,5,68,12,5,85,235,53,373
1135419,15,3,18,85,29,3,117,317,20,454
1135420,8,0,8,67,28,0,95,180,25,300
1135421,9,3,12,78,26,0,104,282,35,421
1135422,5,0,5,82,24,3,109,298,31,438
1135423,3,3,6,3,0,0,3,3,9,15
1135424,3,0,3,49,41,0,90,185,17,292
1135425,0,0,0,38,15,6,59,148,27,234
1135426,92,0,92,33,15,0,48,256,20,324
1135427,8,0,8,104,50,0,154,272,40,466
1135428,3,0,3,42,31,0,73,207,21,301
1135429,3,0,3,51,9,3,63,129,12,204
1135430,3,0,3,17,11,0,28,127,9,164
1135431,3,0,3,60,23,0,83,151,26,260
1135432,6,0,6,47,20,0,67,148,20,235
1135433,0,0,0,46,21,0,67,154,9,230
1135434,4,0,4,52,15,0,67,183,15,265
1135435,12,0,12,91,26,0,117,259,29,405
1135436,0,0,0,64,22,0,86,186,16,288
1135437,0,0,0,0,0,0,0,0,0,0
1135438,3,0,3,40,12,0,52,125,3,180
1135439,0,0,0,71,37,3,111,228,24,363
1135440,0,0,0,42,25,3,70,192,3,265
1135441,3,0,3,47,15,3,65,209,35,309
1135442,6,0,6,38,15,4,57,190,28,275
1135443,7,0,7,68,24,3,95,172,27,294
1135444,8,0,8,56,35,6,97,219,22,338
1135445,7,3,10,50,4,0,54,300,64,418
1135446,0,0,0,36,15,0,51,227,23,301
1135447,4,0,4,50,9,0,59,167,26,252
1135448,6,0,6,35,21,4,60,179,26,265
1135449,3,0,3,24,3,3,30,112,5,147
1135450,3,3,6,78,24,0,102,225,31,358
1135451,61,0,61,64,18,9,91,210,47,348
1135452,4,0,4,64,11,0,75,179,20,274
1135453,4,0,4,25,15,3,43,168,12,223
1135454,6,0,6,31,12,0,43,129,7,179
1135501,0,0,0,0,0,0,0,0,0,0
1135502,0,0,0,0,0,0,0,0,0,0
1135601,0,0,0,0,0,0,0,0,0,0
1135602,0,0,0,0,0,0,0,0,0,0
1135603,5,0,5,66,17,0,83,148,11,242
1135604,0,0,0,0,0,0,0,13,3,16
1135605,0,0,0,3,0,0,3,0,0,3
1135606,3,0,3,85,38,0,123,236,30,389
1135607,6,0,6,38,24,3,65,172,9,246
1135608,10,3,13,71,29,3,103,233,36,372
1135609,5,6,11,52,46,3,101,287,45,433
1135610,6,3,9,89,22,7,118,304,34,456
1135611,7,3,10,83,44,0,127,283,32,442
1135612,7,4,14,84,23,0,107,218,75,400
1135613,9,0,9,95,42,3,140,261,53,454
1135614,6,0,6,71,33,0,104,196,43,343
1135615,6,0,6,77,14,4,95,235,41,371
1135616,6,3,9,49,18,0,67,153,23,243
1135617,6,0,6,39,25,0,64,149,28,241
1135618,12,0,12,69,26,0,95,286,19,400
1135619,6,3,9,94,29,4,127,249,41,417
1135620,0,0,0,0,0,0,0,0,0,0
1135621,5,0,5,54,15,0,69,216,33,318
1135622,0,0,0,0,0,0,0,0,0,0
1135623,5,0,5,78,21,0,99,226,24,349
1135624,5,0,5,78,12,0,90,228,28,346
1135625,4,0,4,58,21,0,79,160,46,285
1135626,10,0,10,49,27,0,76,162,44,282
1135627,4,3,7,54,16,9,79,175,18,272
1135628,0,3,3,53,24,0,77,200,39,316
1135629,4,0,4,39,7,0,46,136,15,197
1135701,14,0,14,69,18,6,93,229,33,355
1135702,3,3,6,41,18,3,62,183,32,277
1135703,0,0,0,44,10,6,60,191,37,288
1135704,4,0,4,70,13,0,83,163,15,261
1135705,0,0,0,76,5,0,81,143,17,241
1135706,8,0,8,95,43,3,141,340,29,510
1135707,5,0,5,50,10,3,63,172,7,242
1135708,4,0,4,86,15,0,101,297,54,452
1135709,5,0,5,63,20,3,86,181,22,289
1135710,4,0,4,55,29,6,90,163,21,274
1135711,8,3,15,100,21,10,131,320,39,490
1135712,7,0,7,98,26,0,124,322,48,494
1135713,0,0,0,81,18,3,102,228,20,350
1135714,4,0,4,41,14,0,55,171,4,230
1135715,6,0,6,57,30,3,90,159,28,277
1135716,7,0,7,119,19,0,138,284,14,436
1135717,3,0,3,42,6,0,48,153,15,216
1135718,6,0,6,54,15,3,72,228,44,344
1135719,4,0,4,46,4,0,50,120,22,192
1135720,7,0,7,51,27,3,81,165,20,266
1135721,3,3,6,80,13,0,93,247,45,385
1135722,0,0,0,58,21,0,79,189,25,293
1135723,6,0,6,56,17,0,73,241,31,345
1135724,6,0,6,52,6,0,58,169,30,257
1135725,6,0,6,57,19,0,76,250,30,356
1135726,7,8,15,77,20,4,101,257,34,392
1135727,3,4,7,67,21,0,88,226,18,332
1135728,16,0,16,85,41,6,132,332,33,497
1135729,8,0,8,69,29,0,98,240,34,372
1135730,7,0,7,59,16,6,81,192,16,289
1135731,7,0,7,76,25,0,101,220,22,343
1135732,13,0,13,78,26,0,104,254,13,371
1135733,13,3,16,83,33,4,120,327,37,484
1135734,5,5,10,78,12,0,90,236,32,358
1135735,7,0,7,79,17,0,96,272,36,404
1135736,8,0,8,94,22,3,119,254,29,402
1135737,12,0,12,49,25,0,74,202,0,276
1135738,3,0,3,49,15,0,64,321,34,419
1135739,0,0,0,91,17,6,114,217,37,368
1135740,5,0,5,49,19,4,72,186,17,275
1135741,3,0,3,71,16,0,87,186,42,315
1135742,0,0,0,65,19,3,87,188,27,302
1135743,0,0,0,75,9,0,84,145,13,242
1135744,6,0,6,45,23,6,74,195,13,282
1135745,0,6,6,45,24,6,75,184,28,287
1135746,6,0,6,61,9,3,73,165,30,268
1135747,0,3,3,51,15,0,66,140,41,247
1135748,7,3,10,56,12,0,68,185,16,269
1135749,0,0,0,0,0,0,0,0,0,0
1135750,50,3,53,59,11,0,70,365,34,469
1135751,3,0,3,36,4,0,40,100,17,157
1135752,3,0,3,67,16,0,83,204,15,302
1135753,6,3,9,60,15,4,79,240,39,358
1135754,3,0,3,42,11,6,59,116,13,188
1135755,3,0,3,44,6,3,53,115,7,175
1135756,6,0,6,36,21,0,57,122,25,204
1135757,0,0,0,54,6,0,60,111,18,189
1135758,4,100,104,16,9,0,25,137,183,345
1135801,12,0,18,54,25,3,82,235,25,342
1135802,3,6,9,41,6,0,47,142,18,207
1135803,8,0,8,65,21,0,86,260,31,377
1135804,11,7,18,121,31,7,159,331,30,520
1135805,8,0,8,43,12,6,61,213,6,280
1135806,0,0,0,0,0,0,0,0,0,0
1135807,5,3,8,37,28,0,65,137,10,212
1135808,10,0,10,94,23,0,117,327,6,450
1135809,11,0,11,73,28,0,101,284,22,407
1135810,14,0,14,93,21,9,123,312,25,460
1135811,7,0,7,44,27,0,71,225,12,308
1135812,6,3,9,54,4,0,58,170,24,252
1135813,6,0,6,51,16,0,67,145,9,221
1135814,11,3,14,77,18,6,101,268,15,384
1135815,7,0,7,45,20,0,65,239,5,309
1135816,10,0,13,78,24,3,105,297,27,429
1135817,0,0,0,0,0,0,0,3,3,6
1135818,8,0,8,79,21,0,100,179,28,307
1135819,9,0,9,60,31,0,91,195,25,311
1135820,6,0,6,70,37,3,110,278,20,408
1135821,8,0,8,88,27,0,115,254,21,390
1135822,3,0,3,33,17,0,50,158,27,235
1135823,14,3,17,105,18,6,129,287,43,459
1135824,11,3,14,35,27,3,65,137,26,228
1135825,0,0,0,17,6,0,23,44,3,70
1135826,48,12,60,24,14,0,38,185,38,261
1135827,4,3,7,85,23,4,112,257,32,401
1135828,3,0,3,74,40,4,118,230,14,362
1135829,89,3,92,56,20,0,76,295,17,388
1135830,6,3,9,69,20,4,93,201,21,315
1135831,8,0,11,52,38,7,97,238,29,364
1135832,6,0,9,47,22,0,69,140,16,225
1135833,7,0,7,31,37,0,68,200,7,275
1135834,53,3,56,71,15,4,90,318,25,433
1135835,0,0,0,0,0,0,0,0,0,0
1135836,3,0,3,60,35,3,98,203,39,340
1135837,0,0,0,30,22,3,55,127,19,201
1135838,6,3,9,60,17,0,77,240,54,371
1135839,6,0,6,79,16,6,101,245,37,383
1135840,3,0,3,56,23,6,85,150,20,255
1135841,6,0,6,69,22,0,91,171,7,269
1135842,7,0,7,87,34,0,121,271,30,422
1135901,9,3,12,78,28,3,109,231,25,365
1135902,7,0,7,48,3,0,51,167,12,230
1135903,9,0,9,56,21,3,80,213,22,315
1135904,0,0,0,49,18,6,73,184,9,266
1135905,3,0,3,81,41,9,131,256,11,398
1135906,0,0,0,77,35,3,115,161,12,288
1135907,16,0,16,76,25,0,101,232,38,371
1135908,15,0,15,88,21,0,109,234,16,359
1135909,3,0,3,59,24,0,83,150,16,249
1135910,0,0,0,0,0,0,0,0,0,0
1135911,3,0,3,94,31,3,128,256,8,392
1135912,3,3,6,86,27,6,119,173,12,304
1135913,0,0,3,52,39,3,94,158,7,259
1135914,0,0,0,94,18,3,115,165,18,298
1135915,10,5,15,109,31,9,149,255,27,431
1135916,9,0,9,72,30,0,102,187,15,304
1135917,6,0,6,67,21,3,91,183,14,288
1135918,4,0,4,61,19,3,83,203,30,316
1135919,7,0,7,44,14,4,62,265,28,355
1135920,6,0,6,37,15,3,55,126,29,210
1135921,10,0,10,58,19,0,77,181,7,265
1135922,0,0,0,0,0,0,0,0,0,0
1135923,0,0,0,84,62,0,146,324,26,496
1135924,6,3,9,115,38,4,157,249,25,431
1135925,7,6,13,75,36,0,111,252,18,381
1135926,18,4,22,97,41,0,138,297,25,460
1135927,0,0,0,66,23,6,95,189,9,293
1135928,6,0,6,53,29,0,82,200,14,296
1135929,3,0,3,75,13,0,88,189,15,292
1135930,3,4,7,86,36,3,125,236,11,372
1135931,4,3,7,84,31,0,115,181,27,323
1135932,6,3,9,92,38,0,130,244,21,395
1135933,11,0,11,78,41,0,119,234,30,383
1135934,9,3,15,97,46,3,146,286,48,480
1135935,8,7,15,76,24,0,100,306,30,436
1135936,10,0,10,39,19,0,58,234,0,292
1135937,10,0,10,82,34,0,116,219,35,370
1135938,4,0,4,58,33,3,94,148,9,251
1135939,0,0,0,50,42,9,101,200,0,301
1135940,3,3,6,60,26,0,86,155,6,247
1135941,0,0,0,0,0,0,0,3,0,3
1135942,7,0,10,85,42,3,130,238,12,380
1135943,3,0,3,76,40,3,119,181,6,306
1135944,0,0,0,75,31,6,112,175,9,296
1135945,0,0,0,90,47,0,137,261,7,405
1135946,0,0,0,58,24,0,82,222,19,323
1135947,13,0,13,105,15,6,126,254,25,405
1135948,6,0,6,45,24,0,69,195,18,282
1135949,17,6,23,99,26,0,125,306,21,452
1135950,4,0,4,75,31,3,109,187,30,326
1135951,5,0,5,62,19,0,81,132,15,228
1135952,0,0,0,0,0,0,0,0,0,0
1135953,0,0,0,73,12,0,85,166,18,269
1135954,8,0,8,114,39,3,156,312,16,484
1135955,4,0,4,45,28,6,79,241,22,342
1135956,12,0,12,81,17,4,102,265,15,382
1135957,8,5,13,89,20,4,113,226,31,370
1135958,6,3,9,62,12,0,74,168,44,286
1135959,19,3,22,72,27,3,102,249,24,375
1135960,7,3,10,67,36,0,103,283,35,421
1135961,0,0,0,46,19,6,71,162,15,248
1136001,4,0,4,68,16,3,87,287,33,407
1136002,12,0,12,78,21,0,99,289,18,406
1136003,3,3,6,79,29,0,108,266,21,395
1136004,13,3,16,64,24,3,91,192,26,309
1136005,10,3,13,47,22,6,75,233,23,331
1136006,8,0,8,49,10,0,59,173,10,242
1136007,8,0,8,61,11,5,77,238,22,337
1136008,4,0,4,62,27,0,89,200,25,314
1136009,8,0,8,68,27,3,98,239,13,350
1136010,31,51,82,60,6,3,69,190,86,345
1136011,6,0,6,55,13,3,71,140,15,226
1136012,3,0,3,48,22,0,70,178,50,298
1136013,3,3,6,46,5,0,51,165,45,261
1136014,8,0,8,115,35,4,154,263,36,453
1136015,7,3,10,60,12,3,75,137,18,230
1136016,16,6,25,126,31,3,160,263,24,447
1136017,14,0,14,97,40,0,137,236,9,382
1136018,5,6,11,101,30,4,135,305,54,494
1136019,3,0,3,89,32,6,127,364,41,532
1136020,0,3,3,37,13,3,53,116,21,190
1136021,6,0,6,64,16,0,80,172,9,261
1136022,10,4,14,47,15,0,62,206,36,304
1136023,7,7,14,55,20,0,75,165,40,280
1136024,6,3,9,63,18,4,85,281,44,410
1136025,3,0,3,43,10,6,59,125,27,211
1136026,6,0,6,79,30,0,109,241,10,360
1136027,10,0,10,92,48,6,146,320,34,500
1136028,9,0,9,22,17,0,39,159,27,225
1136029,14,0,17,95,37,3,135,357,28,520
1136030,6,6,12,68,15,0,83,204,39,326
1136031,0,0,0,44,14,0,58,140,15,213
1136032,7,0,7,69,32,6,107,249,31,387
1136033,12,0,12,68,17,3,88,272,20,380
1136034,20,3,23,30,18,0,48,216,12,276
1136035,57,7,64,69,15,0,84,290,37,411
1136101,10,0,10,50,12,0,62,181,25,268
1136102,0,0,0,0,0,0,0,0,0,0
1136103,3,0,3,36,21,0,57,154,26,237
1136104,8,0,8,107,46,0,153,283,15,451
1136105,3,0,3,37,23,0,60,158,38,256
1136106,3,0,3,53,15,0,68,202,19,289
1136107,8,3,11,62,17,4,83,241,35,359
1136108,16,0,16,73,21,0,94,276,64,434
1136109,7,0,7,59,16,0,75,183,41,299
1136110,6,0,6,43,10,0,53,161,20,234
1136111,0,0,0,27,6,0,33,110,19,162
1136112,11,3,14,77,16,0,93,222,54,369
1136113,4,6,10,68,19,3,90,231,30,351
1136114,6,0,6,74,18,0,92,250,40,382
1136115,14,3,17,56,14,0,70,273,60,403
1136116,6,0,9,38,24,0,62,169,35,266
1136117,9,0,9,93,23,0,116,321,69,506
1136118,8,0,8,39,10,3,52,208,53,313
1136119,10,6,16,48,14,3,65,194,22,281
1136120,12,0,12,60,18,0,78,201,26,305
1136121,7,5,12,80,17,3,100,190,21,311
1136122,6,6,12,66,30,4,100,314,36,450
1136123,72,0,72,45,22,0,67,343,76,486
1136124,8,3,11,67,39,0,106,241,24,371
1136125,3,0,3,46,22,0,68,142,28,238
1136126,13,3,16,86,18,6,110,247,24,381
1136127,13,6,19,76,25,6,107,257,41,405
1136128,3,3,6,47,18,0,65,190,35,290
1136129,3,0,3,68,13,0,81,167,13,261
1136130,10,0,10,54,15,3,72,185,6,263
1136131,7,0,7,49,12,0,61,188,9,258
1136132,3,5,8,65,12,0,77,269,38,384
1136133,11,3,14,62,12,0,74,221,15,310
1136134,10,3,13,84,22,0,106,331,52,489
1136135,7,0,7,59,18,0,77,206,16,299
1136136,5,3,8,50,24,0,74,189,21,284
1136137,3,0,3,95,18,0,113,165,31,309
1136138,12,0,12,56,16,3,75,231,23,329
1136139,16,6,22,54,13,0,67,147,23,237
1136140,9,0,9,89,12,0,101,233,28,362
1136141,0,0,0,64,18,0,82,164,31,277
1136142,9,0,9,104,36,6,146,335,38,519
1136143,0,0,0,41,18,3,62,154,15,231
1136144,6,5,11,34,5,0,39,149,47,235
1136145,12,0,12,57,26,0,83,192,29,304
1136146,0,0,0,74,13,5,92,165,42,299
1136201,0,0,0,19,12,0,31,131,6,168
1136202,3,0,3,47,17,0,64,125,12,201
1136203,3,0,3,57,14,0,71,198,44,313
1136204,0,4,4,74,11,0,85,197,31,313
1136205,7,0,7,58,30,3,91,242,3,336
1136206,8,3,11,51,19,0,70,201,53,324
1136207,0,0,0,104,26,5,135,237,39,411
1136208,5,0,5,57,18,0,75,191,19,285
1136209,10,0,10,66,25,0,91,254,33,378
1136210,0,3,3,65,27,0,92,191,21,304
1136211,3,0,3,82,16,0,98,252,25,375
1136212,14,6,20,82,33,3,118,278,51,447
1136213,9,0,9,68,22,0,90,282,22,394
1136214,4,3,7,62,9,0,71,138,26,235
1136215,0,0,0,66,12,4,82,177,74,333
1136216,5,0,5,62,23,0,85,229,25,339
1136217,3,0,6,63,21,0,84,231,21,336
1136218,3,0,3,55,9,0,64,215,25,304
1136219,8,0,8,96,24,0,120,271,43,434
1136220,7,0,7,90,16,0,106,195,9,310
1136221,9,0,9,94,29,0,123,242,31,396
1136222,8,4,12,60,13,3,76,231,23,330
1136223,3,0,3,87,10,0,97,268,77,442
1136224,4,0,4,80,21,0,101,206,37,344
1136225,8,6,14,77,35,0,112,265,36,413
1136226,11,3,14,61,22,3,86,281,24,391
1136227,6,0,6,114,24,7,145,307,18,470
1136228,3,0,3,91,36,0,127,322,25,474
1136229,3,0,3,54,20,0,74,279,42,395
1136230,11,3,14,80,36,6,122,274,24,420
1136231,6,3,9,54,28,0,82,210,30,322
1136232,3,3,6,90,13,0,103,338,33,474
1136233,0,0,0,67,36,0,103,225,15,343
1136234,3,0,3,68,20,0,88,194,28,310
1136235,3,0,3,85,38,0,123,408,62,593
1136236,3,0,3,33,23,0,56,153,15,224
1136237,0,0,0,22,15,0,37,125,26,188
1136238,4,0,4,72,18,0,90,275,41,406
1136239,8,28,36,70,26,0,96,307,67,470
1136240,6,3,9,42,18,6,66,142,60,268
1136241,3,0,3,25,9,0,34,132,6,172
1136242,0,3,3,35,3,0,38,146,35,219
1136243,12,10,22,56,14,0,70,217,56,343
1136301,7,0,7,30,12,0,42,168,10,220
1136302,4,0,4,71,25,0,96,335,19,450
1136303,7,0,7,86,30,0,116,302,28,446
1136304,6,3,9,66,22,0,88,291,32,411
1136305,10,0,10,57,25,3,85,234,42,361
1136306,23,0,23,32,18,0,50,239,26,315
1136307,6,0,6,42,18,0,60,258,40,358
1136308,9,0,9,97,9,0,106,294,47,447
1136309,3,0,3,79,13,0,92,303,43,438
1136310,5,0,5,80,10,0,90,227,35,352
1136311,6,3,9,69,23,0,92,203,35,330
1136312,7,3,10,36,14,6,56,189,19,264
1136313,3,0,3,63,13,0,76,212,28,316
1136314,3,0,3,47,18,0,65,127,29,221
1136315,16,0,16,67,18,0,85,257,28,370
1136316,11,0,11,79,16,0,95,245,38,378
1136317,3,3,6,30,29,0,59,201,35,295
1136318,7,6,13,68,42,0,110,298,36,444
1136319,6,0,6,105,18,0,123,250,39,412
1136320,0,0,0,118,18,0,136,290,25,451
1136321,0,0,0,63,15,0,78,224,21,323
1136322,7,0,7,94,12,3,109,227,32,368
1136323,3,0,3,65,11,0,76,177,43,296
1136324,3,3,6,78,14,0,92,310,31,433
1136325,6,0,6,63,11,0,74,226,17,317
1136326,3,0,3,67,12,0,79,180,33,292
1136327,0,0,0,76,9,0,85,385,32,502
1136328,8,3,11,72,11,0,83,271,45,399
1136329,4,0,4,83,18,0,101,300,59,460
1136330,0,0,0,72,15,0,87,284,29,400
1136331,0,3,3,49,8,0,57,188,38,283
1136332,6,0,6,57,6,0,63,171,55,289
1136333,0,0,0,58,5,6,69,199,27,295
1136334,3,0,3,57,12,0,69,186,24,279
1136335,0,0,0,78,10,3,91,295,42,428
1136336,11,0,11,111,26,0,137,354,43,534
1136337,6,0,6,57,10,0,67,243,22,332
1136338,8,0,8,69,16,3,88,209,18,315
1136339,4,0,4,36,8,0,44,137,18,199
1136340,0,0,0,65,10,0,75,226,30,331
1136341,15,0,15,65,11,0,76,248,39,363
1136342,3,0,3,93,19,0,112,241,32,385
1136343,0,0,0,70,10,0,80,166,19,265
1136344,6,0,6,106,31,3,140,316,29,485
1136345,12,0,12,87,19,4,110,302,44,456
1136346,6,0,6,74,45,0,119,283,33,435
1136347,3,0,3,55,31,0,86,260,24,370
1136348,0,0,0,3,0,0,3,0,0,3
1136349,7,0,7,60,14,0,74,143,6,223
1136350,9,3,12,70,23,6,99,241,35,375
1136351,3,3,6,95,12,0,107,228,62,397
1136352,3,0,3,30,7,3,40,143,12,195
1136353,4,0,4,36,17,0,53,164,61,278
1136354,0,3,3,44,13,0,57,194,6,257
1136355,6,0,6,32,9,3,44,190,47,281
1136356,7,0,7,44,5,0,49,138,0,187
1136357,4,0,4,36,6,0,42,192,17,251
1136358,4,0,4,69,12,0,81,277,118,476
1136359,0,0,0,48,12,0,60,146,21,227
1136360,0,0,0,32,10,0,42,164,30,236
1136361,0,0,0,39,12,0,51,113,15,179
1136362,4,0,4,42,6,0,48,165,26,239
1136363,3,0,3,62,6,0,68,211,29,308
1136364,6,3,9,58,15,0,73,161,14,248
1136365,3,0,3,42,20,0,62,251,11,324
1136366,0,3,3,25,6,6,37,110,21,168
1136367,0,0,0,27,0,0,27,145,22,194
1136401,6,3,9,36,22,0,58,155,15,228
1136402,12,3,15,99,23,5,127,277,42,446
1136403,48,0,48,79,12,3,94,352,12,458
1136404,0,0,0,47,15,0,62,127,10,199
1136405,12,0,12,59,28,0,87,241,20,348
1136406,6,0,6,90,34,3,127,300,35,462
1136407,6,3,9,107,20,0,127,226,15,368
1136408,6,0,6,25,13,3,41,142,6,189
1136409,3,0,3,38,22,0,60,136,6,202
1136410,0,0,0,66,17,0,83,116,15,214
1136411,4,3,7,57,32,0,89,151,9,249
1136412,0,3,3,73,25,0,98,210,32,340
1136413,0,3,3,66,34,0,100,225,27,352
1136414,5,0,5,87,37,0,124,216,30,370
1136415,9,4,13,71,41,0,112,259,30,401
1136416,7,0,7,86,38,4,128,286,28,442
1136417,3,4,10,76,27,0,103,229,17,349
1136418,5,0,5,37,32,0,69,144,28,241
1136419,15,3,18,39,12,0,51,132,15,198
1136420,0,0,0,72,20,0,92,206,9,307
1136421,6,3,9,47,19,3,69,163,18,250
1136422,8,4,12,60,36,0,96,233,31,360
1136423,8,3,11,50,20,3,73,182,43,298
1136424,3,0,3,53,17,0,70,142,14,226
1136425,6,0,6,46,3,0,49,123,6,178
1136426,4,0,4,46,15,0,61,165,12,238
1136427,7,0,7,53,13,0,66,170,12,248
1136428,13,4,17,99,23,0,122,281,45,448
1136429,0,0,0,0,0,0,0,0,0,0
1136430,9,3,12,75,32,0,107,273,33,413
1136431,12,3,15,85,39,0,124,289,19,432
1136432,11,0,11,38,31,0,69,175,13,257
1136433,8,3,11,91,30,4,125,294,45,464
1136434,13,3,16,37,21,0,58,173,12,243
1136435,14,4,18,70,34,0,104,259,16,379
1136436,9,3,16,104,44,3,151,337,28,516
1136437,15,0,15,62,24,0,86,227,21,334
1136438,14,3,17,102,24,0,126,365,59,550
1136439,7,3,10,61,15,3,79,199,12,290
1136440,7,4,11,94,35,0,129,288,51,468
1136441,8,3,11,64,36,0,100,187,36,323
1136442,5,5,10,70,37,0,107,192,14,313
1136443,7,3,10,63,24,3,90,166,12,268
1136444,6,0,6,79,47,0,126,208,15,349
1136445,5,0,5,63,23,0,86,178,14,278
1136446,13,0,13,97,42,0,139,270,33,442
1136447,16,0,16,86,29,3,118,307,27,452
1136448,0,4,4,43,13,0,56,108,10,174
1136449,12,0,12,78,47,0,125,274,30,429
1136450,8,6,14,81,33,0,114,282,28,424
1136451,0,3,3,37,15,3,55,121,20,196
1136452,3,0,3,77,36,3,116,216,30,362
1136453,4,0,4,24,9,0,33,129,24,186
1136454,6,0,6,35,15,0,50,124,13,187
1136455,4,0,4,57,11,0,68,127,10,205
1136456,6,0,6,81,28,0,109,212,9,330
1136457,5,0,5,45,33,0,78,171,19,268
1136458,3,0,3,52,21,0,73,161,21,255
1136501,7,0,7,97,16,0,113,339,79,531
1136502,7,0,7,96,32,0,128,299,36,463
1136503,4,0,4,66,10,0,76,180,29,285
1136504,11,0,15,74,32,0,106,284,42,432
1136505,0,4,4,68,17,0,85,248,41,374
1136506,0,0,0,94,0,0,94,157,42,293
1136507,0,0,0,73,3,0,76,190,29,295
1136508,4,0,4,83,6,0,89,176,84,349
1136509,3,0,3,74,5,0,79,205,16,300
1136510,0,0,0,70,6,0,76,133,46,255
1136511,0,0,0,139,11,6,156,329,50,535
1136512,6,0,6,81,21,0,102,234,22,358
1136513,6,0,6,88,9,0,97,271,75,443
1136514,3,0,3,42,9,0,51,231,63,345
1136515,0,0,0,82,23,0,105,263,75,443
1136516,3,0,3,53,9,0,62,110,46,218
1136517,4,3,7,34,10,0,44,127,34,205
1136518,4,0,4,120,10,0,130,282,99,511
1136519,6,0,6,121,16,0,137,266,53,456
1136520,19,0,19,79,7,4,90,243,24,357
1136521,0,0,0,70,6,0,76,194,12,282
1136522,8,0,8,78,26,0,104,277,22,403
1136523,0,0,0,99,10,3,112,224,31,367
1136524,3,0,3,95,10,0,105,182,38,325
1136525,0,0,0,123,7,0,130,196,35,361
1136526,4,0,4,69,9,0,78,194,27,299
1136527,0,0,0,88,17,0,105,151,26,282
1136528,3,0,3,87,17,0,104,264,51,419
1136529,4,3,7,95,15,0,110,229,42,381
1136530,0,0,0,93,15,0,108,266,50,424
1136531,6,0,6,58,13,4,75,185,69,329
1136532,4,0,4,144,12,3,159,304,74,537
1136533,0,0,0,101,12,0,113,191,33,337
1136534,4,0,4,76,0,0,76,214,35,325
1136535,3,0,3,82,18,0,100,229,33,362
1136536,0,0,0,111,19,0,130,274,44,448
1136537,0,0,0,81,17,3,101,247,43,391
1136538,0,0,0,97,4,4,105,187,35,327
1136539,6,0,6,70,0,5,75,154,34,263
1136540,3,0,3,91,9,3,103,239,37,379
1136541,0,0,0,81,15,0,96,186,23,305
1136542,6,0,6,94,6,3,103,299,48,450
1136543,0,0,0,92,0,0,92,162,58,312
1136544,30,51,81,73,13,0,86,248,150,484
1136545,4,0,4,58,13,4,75,192,56,323
1136546,3,0,3,41,18,0,59,153,33,245
1136547,4,0,4,57,18,3,78,234,33,345
1136548,7,0,7,117,17,0,134,272,28,434
1136549,6,3,9,144,27,0,171,307,49,527
1136550,0,0,0,88,12,0,100,206,29,335
1136551,3,0,3,69,8,3,80,204,41,325
1136552,4,0,4,36,6,0,42,152,24,218
1136601,0,3,3,49,10,0,59,183,28,270
1136602,3,0,3,101,12,0,113,270,49,432
1136603,3,0,3,78,16,0,94,253,70,417
1136604,0,0,0,95,21,0,116,200,45,361
1136605,4,0,4,52,9,3,64,176,18,258
1136606,4,0,4,76,12,0,88,241,23,352
1136607,0,0,0,66,29,0,95,206,21,322
1136608,5,0,5,50,9,0,59,151,33,243
1136609,0,0,0,81,27,0,108,272,50,430
1136610,0,0,0,57,14,0,71,205,76,352
1136611,3,0,3,54,15,3,72,206,55,333
1136612,6,0,6,80,12,0,92,208,44,344
1136613,3,3,6,57,16,3,76,152,54,282
1136614,7,0,7,50,5,0,55,135,45,235
1136615,0,0,0,50,24,0,74,264,30,368
1136616,0,0,0,70,20,0,90,163,41,294
1136617,5,0,5,54,21,0,75,149,24,248
1136618,4,0,4,80,25,0,105,201,52,358
1136619,0,3,3,26,3,0,29,120,80,229
1136620,0,0,0,48,22,0,70,182,58,310
1136621,17,0,17,71,30,0,101,329,43,473
1136622,9,3,12,39,14,0,53,152,29,234
1136623,5,0,5,68,11,4,83,235,24,342
1136624,4,0,4,66,19,0,85,264,61,410
1136625,3,0,6,51,9,0,60,173,16,249
1136626,3,0,3,70,22,9,101,230,56,387
1136627,6,3,9,52,20,6,78,239,15,332
1136628,0,3,3,53,10,0,63,166,9,238
1136629,0,0,0,85,21,4,110,217,41,368
1136630,4,0,4,45,14,0,59,173,31,263
1136631,5,0,5,65,29,0,94,180,23,297
1136632,9,4,13,38,29,0,67,248,67,382
1136633,0,0,0,40,8,5,53,116,25,194
1136634,0,0,0,73,16,3,92,193,26,311
1136635,6,3,9,48,11,6,65,200,43,308
1136636,0,0,0,71,21,4,96,278,46,420
1136637,7,0,7,65,18,0,83,214,34,331
1136638,7,0,7,62,18,0,80,289,26,395
1136639,8,3,11,48,21,6,75,163,12,250
1136640,6,0,6,60,17,3,80,186,17,283
1136641,0,0,0,0,0,0,0,4,0,4
1136642,3,0,3,70,33,0,103,272,25,400
1136643,6,0,6,60,15,0,75,200,26,301
1136644,0,0,0,3,0,0,3,9,0,12
1136645,8,0,8,64,16,0,80,229,32,341
1136646,3,3,6,45,14,3,62,171,26,259
1136647,0,0,0,49,7,0,56,140,15,211
1136648,3,0,3,34,20,0,54,150,16,220
1136701,11,0,11,56,16,3,75,232,7,314
1136702,12,4,16,69,28,0,97,299,42,438
1136703,7,5,12,54,18,0,72,165,25,262
1136704,6,0,6,75,40,0,115,256,9,380
1136705,0,3,3,30,15,0,45,85,10,140
1136706,3,3,6,37,22,0,59,173,28,260
1136707,8,0,8,85,29,0,114,222,35,371
1136708,6,3,9,55,16,3,74,211,12,297
1136709,6,0,6,55,10,0,65,191,27,283
1136710,14,27,41,37,12,0,49,148,49,246
1136711,9,0,9,73,16,0,89,221,28,338
1136712,6,55,61,81,34,0,115,200,120,435
1136713,12,0,12,99,30,0,129,335,47,511
1136714,13,0,13,56,24,3,83,199,27,309
1136715,13,0,13,41,26,0,67,226,59,352
1136716,9,3,12,74,16,0,90,217,55,362
1136717,6,3,9,78,27,6,111,231,26,368
1136718,11,6,17,100,32,0,132,272,25,429
1136719,7,0,7,79,10,3,92,191,29,312
1136720,6,0,6,113,37,3,153,304,30,487
1136721,3,0,3,97,15,3,115,272,41,428
1136722,3,0,3,113,26,0,139,220,27,386
1136723,0,0,0,116,17,0,133,249,60,442
1136724,0,0,0,117,21,0,138,293,52,483
1136725,4,3,7,106,23,0,129,227,25,381
1136726,3,0,3,83,33,3,119,245,48,412
1136727,12,4,16,94,44,6,144,296,43,483
1136728,4,0,4,82,36,0,118,252,39,409
1136801,0,3,3,49,20,3,72,106,18,196
1136802,0,0,0,67,13,4,84,191,16,291
1136803,103,0,103,50,19,0,69,331,7,407
1136804,0,0,0,64,10,0,74,333,15,422
1136805,3,0,3,41,3,0,44,168,20,232
1136806,3,0,3,80,12,0,92,392,31,515
1136807,0,0,0,71,3,5,79,265,18,362
1136808,4,0,4,68,28,0,96,376,15,487
1136809,6,0,9,77,29,3,109,249,36,394
1136810,9,3,12,80,21,0,101,267,21,389
1136811,3,0,3,66,14,0,80,209,18,307
1136812,8,0,8,111,28,0,139,270,30,439
1136813,3,3,6,77,25,3,105,224,12,341
1136814,6,0,6,70,30,3,103,231,4,338
1136815,6,6,12,92,22,0,114,319,31,464
1136816,3,0,3,61,18,0,79,186,18,283
1136817,6,0,6,124,12,0,136,606,38,780
1136818,6,3,9,73,25,0,98,195,24,317
1136819,8,4,12,84,23,0,107,248,50,405
1136820,6,0,6,72,39,0,111,329,39,479
1136821,10,3,13,61,42,0,103,201,13,317
1136822,40,6,46,73,25,0,98,207,18,323
1136823,4,0,4,51,13,0,64,156,12,232
1136824,9,0,9,60,38,0,98,284,21,403
1136825,6,0,6,80,16,0,96,293,36,425
1136826,3,0,3,122,43,0,165,324,17,506
1136827,6,0,6,78,12,0,90,167,15,272
1136828,3,0,3,72,8,0,80,283,10,373
1136829,6,0,6,75,15,0,90,460,23,573
1136830,6,0,6,73,21,0,94,280,24,398
1136831,3,0,3,69,15,3,87,311,42,440
1136832,4,0,4,110,18,0,128,448,52,628
1136833,3,3,6,71,26,0,97,228,34,359
1136834,3,0,7,61,31,3,95,267,14,376
1136835,30,3,33,81,35,3,119,271,39,429
1136836,0,0,0,60,16,7,83,160,18,261
1136837,6,0,6,53,24,0,77,189,13,279
1136838,4,0,4,73,19,0,92,176,18,286
1136839,3,0,3,68,25,6,99,252,11,362
1136840,11,0,11,73,24,0,97,259,36,392
1136841,12,3,15,98,32,3,133,276,23,432
1136842,0,0,0,66,20,0,86,240,18,344
1136843,7,0,7,125,28,3,156,420,24,600
1136901,8,0,8,58,22,0,80,118,4,202
1136902,6,6,12,62,34,0,96,242,27,365
1136903,5,6,11,64,19,0,83,306,26,415
1136904,0,0,0,0,0,0,0,0,0,0
1136905,0,4,4,41,15,0,56,214,10,280
1136906,3,0,3,69,17,4,90,293,44,427
1136907,0,0,0,78,20,3,101,373,18,492
1136908,6,3,9,65,18,0,83,329,25,437
1136909,0,0,0,100,31,0,131,267,15,413
1136910,6,0,6,109,19,6,134,304,23,461
1136911,14,0,14,99,31,0,130,241,28,399
1136912,5,0,5,56,40,3,99,235,15,349
1136913,18,5,23,66,26,3,95,196,25,316
1136914,6,0,6,102,46,0,148,325,11,484
1136915,7,3,10,64,20,0,84,171,23,278
1136916,12,3,15,77,26,7,110,191,20,321
1136917,18,0,18,71,26,6,103,230,9,342
1136918,13,3,16,87,27,3,117,276,24,417
1136919,5,0,5,63,27,0,90,205,26,321
1136920,0,0,0,44,12,0,56,143,20,219
1136921,86,0,86,71,21,0,92,387,23,502
1136922,17,0,17,105,20,9,134,262,13,409
1136923,12,0,12,93,37,3,133,233,22,388
1136924,3,6,9,70,20,0,90,199,25,314
1136925,4,0,4,62,22,0,84,275,20,379
1136926,6,3,9,72,11,0,83,315,27,425
1136927,11,0,11,132,24,0,156,409,28,593
1136928,0,3,3,154,18,0,172,380,53,605
1136929,4,0,4,108,25,9,142,379,43,564
1136930,0,0,0,73,17,0,90,297,29,416
1136931,3,0,3,59,31,0,90,209,20,319
1136932,0,3,3,58,26,0,84,205,24,313
1136933,8,3,11,137,27,3,167,439,27,633
1136934,5,3,8,49,14,3,66,170,18,254
1136935,5,0,5,92,31,3,126,268,30,424
1136936,7,3,10,73,28,0,101,271,15,387
1136937,37,8,45,78,36,0,114,364,39,517
1136938,10,0,10,42,31,0,73,251,25,349
1136939,15,5,20,80,40,3,123,199,26,348
1136940,46,5,51,40,15,0,55,203,11,269
1136941,3,3,6,58,21,0,79,188,9,276
1136942,10,0,10,109,26,4,139,256,8,403
1136943,6,0,6,54,11,0,65,147,10,222
1136944,8,0,8,66,30,0,96,200,8,304
1136945,10,6,19,90,38,0,128,318,19,465
1136946,12,0,12,85,41,0,126,254,9,389
1136947,0,0,0,0,0,0,0,0,0,0
1136948,7,3,10,81,37,7,125,218,9,352
1136949,3,0,3,43,13,0,56,109,6,171
1136950,22,0,22,119,23,0,142,238,12,392
1137001,15,0,18,37,19,3,59,86,18,163
1137002,12,0,12,72,31,3,106,217,15,338
1137003,9,0,9,58,15,0,73,163,13,249
1137004,0,0,0,58,19,0,77,197,36,310
1137005,5,0,5,52,15,6,73,187,32,292
1137006,9,3,12,56,24,3,83,227,55,365
1137007,3,3,6,66,18,0,84,260,37,381
1137008,0,0,0,51,15,3,69,176,56,301
1137009,6,4,10,51,19,4,74,224,19,317
1137010,9,4,13,74,25,0,99,276,27,402
1137011,10,0,10,86,40,3,129,317,46,492
1137012,3,3,6,46,15,3,64,186,33,283
1137013,7,0,7,35,10,3,48,127,3,178
1137014,10,0,10,86,17,0,103,233,73,409
1137015,7,0,7,42,23,0,65,237,29,331
1137016,0,3,3,32,13,0,45,186,84,315
1137017,5,0,5,76,18,0,94,226,26,346
1137018,10,0,10,113,46,3,162,269,27,458
1137019,10,6,16,132,26,3,161,396,48,605
1137020,8,0,8,71,19,3,93,217,37,347
1137021,68,3,71,61,16,0,77,217,13,307
1137022,11,0,11,69,13,0,82,192,5,279
1137023,15,0,15,58,29,0,87,196,27,310
1137024,23,3,26,83,35,3,121,283,31,435
1137025,16,0,16,83,29,3,115,280,15,410
1137026,18,0,18,104,34,0,138,360,48,546
1137027,9,4,13,48,15,0,63,196,10,269
1137028,13,3,16,53,21,0,74,263,27,364
1137029,9,0,9,69,25,0,94,215,14,323
1137030,6,0,6,51,13,3,67,263,57,387
1137101,3,0,3,38,10,0,48,154,6,208
1137102,16,0,16,43,25,0,68,193,9,270
1137103,6,0,9,39,19,0,58,150,4,212
1137104,6,0,6,76,22,3,101,195,9,305
1137105,6,3,9,69,27,0,96,181,21,298
1137106,51,6,57,26,15,0,41,196,25,262
1137107,0,0,0,90,34,3,127,307,21,455
1137108,14,3,17,94,46,0,140,335,25,500
1137109,9,3,12,82,37,0,119,259,33,411
1137110,11,0,11,93,26,3,122,261,36,419
1137111,17,3,20,67,31,0,98,258,15,371
1137112,10,0,10,71,27,0,98,223,15,336
1137113,6,0,6,58,34,4,96,229,16,341
1137114,11,3,14,70,23,0,93,220,27,340
1137115,4,0,4,85,22,0,107,228,35,370
1137116,8,0,8,61,10,9,80,158,15,253
1137117,6,0,6,39,21,0,60,117,6,183
1137118,6,0,6,71,28,3,102,250,15,367
1137119,4,0,4,82,23,0,105,211,9,325
1137120,7,0,7,91,30,5,126,245,15,386
1137121,3,0,3,71,18,3,92,211,29,332
1137122,7,0,7,50,21,6,77,193,13,283
1137123,6,0,6,38,8,3,49,123,8,180
1137124,3,0,3,36,4,0,40,113,0,153
1137125,9,0,9,70,31,3,104,177,18,299
1137126,5,6,11,87,22,3,112,298,27,437
1137127,15,0,15,59,17,3,79,239,26,344
1137128,15,0,15,88,24,0,112,190,19,321
1137129,9,0,9,79,29,6,114,156,9,279
1137130,5,0,5,65,22,3,90,186,13,289
1137131,0,0,0,62,16,0,78,120,0,198
1137201,9,0,9,107,44,0,151,299,8,458
1137202,10,4,14,90,31,7,128,246,28,402
1137203,6,0,6,77,37,0,114,222,15,351
1137204,0,3,3,6,0,0,6,18,9,33
1137205,6,3,9,51,23,0,74,174,9,257
1137206,12,0,12,86,49,12,147,283,19,449
1137207,0,0,0,54,31,4,89,239,12,340
1137208,4,0,4,75,63,4,142,194,10,346
1137209,0,0,0,0,3,0,3,3,0,6
1137210,85,7,92,66,19,0,85,291,37,413
1137211,6,0,6,55,26,3,84,185,16,285
1137212,6,3,9,73,32,0,105,173,27,305
1137213,12,6,18,102,29,7,138,250,27,415
1137214,11,0,11,89,23,0,112,214,21,347
1137215,9,0,9,57,21,0,78,153,27,258
1137216,10,0,10,84,30,3,117,287,56,460
1137217,3,6,9,21,5,3,29,102,34,165
1137218,19,5,24,114,31,0,145,330,28,503
1137219,17,0,17,101,40,5,146,306,22,474
1137220,10,6,16,56,21,9,86,181,15,282
1137221,5,0,5,79,42,6,127,261,20,408
1137222,9,0,9,37,27,3,67,162,25,254
1137223,10,3,13,89,36,0,125,232,13,370
1137224,7,0,7,45,27,3,75,154,12,241
1137225,0,3,3,53,22,9,84,139,7,230
1137226,3,3,6,42,33,0,75,149,6,230
1137227,82,15,97,20,11,0,31,235,31,297
1137228,0,3,3,43,14,0,57,161,30,248
1137229,8,0,8,58,17,7,82,193,3,278
1137230,3,0,3,105,41,10,156,293,6,455
1137231,6,0,6,91,46,0,137,234,9,380
1137232,11,4,15,96,40,0,136,268,27,431
1137233,6,3,9,37,17,0,54,172,15,241
1137234,0,0,0,51,39,3,93,193,20,306
1137235,69,5,74,39,9,4,52,253,32,337
1137236,4,0,4,44,24,0,68,187,16,271
1137237,6,0,6,69,29,0,98,247,21,366
1137238,6,4,10,112,32,3,147,277,19,443
1137239,9,0,12,44,28,0,72,181,17,270
1137240,3,0,3,36,20,6,62,211,24,297
1137241,7,0,7,54,11,0,65,181,10,256
1137242,7,0,7,36,31,0,67,167,6,240
1137243,3,0,3,38,30,6,74,132,4,210
1137244,3,0,3,37,20,0,57,215,0,272
1137245,0,0,0,56,20,0,76,164,3,243
1137301,4,0,4,35,9,3,47,179,52,278
1137302,0,3,3,95,25,6,126,325,49,500
1137303,0,0,0,101,26,0,127,282,41,450
1137304,10,3,13,115,29,0,144,338,54,536
1137305,12,0,12,34,8,7,49,175,11,235
1137306,8,3,11,57,17,0,74,177,21,272
1137307,0,0,0,0,0,0,0,0,0,0
1137308,3,0,3,19,6,0,25,158,30,213
1137309,4,0,4,38,3,3,44,253,49,346
1137310,0,0,0,14,0,0,14,113,48,175
1137311,0,0,0,0,0,0,0,0,0,0
1137312,8,3,11,13,6,0,19,256,61,336
1137313,4,3,7,40,10,0,50,225,70,345
1137314,8,3,11,39,15,0,54,156,49,259
1137315,0,0,0,0,0,0,0,0,0,0
1137316,15,3,18,103,22,0,125,348,39,512
1137317,8,0,8,58,21,0,79,227,40,346
1137318,12,5,17,100,17,6,123,312,20,455
1137319,11,0,11,63,37,5,105,270,46,421
1137320,6,0,6,28,24,0,52,141,26,219
1137321,7,0,7,35,24,0,59,216,21,296
1137322,12,0,12,66,18,0,84,249,38,371
1137323,8,3,11,86,13,0,99,274,37,410
1137324,10,6,16,44,26,3,73,250,88,411
1137325,4,3,7,84,27,0,111,285,59,455
1137401,0,4,4,77,10,0,87,258,22,367
1137402,3,4,7,100,18,0,118,380,22,520
1137403,6,0,6,69,3,0,72,219,16,307
1137404,3,3,6,54,3,0,57,153,16,226
1137405,0,0,3,43,18,0,61,147,13,221
1137406,0,0,0,137,38,0,175,393,46,614
1137407,5,0,5,69,13,3,85,173,9,267
1137408,3,3,6,75,27,0,102,263,25,390
1137409,6,0,6,53,12,0,65,198,24,287
1137410,0,0,0,61,12,0,73,227,10,310
1137411,9,3,12,34,12,0,46,173,12,231
1137412,3,0,6,44,12,0,56,138,17,211
1137413,23,0,23,87,28,0,115,268,8,391
1137414,21,6,27,84,7,0,91,231,30,352
1137415,6,0,6,46,10,0,56,148,14,218
1137416,73,6,82,78,20,3,101,342,36,479
1137417,4,0,4,86,33,3,122,292,34,448
1137418,45,3,48,69,22,0,91,279,33,403
1137419,18,0,18,62,18,0,80,199,3,282
1137420,0,0,0,34,0,0,34,299,24,357
1137421,8,0,8,57,31,0,88,369,15,472
1137422,5,0,5,67,7,0,74,269,34,377
1137423,0,0,0,63,10,0,73,201,27,301
1137424,3,0,3,39,22,3,64,143,33,240
1137425,6,0,6,44,0,0,44,308,34,386
1137426,0,0,0,43,7,0,50,209,22,281
1137427,3,0,3,83,18,0,101,342,13,456
1137428,3,0,3,55,3,0,58,217,19,294
1137429,3,0,3,110,26,3,139,374,40,553
1137430,12,3,15,69,30,0,99,288,15,402
1137431,4,0,4,48,10,0,58,129,9,196
1137432,4,3,7,50,13,0,63,141,10,214
1137433,9,0,9,92,17,7,116,218,21,355
1137434,10,0,10,63,16,6,85,225,9,319
1137435,0,4,4,46,19,0,65,136,7,208
1137436,10,0,10,79,12,3,94,203,21,318
1137437,12,6,18,98,43,0,141,269,26,436
1137438,8,3,11,76,24,0,100,172,16,288
1137439,13,0,13,66,47,3,116,254,20,390
1137440,6,0,6,32,9,3,44,114,15,173
1137441,9,5,14,69,24,3,96,201,24,321
1137442,11,0,11,96,40,0,136,285,24,445
1137443,5,0,5,69,18,0,87,196,14,297
1137444,3,6,9,40,18,0,58,148,12,218
1137445,7,0,7,58,33,0,91,233,22,346
1137446,23,4,27,86,19,0,105,264,21,390
1137447,3,0,3,66,12,0,78,231,24,333
1137448,10,0,10,68,25,3,96,159,16,271
1137449,13,0,13,63,21,0,84,238,6,328
1137450,0,0,0,38,15,0,53,135,11,199
1137451,5,0,5,29,12,0,41,90,15,146
1137452,7,3,10,103,53,3,159,200,6,365
1137453,0,0,0,0,0,0,0,0,0,0
1137454,47,3,50,39,8,3,50,186,27,263
1137455,3,0,3,40,29,0,69,177,9,255
1137456,6,0,6,61,18,0,79,156,3,238
1137457,3,0,7,51,26,6,83,262,10,355
1137458,7,0,7,82,31,0,113,238,16,367
1137501,7,0,7,53,25,0,78,244,6,328
1137502,0,0,0,100,45,0,145,265,17,427
1137503,7,0,7,67,27,4,98,287,35,420
1137504,6,0,6,52,16,3,71,138,16,225
1137505,6,0,6,68,24,7,99,407,63,569
1137506,0,0,0,51,4,0,55,133,23,211
1137507,7,3,10,58,12,4,74,202,49,325
1137508,0,0,0,0,0,0,0,0,0,0
1137509,0,0,0,71,22,0,93,464,59,616
1137510,31,0,31,86,22,3,111,310,50,471
1137511,3,0,3,87,28,3,118,234,31,383
1137512,3,0,3,97,31,6,134,213,19,366
1137513,3,0,3,74,26,6,106,249,38,393
1137514,7,3,10,74,33,0,107,304,33,444
1137515,0,0,0,20,0,3,23,114,16,153
1137516,0,0,0,60,15,0,75,493,50,618
1137517,4,0,4,4,3,0,7,25,3,35
1137518,11,0,11,95,20,9,124,260,40,424
1137519,0,0,0,101,29,0,130,768,56,954
1137520,0,0,0,51,6,0,57,229,49,335
1137521,0,0,0,0,0,0,0,0,0,0
1137522,7,0,10,70,24,0,94,244,39,377
1137523,3,3,10,69,21,3,93,175,14,282
1137524,3,3,6,53,27,3,83,189,18,290
1137525,13,0,13,47,21,0,68,153,34,255
1137526,7,0,7,43,27,3,73,197,28,298
1137527,59,12,71,14,10,0,24,232,42,298
1137528,0,0,3,37,25,5,67,215,29,311
1137529,0,0,0,53,19,3,75,153,15,243
1137530,0,0,0,42,6,3,51,112,9,172
1137531,8,0,8,58,18,15,91,275,31,397
1137532,9,0,9,74,22,3,99,247,33,379
1137533,6,0,6,69,28,3,100,204,25,329
1137534,7,0,7,73,27,0,100,278,51,429
1137535,3,3,6,54,13,0,67,185,57,309
1137601,5,3,8,63,18,0,81,174,12,267
1137602,9,0,9,86,21,3,110,278,32,420
1137603,5,3,8,67,23,0,90,230,27,347
1137604,3,0,3,57,17,3,77,173,32,282
1137605,11,0,11,70,27,0,97,223,15,335
1137606,3,0,3,98,18,0,116,280,40,436
1137607,7,0,7,53,10,0,63,143,20,226
1137608,4,0,4,155,24,0,179,344,55,578
1137609,6,0,6,34,14,0,48,96,9,153
1137610,6,0,6,81,25,3,109,211,25,345
1137611,3,3,6,35,10,3,48,135,10,193
1137612,31,0,31,27,9,0,36,174,4,214
1137613,0,0,0,52,31,0,83,169,13,265
1137614,54,3,57,81,27,6,114,384,27,525
1137615,8,0,8,75,23,0,98,275,30,403
1137616,3,0,3,89,22,3,114,336,40,490
1137617,0,0,0,58,13,9,80,339,38,457
1137618,3,0,3,66,10,0,76,194,42,312
1137619,0,0,0,75,12,0,87,228,64,379
1137620,36,0,36,48,15,0,63,238,29,330
1137621,6,0,6,52,18,0,70,133,3,206
1137622,3,0,3,58,11,0,69,124,12,205
1137623,6,3,9,34,16,0,50,186,9,245
1137624,3,0,3,86,31,3,120,269,15,404
1137625,6,0,6,77,34,0,111,282,17,410
1137626,5,3,8,126,43,4,173,225,15,413
1137627,5,3,8,97,29,0,126,336,32,494
1137628,7,6,13,90,40,0,130,223,22,375
1137629,3,0,3,50,7,0,57,189,25,271
1137630,0,0,0,81,31,0,112,358,22,492
1137631,4,0,4,74,13,0,87,227,11,325
1137632,5,0,5,92,24,6,122,288,24,434
1137633,64,5,69,58,35,3,96,326,16,438
1137634,0,0,0,61,32,0,93,226,26,345
1137635,0,0,0,85,16,0,101,223,28,352
1137636,0,4,4,92,9,0,101,303,48,452
1137637,0,0,0,51,3,3,57,172,17,246
1137638,28,3,31,82,21,0,103,321,49,473
1137639,3,0,3,68,22,6,96,254,26,376
1137640,4,4,8,72,57,0,129,260,43,432
1137641,3,4,7,101,20,0,121,327,41,489
1137642,25,4,29,98,23,0,121,286,29,436
1137643,0,0,0,69,22,3,94,205,34,333
1137644,6,0,9,79,36,9,124,220,23,367
1137645,6,0,6,67,24,6,97,222,24,343
1137646,0,0,0,33,9,3,45,124,9,178
1137647,3,0,3,86,18,0,104,255,34,393
1137648,12,0,12,63,28,0,91,271,18,380
1137649,6,0,6,70,24,0,94,195,9,298
1137650,0,0,0,69,15,4,88,155,32,275
1137651,7,3,10,77,28,6,111,230,38,379
1137652,4,3,7,75,19,0,94,162,30,286
1137653,9,3,12,84,17,7,108,204,21,333
1137654,4,0,4,80,21,0,101,218,44,363
1137655,9,3,12,77,20,0,97,185,21,303
1137656,9,0,9,97,31,0,128,272,9,409
1137657,44,4,48,68,19,3,90,262,26,378
1137701,14,0,14,39,12,0,51,208,18,277
1137702,7,0,7,40,12,0,52,154,10,216
1137703,10,0,10,30,9,0,39,143,0,182
1137704,11,3,17,47,14,0,61,221,36,318
1137705,6,6,12,68,20,0,88,182,12,282
1137706,7,3,10,46,22,0,68,123,29,220
1137707,21,0,21,76,24,0,100,243,14,357
1137708,0,0,0,74,25,0,99,172,21,292
1137709,0,0,0,47,16,0,63,143,12,218
1137710,10,0,10,48,16,0,64,183,22,269
1137711,0,0,3,32,17,0,49,119,12,180
1137712,7,0,7,55,12,0,67,152,14,233
1137713,3,0,3,45,15,0,60,156,20,236
1137714,9,0,9,79,26,0,105,208,14,327
1137715,15,6,21,62,23,3,88,200,18,306
1137716,4,0,4,60,13,0,73,149,6,228
1137717,3,0,6,41,20,0,61,164,7,232
1137718,11,5,16,62,25,0,87,207,13,307
1137719,16,0,16,41,30,0,71,243,29,343
1137720,8,0,8,37,7,3,47,146,3,196
1137721,10,6,16,75,21,0,96,218,49,363
1137722,11,0,11,77,27,3,107,297,39,443
1137723,7,6,13,50,29,3,82,172,46,300
1137724,15,3,18,70,19,0,89,224,21,334
1137725,14,0,14,75,19,6,100,160,20,280
1137726,3,0,3,51,32,6,89,90,10,189
1137727,11,3,14,98,38,3,139,307,36,482
1137728,14,0,14,77,14,6,97,205,13,315
1137729,6,0,6,119,30,6,155,303,12,470
1137730,7,0,7,68,20,9,97,213,10,320
1137731,0,0,0,30,12,0,42,137,3,182
1137732,12,0,12,51,14,0,65,152,10,227
1137733,11,0,11,47,25,6,78,203,12,293
1137734,6,3,9,69,24,0,93,156,16,265
1137801,0,0,0,53,22,0,75,108,30,213
1137802,10,0,10,87,16,0,103,294,40,437
1137803,6,0,6,82,12,0,94,240,42,376
1137804,8,4,12,46,10,0,56,162,36,254
1137805,6,3,9,84,18,0,102,239,31,372
1137806,4,0,4,98,0,0,98,286,65,449
1137807,0,0,0,74,11,0,85,204,28,317
1137808,8,0,8,73,16,3,92,231,17,340
1137809,0,0,0,0,0,0,0,0,0,0
1137810,9,3,12,64,19,3,86,167,27,280
1137811,49,4,53,74,24,0,98,235,28,361
1137812,0,0,0,0,0,0,0,0,0,0
1137813,9,3,16,78,17,6,101,259,28,388
1137814,7,5,12,33,16,0,49,117,8,174
1137815,0,0,0,0,0,0,0,3,0,3
1137816,6,0,9,62,26,3,91,221,6,318
1137817,5,3,8,73,22,0,95,257,33,385
1137818,3,0,3,58,8,0,66,140,21,227
1137819,5,0,5,85,13,0,98,263,54,415
1137820,4,0,4,38,12,0,50,123,4,177
1137821,5,6,11,58,22,0,80,181,22,283
1137822,5,0,5,89,25,3,117,293,25,435
1137823,3,0,3,38,6,0,44,159,25,228
1137824,0,0,0,38,3,0,41,171,6,218
1137825,0,0,0,69,15,0,84,286,36,406
1137826,0,0,0,128,16,3,147,353,58,558
1137827,3,3,6,56,15,0,71,229,41,341
1137901,0,0,0,38,15,6,59,185,16,260
1137902,4,0,4,67,34,0,101,330,40,471
1137903,8,0,8,98,10,0,108,358,26,492
1137904,3,0,3,124,26,0,150,405,37,592
1137905,3,0,3,45,5,0,50,217,18,285
1137906,3,0,3,72,17,0,89,336,33,458
1137907,13,0,13,122,30,0,152,312,35,499
1137908,3,3,6,51,23,3,77,192,18,287
1137909,0,0,0,61,26,3,90,113,20,223
1137910,3,0,3,52,30,3,85,160,15,260
1137911,3,0,3,51,22,0,73,150,18,241
1137912,7,3,10,126,37,0,163,434,21,618
1137913,0,0,0,64,7,0,71,260,25,356
1137914,5,0,5,46,4,0,50,138,48,236
1137915,12,3,15,59,30,0,89,270,51,410
1137916,0,0,0,30,18,0,48,101,9,158
1137917,6,3,9,77,24,0,101,191,21,313
1137918,3,0,3,81,38,0,119,286,33,438
1137919,5,0,5,85,20,0,105,370,33,508
1137920,4,0,4,80,14,0,94,241,28,363
1137921,6,0,6,73,22,0,95,290,30,415
1137922,10,3,13,70,24,3,97,129,10,236
1137923,14,6,20,100,24,4,128,226,23,377
1137924,0,0,0,61,18,0,79,143,9,231
1137925,19,7,26,66,18,0,84,243,29,356
1137926,0,3,3,0,0,0,0,0,3,3
1137927,9,3,12,49,6,3,58,131,9,198
1137928,3,0,3,33,22,3,58,127,7,192
1137929,3,3,6,37,20,3,60,198,13,271
1137930,8,3,14,85,26,0,111,220,15,346
1137931,6,0,6,46,21,0,67,165,14,246
1137932,11,3,14,60,16,0,76,176,15,267
1137933,10,0,10,85,30,4,119,266,15,400
1137934,3,0,3,62,14,0,76,263,32,371
1137935,5,4,9,90,21,0,111,246,20,377
1137936,18,0,18,46,8,0,54,189,4,247
1137937,10,0,10,68,13,0,81,130,8,219
1138001,10,0,10,58,30,4,92,231,41,364
1138002,38,0,38,73,26,0,99,262,36,397
1138003,3,4,7,30,20,3,53,160,10,223
1138004,6,0,6,44,10,0,54,139,32,225
1138005,4,4,8,58,16,0,74,179,18,271
1138006,7,0,7,50,25,0,75,185,33,293
1138007,9,0,9,40,26,4,70,199,24,293
1138008,8,5,13,89,26,0,115,196,27,338
1138009,20,0,20,64,36,0,100,278,21,399
1138010,14,0,14,95,34,0,129,313,26,468
1138011,8,0,8,64,27,3,94,363,42,499
1138012,6,0,6,29,9,3,41,110,0,151
1138013,3,3,6,48,16,0,64,174,16,254
1138014,13,0,13,64,20,0,84,289,56,429
1138015,11,3,14,26,16,0,42,141,9,192
1138016,5,0,5,33,18,0,51,146,38,235
1138017,6,6,12,56,21,0,77,315,65,457
1138018,12,3,15,70,24,0,94,351,30,475
1138019,6,0,6,59,40,0,99,247,33,379
1138020,7,0,7,85,16,6,107,250,50,407
1138021,5,0,5,31,14,0,45,186,39,270
1138022,16,0,16,45,32,6,83,243,36,362
1138023,7,0,7,80,22,3,105,336,66,507
1138024,3,0,3,65,12,0,77,250,51,378
1138025,6,5,11,47,4,0,51,177,26,254
1138026,6,9,15,93,19,3,115,319,62,496
1138027,13,6,19,75,31,3,109,298,32,439
1138028,6,0,9,65,42,6,113,253,36,402
1138029,7,0,7,36,13,3,52,204,16,272
1138030,6,5,11,88,28,6,122,211,16,349
1138031,9,4,13,71,24,0,95,194,35,324
1138032,7,4,11,37,15,0,52,145,19,216
1138101,3,0,3,25,15,0,40,199,55,294
1138102,107,0,107,20,10,0,30,236,26,292
1138103,36,3,39,26,9,0,35,238,43,316
1138104,4,0,4,57,21,0,78,326,51,455
1138105,7,0,7,73,14,4,91,389,94,574
1138106,0,3,3,32,15,0,47,161,21,229
1138107,0,0,0,47,9,0,56,127,9,192
1138108,3,0,6,34,14,0,48,114,20,182
1138109,11,3,14,53,23,3,79,246,34,359
1138110,4,0,4,27,14,3,44,161,11,216
1138111,8,0,8,89,34,0,123,273,28,424
1138112,0,0,0,57,10,0,67,151,64,282
1138113,9,0,9,51,10,3,64,205,23,292
1138114,6,0,6,65,39,0,104,196,17,317
1138115,0,0,0,0,0,0,0,0,0,0
1138116,4,3,7,43,22,0,65,185,35,285
1138117,15,0,15,64,33,5,102,259,38,399
1138118,9,5,14,73,34,0,107,332,53,492
1138119,3,3,6,92,10,7,109,454,166,729
1138120,0,0,0,27,17,0,44,92,30,166
1138121,4,0,4,47,25,3,75,219,63,357
1138122,3,0,3,48,9,0,57,164,31,252
1138123,6,0,6,97,23,0,120,520,94,734
1138124,6,0,6,82,15,0,97,300,41,438
1138125,3,0,3,58,6,0,64,161,17,242
1138126,0,4,4,70,9,0,79,240,48,367
1138127,3,0,3,31,7,0,38,191,33,262
1138128,0,0,0,0,3,0,3,9,0,12
1138129,0,0,0,39,6,0,45,240,38,323
1138130,0,0,0,92,21,4,117,609,62,788
1138131,6,0,6,51,18,0,69,301,44,414
1138132,0,0,0,52,11,0,63,210,49,322
1138133,7,0,7,81,19,0,100,401,44,545
1138134,47,0,51,76,31,0,107,377,31,515
1138135,6,3,12,53,33,0,86,136,3,225
1138136,6,0,6,63,11,3,77,176,29,282
1138137,0,3,3,92,25,6,123,256,26,405
1138138,3,0,3,66,22,0,88,206,40,334
1138139,0,0,0,0,0,0,0,11,4,15
1138140,4,0,4,63,12,0,75,196,24,295
1138141,9,0,9,45,9,0,54,174,10,238
1138142,3,0,3,40,16,0,56,167,10,233
1138143,5,0,5,37,4,0,41,123,15,179
1138144,40,5,45,39,13,5,57,267,26,350
1138145,0,0,0,75,13,0,88,222,60,370
1138146,0,0,0,28,6,0,34,145,38,217
1138147,0,3,3,63,34,0,97,213,30,340
1138201,6,3,9,26,21,0,47,123,6,176
1138202,20,3,23,46,12,0,58,232,32,322
1138203,4,0,4,73,18,0,91,239,24,354
1138204,4,0,4,31,18,0,49,128,15,192
1138205,13,0,13,58,25,0,83,238,15,336
1138206,17,0,17,82,12,3,97,248,20,365
1138207,13,7,20,87,22,0,109,368,50,527
1138208,5,0,5,77,35,5,117,248,40,405
1138209,3,0,3,67,31,3,101,171,29,301
1138210,13,0,13,74,26,0,100,179,18,297
1138211,8,0,8,58,18,0,76,211,33,320
1138212,16,7,26,44,28,0,72,212,39,323
1138213,25,5,30,21,13,0,34,115,21,170
1138214,23,7,30,65,23,6,94,269,36,399
1138215,15,3,18,49,21,0,70,176,12,258
1138216,7,3,10,24,13,0,37,141,10,188
1138217,7,3,10,72,29,0,101,245,28,374
1138218,12,0,12,30,18,0,48,174,15,237
1138219,7,0,7,79,18,0,97,206,8,311
1138220,9,3,12,73,20,0,93,223,15,331
1138221,10,3,13,47,17,3,67,176,6,249
1138222,14,6,20,75,30,9,114,290,48,452
1138223,3,0,3,55,24,6,85,181,35,301
1138224,16,6,22,69,23,5,97,302,37,436
1138225,12,5,17,67,16,4,87,239,24,350
1138226,11,7,18,47,13,0,60,165,29,254
1138227,20,8,28,42,23,4,69,203,40,312
1138228,14,6,20,64,24,3,91,223,21,335
1138229,20,6,26,97,44,0,141,368,34,543
1138230,13,0,13,56,44,0,100,265,20,385
1138231,7,0,7,40,24,4,68,141,8,217
1138232,3,0,3,51,10,0,61,160,25,246
1138233,3,3,6,58,25,0,83,188,25,296
1138234,5,0,5,52,17,6,75,230,39,344
1138235,6,0,6,82,25,3,110,184,24,318
1138236,13,6,19,82,24,0,106,257,36,399
1138237,9,0,9,62,22,0,84,132,16,232
1138238,7,9,16,59,15,0,74,198,17,289
1138239,9,5,14,45,12,0,57,124,15,196
1138301,49,11,60,75,14,0,89,361,52,502
1138302,8,0,8,91,24,0,115,202,15,332
1138303,0,0,0,0,0,0,0,0,0,0
1138304,7,0,7,56,15,0,71,147,11,229
1138305,0,0,0,0,0,0,0,0,0,0
1138306,6,0,6,94,22,0,116,242,18,376
1138307,10,0,10,87,41,4,132,269,21,422
1138308,6,0,6,67,13,4,84,192,9,285
1138309,7,0,7,50,21,0,71,230,27,328
1138310,4,0,4,63,18,0,81,207,18,306
1138311,3,0,6,62,18,3,83,177,19,279
1138312,4,0,4,85,23,3,111,253,11,375
1138313,0,0,0,61,42,3,106,146,12,264
1138314,6,0,6,48,29,0,77,345,35,457
1138315,0,0,0,99,39,0,138,225,23,386
1138316,6,6,12,55,13,0,68,166,9,243
1138317,7,0,7,44,18,3,65,157,3,225
1138318,3,0,3,39,4,0,43,122,9,174
1138319,3,0,3,77,38,0,115,283,35,433
1138320,0,0,0,90,56,0,146,455,42,643
1138321,0,0,0,45,32,0,77,221,23,321
1138322,9,0,9,69,36,4,109,233,25,367
1138323,42,0,42,78,20,0,98,257,12,367
1138324,6,0,6,61,12,6,79,248,15,342
1138325,6,0,6,74,17,3,94,315,12,421
1138326,13,3,16,88,34,0,122,263,18,403
1138327,7,3,10,81,18,0,99,143,6,248
1138328,0,3,3,51,35,6,92,253,36,381
1138329,6,0,6,83,40,0,123,319,39,481
1138330,9,3,12,81,36,3,120,279,24,423
1138331,17,3,20,95,20,0,115,238,42,395
1138332,0,0,0,0,0,0,0,0,0,0
1138333,5,0,5,42,35,0,77,217,18,312
1138334,4,6,10,80,37,6,123,259,42,424
1138335,6,0,6,88,24,3,115,287,40,442
1138336,0,0,0,0,0,0,0,0,0,0
1138337,11,0,11,89,28,5,122,258,23,403
1138338,6,0,6,98,34,0,132,216,20,368
1138339,4,0,4,54,31,0,85,185,13,283
1138340,0,0,0,117,33,0,150,303,18,471
1138341,7,6,13,68,24,4,96,199,30,325
1138342,3,0,3,37,7,0,44,108,18,170
1138343,0,0,0,19,28,0,47,134,18,199
1138344,7,0,7,146,41,0,187,381,38,606
1138345,4,0,4,65,28,0,93,200,23,316
1138346,0,0,0,0,0,0,0,0,0,0
1138347,11,6,17,95,35,4,134,213,30,377
1138348,11,0,11,86,28,0,114,257,27,398
1138349,3,0,3,72,56,4,132,310,47,489
1138401,10,3,13,57,18,0,75,153,15,243
1138402,4,0,4,58,25,9,92,233,43,368
1138403,0,0,0,60,7,3,70,166,15,251
1138404,0,0,0,39,3,0,42,114,3,159
1138405,0,0,0,0,0,0,0,0,0,0
1138406,3,0,3,65,23,0,88,156,10,254
1138407,12,3,15,82,32,6,120,309,35,464
1138408,4,0,4,90,30,0,120,282,15,417
1138409,7,0,7,56,17,0,73,161,15,249
1138410,7,0,7,63,20,0,83,230,28,341
1138411,11,4,15,65,6,0,71,209,9,289
1138412,0,0,0,3,0,0,3,22,0,25
1138413,0,0,0,0,0,0,0,0,0,0
1138414,0,0,0,0,0,0,0,0,0,0
1138415,0,0,0,66,17,0,83,103,30,216
1138416,4,0,4,383,52,0,435,1875,251,2561
1138417,0,0,0,69,9,0,78,163,36,277
1138418,6,0,6,70,24,9,103,236,25,364
1138419,9,0,9,92,32,3,127,262,21,410
1138420,5,0,5,63,16,6,85,209,11,305
1138421,0,0,0,59,3,9,71,186,18,275
1138422,0,0,0,57,12,0,69,147,28,244
1138423,0,0,0,108,15,3,126,211,22,359
1138424,0,0,0,176,22,3,201,486,51,738
1138425,3,0,3,118,25,3,146,802,155,1103
1138426,0,0,0,0,0,0,0,0,0,0
1138427,12,0,12,107,16,4,127,472,300,899
1138428,0,0,0,75,17,0,92,182,0,274
1138429,4,0,4,77,20,3,100,191,13,304
1138430,3,4,7,66,17,0,83,177,20,280
1138431,6,0,6,62,4,5,71,245,23,339
1138432,0,0,0,0,0,0,0,35,21,56
1138433,5,0,5,67,28,0,95,238,26,359
1138434,8,3,11,87,20,6,113,337,47,497
1138435,11,0,11,96,26,0,122,242,19,383
1138436,9,3,12,73,17,6,96,228,24,348
1138437,37,3,40,43,23,0,66,206,30,302
1138438,12,0,12,58,20,0,78,239,18,335
1138439,0,0,0,73,13,0,86,552,120,758
1138440,0,0,0,0,6,0,6,42,7,55
1138501,9,3,12,43,25,0,68,250,70,388
1138502,6,3,9,46,18,3,67,190,19,276
1138503,13,0,13,41,29,3,73,288,68,429
1138504,15,3,18,47,25,3,75,295,55,425
1138505,9,3,12,55,16,0,71,265,38,374
1138506,0,0,0,52,22,0,74,234,35,343
1138507,15,0,15,71,24,5,100,307,67,474
1138508,9,0,9,66,27,0,93,231,18,342
1138509,7,0,7,63,27,0,90,204,12,306
1138510,14,61,78,27,23,0,50,155,118,323
1138511,15,0,15,58,25,0,83,180,18,281
1138512,3,3,6,81,25,4,110,205,18,333
1138513,36,0,36,59,9,3,71,253,27,351
1138514,3,0,3,77,36,4,117,178,13,308
1138515,6,3,9,32,12,3,47,135,18,200
1138516,7,3,10,71,15,0,86,192,24,302
1138517,6,0,6,66,27,6,99,181,6,286
1138518,8,0,8,55,21,3,79,211,16,306
1138519,0,0,0,61,25,0,86,355,16,457
1138520,7,5,15,82,18,3,103,211,32,346
1138521,3,3,6,77,15,3,95,216,45,356
1138522,9,0,9,51,24,0,75,179,30,284
1138523,8,3,11,61,20,3,84,267,64,415
1138524,34,4,38,68,17,3,88,196,22,306
1138525,7,0,7,51,22,0,73,199,8,280
1138526,0,4,4,84,22,0,106,200,17,323
1138527,3,3,6,105,24,4,133,221,13,367
1138528,10,0,10,69,33,0,102,309,34,445
1138529,5,0,5,44,19,0,63,232,34,329
1138530,5,0,5,67,12,0,79,120,3,202
1138531,10,0,10,91,23,0,114,225,24,363
1138532,17,8,25,89,13,0,102,182,26,310
1138533,6,5,11,63,16,3,82,179,8,269
1138534,6,0,6,93,18,0,111,162,26,299
1138535,8,0,8,68,22,0,90,219,16,325
1138536,3,0,3,68,17,0,85,190,26,301
1138537,3,0,3,66,15,0,81,279,51,411
1138538,11,0,11,90,32,0,122,233,13,368
1138539,0,0,0,40,11,4,55,147,6,208
1138540,8,3,11,75,25,3,103,283,23,409
1138541,13,6,19,68,19,3,90,162,18,270
1138542,7,0,7,52,35,0,87,293,49,429
1138543,5,3,8,136,22,0,158,236,19,413
1138601,8,0,8,53,13,9,75,186,15,276
1138602,3,0,3,43,24,3,70,196,12,278
1138603,12,3,15,64,41,3,108,352,45,505
1138604,5,6,14,76,32,3,111,267,33,411
1138605,3,0,3,45,12,6,63,208,8,279
1138606,0,0,0,65,23,3,91,206,18,315
1138607,7,0,7,70,56,6,132,259,38,429
1138608,0,0,0,36,15,0,51,175,15,241
1138609,18,0,18,64,34,0,98,331,42,471
1138610,0,0,0,55,16,4,75,138,10,223
1138611,0,0,0,85,30,0,115,259,19,393
1138612,0,0,0,0,0,0,0,0,0,0
1138613,4,0,4,83,44,4,131,256,31,418
1138614,6,3,9,44,11,0,55,168,18,241
1138615,7,3,10,108,23,3,134,191,19,344
1138616,9,0,9,80,37,0,117,343,17,477
1138617,11,0,11,59,19,0,78,250,11,339
1138618,3,0,3,80,19,0,99,181,19,299
1138619,3,0,3,0,0,0,0,6,0,6
1138620,4,0,4,69,22,13,104,205,8,317
1138621,4,0,4,45,13,0,58,124,3,185
1138622,6,0,6,57,27,4,88,189,15,292
1138623,0,4,4,65,25,0,90,266,32,388
1138624,9,0,9,49,29,0,78,251,33,362
1138625,3,0,3,57,24,0,81,115,13,209
1138626,7,0,7,68,21,0,89,200,27,316
1138627,0,6,6,40,10,0,50,145,10,205
1138628,10,0,10,67,42,0,109,276,29,414
1138629,13,0,13,87,27,3,117,256,35,408
1138630,7,0,7,45,13,0,58,132,9,199
1138631,0,0,0,0,0,0,0,0,0,0
1138632,7,3,10,84,30,3,117,196,23,336
1138633,3,3,6,64,15,7,86,236,38,360
1138634,14,3,17,109,22,3,134,284,43,461
1138635,15,5,20,61,28,0,89,226,30,345
1138636,3,5,8,97,25,4,126,298,15,439
1138637,7,0,7,77,26,0,103,255,23,381
1138638,15,0,15,70,21,0,91,304,23,418
1138639,8,0,8,58,12,0,70,237,18,325
1138640,0,0,0,133,30,6,169,531,50,750
1138641,8,0,8,39,12,3,54,124,12,190
1138642,9,0,9,59,8,0,67,169,6,242
1138643,3,0,3,57,7,0,64,180,16,260
1138644,14,0,14,85,17,0,102,227,7,336
1138645,0,0,0,60,20,9,89,233,21,343
1138646,10,37,47,72,24,0,96,256,66,418
1138647,6,0,6,39,18,3,60,117,3,180
1138648,6,3,9,72,4,3,79,173,25,277
1138649,8,3,11,97,22,0,119,182,21,322
1138650,13,0,13,73,20,0,93,210,15,318
1138701,0,0,0,70,17,6,93,228,33,354
1138702,3,0,3,39,14,0,53,118,6,177
1138703,3,0,3,21,20,0,41,115,18,174
1138704,0,7,7,75,18,4,97,223,33,353
1138705,0,0,0,48,20,3,71,236,16,323
1138706,6,0,6,110,22,3,135,216,34,385
1138707,0,0,0,49,19,0,68,140,10,218
1138708,3,3,6,98,26,9,133,300,32,465
1138709,7,0,7,90,28,4,122,273,54,449
1138710,0,0,0,82,15,0,97,263,42,402
1138711,0,0,0,52,11,3,66,159,3,228
1138712,0,0,0,55,15,3,73,242,35,350
1138713,0,0,0,42,11,0,53,161,21,235
1138714,11,5,16,79,36,4,119,319,35,473
1138715,0,3,3,46,30,0,76,158,16,250
1138716,4,0,4,57,25,0,82,258,52,392
1138717,3,0,3,65,17,3,85,186,36,307
1138718,3,0,3,72,23,5,100,214,12,326
1138719,0,0,0,44,21,3,68,162,22,252
1138720,7,0,7,70,12,0,82,248,35,365
1138721,4,0,4,93,25,9,127,238,30,395
1138722,3,0,3,63,7,0,70,143,12,225
1138723,0,0,0,59,15,0,74,225,31,330
1138724,0,0,0,0,0,0,0,0,0,0
1138725,0,3,3,40,16,0,56,163,37,256
1138726,3,0,3,69,30,0,99,268,23,390
1138727,0,0,0,46,14,3,63,189,9,261
1138728,0,0,0,74,21,0,95,183,13,291
1138729,5,0,5,55,30,3,88,242,9,339
1138730,0,0,0,0,0,0,0,0,0,0
1138731,0,0,0,87,26,12,125,311,15,451
1138732,4,0,4,40,23,3,66,262,15,343
1138733,0,0,0,32,13,6,51,171,4,226
1138734,3,0,3,61,21,0,82,207,19,308
1138735,0,0,0,29,9,3,41,126,13,180
1138736,5,0,5,95,36,6,137,335,32,504
1138737,6,0,6,53,29,6,88,288,26,402
1138738,0,0,0,0,0,0,0,0,0,0
1138739,3,0,3,54,18,0,72,165,16,253
1138740,6,3,9,30,17,0,47,180,30,257
1138741,8,0,8,35,3,0,38,156,13,207
1138742,7,3,10,52,16,0,68,210,17,295
1138801,6,0,6,83,27,0,110,220,24,354
1138802,3,0,3,98,19,7,124,175,18,317
1138803,0,0,0,35,24,3,62,172,24,258
1138804,0,0,0,48,6,3,57,226,15,298
1138805,9,4,13,98,25,6,129,174,19,322
1138806,0,0,0,66,19,0,85,238,12,335
1138807,3,0,3,67,12,8,87,230,13,330
1138808,0,0,0,103,15,5,123,218,11,352
1138809,7,0,7,72,25,0,97,215,24,336
1138810,6,0,6,80,22,6,108,338,52,498
1138811,0,0,0,37,3,0,40,261,24,325
1138812,25,0,25,81,5,3,89,318,15,422
1138813,4,0,4,65,24,6,95,175,9,279
1138814,0,0,0,40,4,0,44,164,15,223
1138815,0,0,0,51,15,9,75,290,22,387
1138816,0,0,0,49,21,0,70,175,7,252
1138817,23,0,23,82,16,3,101,405,24,530
1138818,0,0,0,57,18,6,81,198,25,304
1138819,0,0,0,117,32,0,149,248,27,424
1138820,3,0,3,83,21,0,104,189,26,319
1138821,6,0,6,58,18,6,82,251,27,360
1138822,6,0,6,87,25,6,118,496,50,664
1138823,23,63,86,69,18,7,94,216,138,448
1138824,11,3,14,81,21,5,107,330,52,489
1138825,6,0,6,68,23,0,91,208,9,308
1138826,3,0,3,59,15,6,80,200,31,311
1138827,3,0,3,121,27,4,152,241,43,436
1138828,3,3,6,90,9,6,105,235,19,359
1138829,9,3,12,102,32,0,134,367,24,525
1138830,0,0,0,92,14,6,112,327,56,495
1138831,0,0,0,80,22,6,108,187,28,323
1138832,3,0,3,81,11,6,98,184,20,302
1138833,6,0,6,87,28,6,121,216,43,380
1138834,5,0,5,68,22,3,93,267,23,383
1138835,3,0,3,79,12,3,94,252,24,370
1138836,0,0,0,71,19,6,96,193,11,300
1138837,5,0,5,72,16,9,97,356,36,489
1138838,10,0,10,87,33,0,120,414,40,574
1138839,0,0,0,60,9,0,69,157,17,243
1138840,0,0,0,67,20,6,93,155,27,275
1138841,0,0,0,78,7,4,89,150,18,257
1138842,13,0,13,142,24,10,176,304,39,519
1138843,0,6,6,102,28,0,130,218,45,393
1138844,6,0,6,50,18,4,72,145,6,223
1138845,3,0,3,82,15,9,106,259,22,387
1138846,0,0,0,107,17,0,124,225,17,366
1138847,0,0,0,42,10,6,58,215,4,277
1138848,0,0,0,88,27,11,126,218,15,359
1138849,4,0,4,106,30,3,139,222,12,373
1138850,3,0,3,41,9,4,54,130,12,196
1138851,0,0,0,78,21,0,99,194,6,299
1138852,0,0,0,104,31,6,141,287,19,447
1138853,3,0,3,81,25,6,112,230,15,357
1138854,0,0,0,89,17,14,120,351,35,506
1138855,0,0,0,56,17,3,76,282,52,410
1138901,0,0,0,0,4,0,4,9,0,13
1138902,6,0,6,99,30,7,136,210,14,360
1138903,3,0,3,120,21,12,153,272,40,465
1138904,0,0,0,131,26,3,160,224,32,416
1138905,0,0,0,0,0,0,0,0,0,0
1138906,0,0,0,101,23,7,131,272,16,419
1138907,0,0,0,91,31,5,127,300,33,460
1138908,0,3,3,80,21,3,104,252,24,380
1138909,0,0,0,0,0,0,0,3,0,3
1138910,0,0,0,6,0,0,6,48,16,70
1138911,5,0,5,111,31,4,146,303,15,464
1138912,5,0,5,98,13,6,117,319,40,476
1138913,64,4,68,94,26,6,126,354,16,496
1138914,6,3,9,58,21,6,85,321,81,487
1138915,5,3,8,95,20,6,121,270,43,434
1138916,4,4,8,134,24,11,169,285,27,481
1138917,3,0,3,124,34,0,158,288,27,473
1138918,3,3,6,116,27,6,149,212,15,376
1138919,3,0,3,121,26,3,150,328,25,503
1138920,4,0,4,61,11,0,72,188,27,287
1138921,9,0,9,113,19,0,132,245,12,389
1138922,0,0,0,75,22,3,100,217,47,364
1138923,0,0,0,30,21,0,51,311,43,405
1138924,0,0,0,64,35,3,102,307,35,444
1138925,3,0,3,49,20,3,72,214,21,307
1138926,7,0,7,58,17,6,81,230,10,321
1138927,3,0,3,76,12,0,88,201,23,312
1138928,0,0,0,35,39,0,74,315,22,411
1138929,3,0,3,84,21,0,105,192,15,312
1138930,3,0,3,84,19,7,110,286,12,408
1139001,3,6,9,73,19,6,98,283,27,408
1139002,3,0,3,60,18,0,78,301,25,404
1139003,41,0,41,35,20,0,55,239,22,316
1139004,4,0,4,50,22,0,72,269,18,359
1139005,0,0,0,122,15,0,137,306,27,470
1139006,3,0,3,19,9,0,28,148,27,203
1139007,3,0,3,77,12,6,95,297,111,503
1139008,0,16,16,85,7,0,92,303,64,459
1139009,18,0,18,71,15,0,86,280,29,395
1139010,4,0,4,66,24,0,90,220,19,329
1139011,7,0,7,43,11,0,54,352,33,439
1139012,0,0,0,80,9,0,89,295,17,401
1139013,7,0,7,68,6,3,77,358,29,464
1139014,3,0,3,50,5,0,55,262,25,342
1139015,91,0,91,31,9,0,40,344,15,399
1139016,8,5,13,86,12,0,98,331,24,453
1139017,6,0,6,61,10,0,71,254,12,337
1139018,6,0,6,63,20,0,83,240,35,358
1139019,6,0,6,55,16,0,71,219,17,307
1139020,8,3,11,67,11,0,78,312,30,420
1139021,3,0,3,58,22,0,80,178,25,283
1139022,3,0,3,37,18,0,55,176,30,261
1139023,4,0,4,53,0,0,53,172,10,235
1139024,5,3,8,47,18,0,65,174,27,266
1139025,0,41,41,58,18,0,76,309,160,545
1139026,0,0,0,80,23,0,103,200,31,334
1139027,4,0,4,58,16,0,74,214,66,354
1139028,9,6,15,57,21,0,78,238,44,360
1139029,10,0,10,84,30,5,119,330,36,485
1139030,7,0,7,50,21,3,74,157,12,243
1139031,18,4,22,98,26,3,127,370,29,526
1139032,3,0,3,76,22,0,98,239,21,358
1139033,156,17,173,44,21,3,68,428,45,541
1139034,80,0,80,48,13,3,64,334,32,430
1139035,28,0,28,60,18,0,78,321,13,412
1139036,6,0,6,93,26,6,125,378,35,538
1139037,9,0,9,81,18,6,105,313,17,435
1139038,6,3,9,56,16,0,72,220,39,331
1139039,8,0,8,53,13,0,66,269,13,348
1139040,3,0,3,44,6,3,53,222,22,297
1139041,0,0,0,32,12,0,44,189,55,288
1139042,3,5,8,78,18,4,100,390,111,601
1139043,0,0,0,50,12,0,62,255,22,339
1139044,0,4,4,61,9,3,73,212,46,331
1139045,6,0,6,61,18,0,79,307,27,413
1139046,3,0,3,52,0,0,52,200,16,268
1139047,4,0,4,44,9,0,53,275,42,370
1139048,0,0,0,45,5,0,50,217,16,283
1139049,3,0,3,56,6,0,62,201,15,278
1139050,3,5,8,32,5,0,37,154,39,230
1139051,7,0,7,56,10,0,66,265,22,353
1139052,7,0,7,25,12,0,37,265,18,320
1139053,0,0,0,36,12,0,48,126,12,186
1139101,7,3,10,37,11,0,48,195,19,262
1139102,12,0,12,50,23,0,73,266,24,363
1139103,3,0,6,45,25,9,79,170,16,265
1139104,6,0,6,49,12,0,61,180,3,244
1139105,7,0,7,60,23,0,83,295,21,399
1139106,7,0,7,73,14,0,87,354,24,465
1139107,6,6,12,61,15,0,76,367,53,496
1139108,0,0,0,51,9,0,60,256,43,359
1139109,3,3,6,23,3,0,26,158,18,202
1139110,8,0,8,66,33,7,106,257,18,381
1139111,0,0,0,58,18,0,76,243,22,341
1139112,5,3,8,58,27,0,85,167,15,267
1139113,9,0,9,76,21,0,97,361,44,502
1139114,21,0,21,70,16,0,86,381,22,489
1139115,7,0,7,71,23,0,94,266,38,398
1139116,9,0,9,57,18,0,75,322,29,426
1139117,67,3,70,30,11,3,44,216,24,284
1139118,6,0,6,52,15,0,67,261,24,352
1139119,0,0,0,40,11,0,51,202,27,280
1139120,11,0,11,63,15,4,82,283,19,384
1139121,3,0,3,93,19,12,124,264,32,420
1139122,5,0,5,52,29,0,81,164,15,260
1139123,11,4,15,83,42,0,125,371,39,535
1139124,4,0,4,48,3,0,51,283,34,368
1139125,7,3,10,34,6,3,43,242,33,318
1139126,11,36,47,101,18,6,125,225,66,416
1139127,7,0,7,103,18,4,125,295,37,457
1139128,3,0,3,92,21,6,119,238,4,361
1139129,9,0,9,57,26,0,83,399,60,542
1139130,0,0,0,24,3,0,27,172,33,232
1139131,8,3,14,122,18,0,140,664,94,898
1139132,20,7,27,36,13,0,49,296,44,389
1139133,6,0,12,46,12,0,58,124,14,196
1139134,3,3,6,77,19,3,99,274,29,402
1139135,3,0,3,70,18,6,94,214,37,345
1139136,12,0,12,28,5,0,33,189,27,249
1139137,9,0,9,45,23,0,68,173,22,263
1139138,8,3,11,63,20,0,83,198,18,299
1139139,3,4,7,80,33,3,116,287,32,435
1139140,9,32,41,44,16,0,60,188,68,316
1139141,17,7,27,55,15,3,73,341,21,435
1139142,3,3,6,51,31,0,82,242,39,363
1139143,3,0,3,68,20,0,88,262,18,368
1139144,9,0,9,76,28,9,113,273,32,418
1139145,6,0,6,72,26,3,101,241,13,355
1139146,8,0,8,84,28,6,118,247,35,400
1139147,11,3,14,75,22,7,104,234,23,361
1139148,0,3,3,13,9,0,22,133,25,180
1139149,7,3,10,41,12,0,53,199,32,284
1139201,0,0,3,55,18,6,79,241,21,341
1139202,9,3,15,63,26,3,92,202,46,340
1139203,0,0,0,32,5,3,40,146,12,198
1139204,5,0,5,66,14,3,83,224,12,319
1139205,3,0,3,90,29,3,122,243,9,374
1139206,5,3,8,60,20,4,84,160,18,262
1139207,7,0,7,88,34,11,133,288,20,441
1139208,3,3,6,48,11,3,62,141,15,218
1139209,0,0,0,0,0,0,0,3,0,3
1139210,0,3,3,35,4,0,39,188,32,259
1139211,0,0,0,71,16,0,87,239,23,349
1139212,4,0,4,71,10,0,81,244,27,352
1139213,5,4,9,67,21,0,88,258,23,369
1139214,6,0,6,53,11,3,67,148,11,226
1139215,7,5,12,89,25,12,126,244,23,393
1139216,6,3,9,83,25,3,111,278,43,432
1139217,3,0,3,50,20,0,70,168,18,256
1139218,6,0,6,47,21,3,71,154,16,241
1139219,6,3,9,83,30,3,116,230,21,367
1139220,0,0,0,59,23,3,85,264,22,371
1139221,5,0,5,88,26,3,117,229,18,364
1139222,5,0,5,55,18,6,79,294,15,388
1139223,8,0,8,42,23,8,73,144,15,232
1139224,0,0,0,61,16,0,77,120,21,218
1139225,3,0,3,42,20,9,71,139,22,232
1139226,0,0,0,51,8,4,63,133,0,196
1139301,3,0,3,80,26,0,106,260,26,392
1139302,3,0,3,76,30,0,106,205,15,326
1139303,7,0,7,78,28,0,106,258,27,391
1139304,6,0,6,71,10,0,81,253,27,361
1139305,4,0,4,63,20,0,83,160,24,267
1139306,74,3,77,21,9,0,30,239,13,282
1139307,0,0,0,39,18,0,57,153,17,227
1139308,0,3,3,45,16,0,61,158,21,240
1139309,0,0,0,70,18,0,88,212,43,343
1139310,3,3,6,25,4,0,29,155,33,217
1139311,5,0,5,59,13,3,75,193,32,300
1139312,6,3,9,57,16,0,73,260,34,367
1139313,3,0,3,110,37,0,147,247,21,415
1139314,8,3,11,95,26,0,121,264,21,406
1139315,4,0,4,68,12,0,80,175,24,279
1139316,7,0,7,83,23,4,110,220,10,340
1139317,7,0,7,89,28,6,123,256,35,414
1139318,5,0,5,49,17,0,66,182,17,265
1139319,9,0,9,83,20,3,106,319,34,459
1139320,8,0,8,70,36,0,106,289,28,423
1139321,3,0,3,97,9,0,106,392,48,546
1139322,11,3,14,39,27,3,69,186,39,294
1139323,4,0,4,64,23,0,87,148,12,247
1139324,12,0,12,42,19,0,61,170,11,242
1139325,3,0,3,44,14,0,58,179,8,245
1139326,0,0,0,78,45,3,126,279,20,425
1139327,6,0,6,69,16,3,88,162,25,275
1139328,7,0,7,55,24,0,79,199,15,293
1139329,0,0,0,48,22,0,70,218,38,326
1139330,7,0,7,71,30,4,105,264,19,388
1139331,4,0,4,82,27,0,109,240,21,370
1139332,11,3,14,87,22,4,113,291,44,448
1139333,7,22,29,59,21,0,80,133,62,275
1139334,7,0,7,60,45,3,108,273,26,407
1139335,3,3,6,62,21,6,89,228,25,342
1139336,3,3,9,74,31,3,108,247,34,389
1139337,6,0,9,36,22,0,58,192,27,277
1139338,4,3,7,92,21,6,119,305,34,458
1139339,7,0,7,54,6,0,60,120,15,195
1139340,3,3,6,51,37,3,91,210,19,320
1139401,0,0,0,122,22,0,144,408,55,607
1139402,3,0,3,36,10,0,46,130,22,198
1139403,0,0,0,48,14,7,69,249,25,343
1139404,6,0,6,77,19,12,108,244,28,380
1139405,6,0,6,70,24,10,104,183,7,294
1139406,3,0,3,71,22,0,93,378,51,522
1139407,4,0,4,69,29,5,103,292,43,438
1139408,8,0,8,50,15,5,70,185,27,282
1139409,6,0,6,34,12,0,46,223,24,293
1139410,3,0,3,42,15,6,63,258,38,359
1139411,0,0,0,83,16,4,103,218,46,367
1139412,3,0,3,79,11,0,90,141,11,242
1139413,9,0,9,55,18,3,76,108,9,193
1139414,3,0,3,80,34,3,117,162,12,291
1139415,3,0,3,54,13,10,77,194,9,280
1139416,0,0,0,64,21,0,85,228,19,332
1139417,13,3,16,87,24,3,114,276,15,405
1139418,5,0,5,99,37,8,144,243,9,396
1139419,0,3,3,71,22,6,99,190,19,308
1139420,3,0,3,58,25,9,92,281,25,398
1139421,0,0,0,46,19,0,65,182,19,266
1139422,0,6,6,57,12,0,69,150,34,253
1139423,3,0,3,67,14,0,81,285,22,388
1139424,28,28,56,68,21,3,92,292,72,456
1139425,4,0,4,83,15,3,101,196,27,324
1139426,3,0,3,45,12,0,57,141,20,218
1139427,6,0,6,48,11,3,62,181,17,260
1139428,4,0,4,78,29,3,110,284,54,448
1139429,9,3,12,53,20,4,77,212,43,332
1139430,8,0,8,77,23,12,112,350,48,510
1139431,0,0,0,55,17,0,72,247,40,359
1139432,8,3,11,100,28,7,135,234,70,439
1139433,3,3,6,50,15,3,68,142,16,226
1139434,3,3,6,84,13,3,100,272,55,427
1139435,0,0,0,45,19,5,69,201,35,305
1139436,3,0,3,42,22,3,67,236,46,349
1139437,3,4,7,36,12,0,48,208,26,282
1139438,0,0,0,22,6,0,28,144,31,203
1139439,6,3,9,58,12,10,80,124,35,239
1139501,5,0,5,67,11,0,78,231,18,327
1139502,0,0,0,52,22,3,77,263,34,374
1139503,13,4,17,95,39,0,134,210,24,368
1139504,8,0,8,41,17,0,58,128,28,214
1139505,6,3,9,57,18,3,78,115,6,199
1139506,33,6,39,115,35,3,153,283,26,462
1139507,9,0,9,82,18,3,103,192,29,324
1139508,36,0,36,45,22,0,67,265,56,388
1139509,0,0,0,60,25,0,85,336,34,455
1139510,0,0,0,30,7,0,37,175,24,236
1139511,6,0,6,29,10,0,39,218,28,285
1139512,22,5,27,40,9,0,49,329,29,407
1139513,3,0,3,51,21,4,76,251,7,334
1139514,0,0,0,35,20,0,55,311,42,408
1139515,13,3,16,65,21,3,89,210,27,326
1139516,0,0,0,90,23,6,119,221,24,364
1139517,6,0,6,71,17,3,91,177,15,283
1139518,4,0,4,79,32,7,118,223,24,365
1139519,16,0,16,59,12,9,80,264,45,389
1139520,37,0,37,64,17,18,99,223,13,335
1139521,6,0,6,78,28,6,112,235,9,356
1139522,0,3,3,68,12,6,86,233,21,340
1139523,7,3,10,76,12,12,100,239,39,378
1139524,6,3,9,83,18,4,105,176,17,298
1139525,19,37,56,46,18,0,64,224,96,384
1139526,10,0,10,66,12,0,78,174,12,264
1139527,7,0,7,55,13,0,68,202,18,288
1139528,9,6,15,68,14,0,82,239,49,370
1139529,3,0,3,85,25,0,110,235,15,360
1139530,6,0,10,83,23,0,106,247,26,379
1139531,10,0,13,73,36,0,109,256,34,399
1139532,11,3,14,90,26,3,119,259,24,402
1139601,3,0,3,132,6,0,138,418,29,585
1139602,0,0,0,104,14,0,118,333,58,509
1139603,0,3,3,41,9,0,50,193,60,303
1139604,0,0,0,119,12,0,131,415,140,686
1139605,3,0,3,27,12,3,42,102,6,150
1139606,7,0,7,68,21,3,92,239,9,340
1139607,0,3,3,51,6,0,57,231,35,323
1139608,0,0,0,84,17,3,104,269,112,485
1139609,0,0,0,29,10,0,39,174,66,279
1139610,6,3,9,46,36,0,82,296,92,470
1139611,3,0,3,35,6,3,44,218,21,283
1139612,0,0,0,42,20,3,65,346,79,490
1139613,10,3,13,42,20,6,68,239,40,347
1139614,0,4,4,57,9,6,72,196,39,307
1139615,0,0,0,81,22,3,106,328,22,456
1139616,0,0,0,112,23,6,141,266,35,442
1139617,3,0,3,78,0,0,78,334,38,450
1139618,0,0,0,82,12,3,97,285,46,428
1139619,3,0,3,70,5,0,75,165,15,255
1139620,4,0,4,74,6,0,80,234,13,327
1139621,4,0,4,0,0,0,0,7,0,7
1139622,0,0,0,6,0,0,6,3,0,9
1139623,0,0,0,0,0,0,0,3,0,3
1139624,12,0,12,102,20,0,122,366,20,508
1139625,0,0,0,127,24,0,151,485,43,679
1139626,0,0,0,157,19,4,180,471,28,679
1139627,0,0,0,0,0,0,0,0,0,0
1139628,0,3,3,38,18,3,59,129,29,217
1139629,6,4,10,84,14,3,101,280,125,506
1139701,50,6,56,38,15,0,53,263,65,381
1139702,8,4,12,43,0,0,43,245,33,321
1139703,0,0,0,0,0,0,0,0,0,0
1139704,0,0,0,0,0,0,0,0,0,0
1139705,0,0,0,54,4,0,58,418,70,546
1139706,11,0,11,87,39,0,126,320,25,471
1139707,9,0,9,81,20,3,104,311,39,454
1139708,0,3,3,103,37,0,140,288,24,452
1139709,5,0,5,58,21,0,79,205,19,303
1139710,4,3,7,51,20,0,71,179,32,282
1139711,0,0,0,74,19,0,93,210,29,332
1139712,0,0,0,71,12,0,83,181,20,284
1139713,3,0,3,52,12,0,64,349,77,490
1139714,0,0,0,42,3,0,45,306,83,434
1139715,5,0,5,69,31,0,100,362,67,529
1139716,4,0,4,40,14,0,54,337,36,427
1139717,10,3,13,44,17,0,61,157,24,242
1139718,3,0,3,69,16,0,85,204,16,305
1139719,6,0,6,39,5,0,44,281,42,367
1139720,23,5,28,59,20,0,79,314,22,415
1139721,0,0,0,33,3,0,36,197,21,254
1139722,12,0,12,58,25,0,83,239,19,341
1139723,6,3,9,98,51,8,157,255,21,433
1139724,12,0,12,70,10,5,85,195,12,292
1139725,39,0,39,88,16,6,110,294,20,424
1139726,6,3,9,86,15,0,101,368,52,521
1139727,10,0,10,61,12,0,73,435,112,620
1139728,3,0,3,7,0,0,7,124,34,165
1139729,14,0,14,79,3,0,82,424,45,551
1139730,0,0,0,104,15,0,119,526,97,742
1139731,0,0,0,42,4,0,46,175,58,279
1139732,3,5,8,7,6,0,13,86,9,108
1139733,6,0,6,67,0,5,72,509,86,667
1139734,7,0,7,93,34,0,127,338,33,498
1139735,3,0,3,78,21,3,102,307,21,430
1139736,3,3,9,68,23,0,91,224,43,358
1139737,0,7,7,67,30,0,97,217,21,335
1139738,6,3,9,69,9,0,78,192,18,288
1139739,8,0,12,53,32,0,85,255,6,346
1139740,6,0,6,70,26,4,100,251,35,386
1139741,3,0,3,38,13,4,55,214,54,323
1139742,65,5,70,36,11,0,47,340,71,458
1139743,14,3,17,48,18,0,66,362,49,477
1139744,10,0,10,49,26,0,75,250,27,352
1139745,3,0,3,66,0,0,66,351,38,455
1139746,7,0,7,38,34,0,72,219,19,310
1139747,7,0,7,39,16,4,59,176,17,252
1139748,4,7,11,48,16,0,64,217,41,322
1139749,0,3,3,36,18,0,54,180,12,246
1139750,8,0,8,57,19,0,76,223,22,321
1139751,20,8,28,84,13,0,97,309,56,462
1139752,11,3,17,82,32,0,114,283,22,419
1139753,0,0,0,0,4,0,4,20,12,36
1139754,6,3,12,72,30,5,107,236,6,349
1139755,10,0,10,58,27,0,85,195,18,298
1139756,9,3,12,66,25,0,91,212,18,321
1139757,7,6,13,70,32,0,102,261,20,383
1139758,4,6,10,67,35,0,102,294,21,417
1139759,6,6,12,77,33,3,113,242,16,371
1139760,6,0,6,50,26,0,76,162,10,248
1139761,22,3,29,42,31,0,73,257,30,360
1139801,0,0,0,0,0,0,0,0,0,0
1139802,12,0,12,37,17,0,54,221,25,300
1139803,54,0,54,58,20,0,78,274,28,380
1139804,40,3,43,66,12,0,78,296,41,415
1139805,9,0,9,109,18,6,133,258,61,452
1139806,9,3,12,88,27,3,118,306,30,454
1139807,14,0,14,67,25,3,95,254,36,385
1139808,64,10,74,62,14,0,76,353,76,505
1139809,14,5,19,59,8,0,67,318,43,428
1139810,3,6,9,32,4,0,36,145,36,217
1139811,4,0,4,87,34,0,121,256,23,400
1139812,8,0,8,92,31,5,128,243,15,386
1139813,0,0,0,69,15,0,84,252,5,341
1139814,3,3,6,87,19,0,106,261,15,382
1139815,4,0,4,100,13,0,113,311,14,438
1139816,3,0,3,98,6,3,107,313,15,435
1139817,0,0,0,41,7,0,48,193,12,253
1139818,8,0,8,23,3,4,30,163,27,220
1139819,3,0,3,48,10,7,65,169,17,251
1139820,11,0,11,63,12,0,75,153,46,274
1139821,40,8,48,39,9,3,51,149,20,220
1139822,3,3,6,119,16,11,146,241,12,399
1139823,6,3,9,68,13,6,87,174,13,274
1139824,8,0,8,81,24,0,105,179,19,303
1139825,4,0,4,90,18,10,118,137,3,258
1139826,27,3,30,42,15,4,61,173,12,246
1139827,4,0,4,96,18,6,120,196,16,332
1139828,4,0,4,55,23,0,78,159,9,246
1139829,3,0,3,46,18,3,67,152,13,232
1139830,0,0,0,133,27,0,160,496,78,734
1139831,0,0,0,71,5,0,76,312,50,438
1139832,7,0,7,97,13,3,113,304,5,422
1139833,8,0,8,64,14,0,78,362,39,479
1139834,6,0,6,30,18,0,48,154,15,217
1139835,3,0,3,61,19,3,83,247,25,355
1139836,8,0,8,97,34,6,137,262,28,427
1139837,3,3,6,77,7,0,84,102,3,189
1139838,3,0,3,70,10,5,85,147,9,241
1139839,3,0,3,57,10,7,74,99,6,179
1139840,0,3,3,101,9,6,116,192,18,326
1139841,3,0,3,49,6,0,55,169,10,234
1139842,0,0,0,27,3,7,37,147,18,202
1139843,3,3,6,92,7,0,99,251,35,385
1139844,4,0,4,124,14,0,138,479,57,674
1139845,8,0,8,69,15,0,84,282,26,392
1139846,0,0,0,86,31,0,117,305,15,437
1139847,43,3,46,57,30,5,92,213,25,330
1139848,4,0,4,57,22,0,79,152,15,246
1139849,10,0,10,166,22,3,191,707,55,953
1139850,0,0,0,45,3,0,48,168,14,230
1139851,5,0,5,78,18,0,96,303,30,429
1139852,4,0,4,55,20,6,81,219,18,318
1139853,4,0,4,94,17,6,117,147,3,267
1139854,0,0,0,49,6,0,55,88,0,143
1139855,11,0,11,89,23,12,124,265,26,415
1139856,4,0,4,30,6,6,42,103,11,156
1139857,4,0,4,48,15,0,63,172,23,258
1139858,0,0,0,81,3,6,90,325,68,483
1139859,4,0,4,63,0,0,63,216,37,316
1139901,6,0,6,65,15,6,86,102,10,198
1139902,0,0,0,91,18,0,109,243,22,374
1139903,0,0,0,65,18,0,83,383,38,504
1139904,6,0,6,51,18,0,69,242,26,337
1139905,46,3,49,78,11,0,89,357,46,492
1139906,0,0,0,60,21,0,81,254,19,354
1139907,10,6,16,102,26,0,128,398,47,573
1139908,31,8,39,60,30,3,93,247,8,348
1139909,7,0,7,96,25,6,127,241,6,374
1139910,3,0,3,63,20,5,88,308,30,426
1139911,0,0,0,99,17,0,116,294,5,415
1139912,4,0,4,72,26,3,101,257,13,371
1139913,11,0,11,49,16,6,71,166,21,258
1139914,6,0,6,56,11,3,70,152,12,234
1139915,8,0,8,69,16,3,88,167,15,270
1139916,5,0,5,92,22,0,114,150,18,282
1139917,6,3,9,105,36,3,144,193,33,370
1139918,86,11,97,75,32,0,107,357,26,490
1139919,16,0,16,121,24,6,151,260,18,429
1139920,9,0,9,98,19,4,121,200,19,340
1139921,12,0,12,76,26,5,107,209,11,327
1139922,6,3,9,105,34,9,148,206,30,384
1139923,4,0,4,116,16,6,138,249,33,420
1139924,6,0,6,48,21,0,69,158,6,233
1139925,3,0,3,76,0,0,76,260,43,379
1139926,0,0,0,44,15,0,59,223,40,322
1139927,3,3,6,77,10,0,87,301,31,419
1139928,3,0,3,60,9,0,69,257,13,339
1139929,0,0,0,84,22,0,106,280,15,401
1139930,6,0,6,94,8,9,111,183,16,310
1139931,3,0,3,123,19,3,145,235,4,384
1139932,6,0,6,92,26,6,124,333,38,495
1139933,3,3,6,73,14,4,91,155,8,254
1139934,5,4,12,103,28,0,131,287,43,461
1139935,3,0,3,46,12,0,58,92,6,156
1139936,3,0,3,89,22,9,120,282,19,421
1139937,0,0,0,86,11,5,102,251,15,368
1139938,9,0,9,90,13,5,108,219,11,338
1139939,3,3,6,36,17,3,56,138,12,206
1139940,10,0,10,61,12,3,76,141,4,221
1139941,9,0,9,110,28,0,138,199,9,346
1139942,0,3,3,49,12,0,61,212,12,285
1140001,3,3,6,63,9,0,72,84,6,162
1140002,0,3,6,53,21,6,80,101,6,187
1140003,0,0,0,0,0,0,0,3,0,3
1140004,9,0,9,48,9,6,63,127,19,209
1140005,11,0,11,94,23,0,117,298,22,437
1140006,3,0,3,84,15,12,111,158,7,276
1140007,9,6,15,94,16,9,119,147,12,278
1140008,6,0,6,74,27,3,104,158,0,262
1140009,6,3,9,108,6,6,120,186,6,312
1140010,3,0,3,55,9,0,64,136,6,206
1140011,13,6,19,97,30,4,131,217,12,360
1140012,13,0,13,101,47,4,152,212,13,377
1140013,0,0,0,12,14,0,26,105,6,137
1140014,7,3,10,62,15,3,80,136,9,225
1140015,3,0,3,101,54,6,161,235,11,407
1140016,9,6,15,106,26,9,141,226,18,385
1140017,0,0,0,79,11,5,95,148,10,253
1140018,6,0,6,81,16,3,100,184,6,290
1140019,6,0,6,64,24,0,88,165,11,264
1140020,5,0,5,150,17,5,172,232,4,408
1140021,46,4,50,43,20,4,67,234,10,311
1140022,13,0,13,51,18,0,69,257,12,338
1140023,16,0,16,101,29,0,130,300,16,446
1140024,0,0,0,52,11,4,67,438,27,532
1140025,3,0,3,93,70,3,166,221,27,414
1140026,6,0,6,76,14,3,93,200,16,309
1140027,10,0,10,81,45,0,126,286,22,434
1140028,6,3,9,59,24,6,89,144,13,246
1140029,0,3,3,98,39,4,141,253,21,415
1140030,13,3,16,80,42,3,125,177,18,320
1140031,6,0,6,69,17,3,89,134,6,229
1140032,9,0,9,75,15,3,93,186,6,285
1140033,9,3,12,55,34,10,99,212,20,331
1140034,6,6,12,68,57,4,129,228,33,390
1140035,12,7,19,86,24,7,117,294,23,434
1140036,38,0,38,61,16,0,77,192,7,276
1140037,6,0,6,75,16,0,91,316,17,424
1140038,13,0,13,76,13,6,95,211,17,323
1140039,50,28,78,106,31,3,140,601,97,838
1140040,5,0,5,93,21,8,122,175,21,318
1140041,8,0,8,117,32,6,155,266,34,455
1140042,0,0,0,55,3,4,62,83,8,153
1140043,6,0,6,113,29,8,150,204,9,363
1140044,16,3,19,76,25,3,104,237,17,358
1140045,29,3,32,62,12,3,77,215,12,304
1140046,4,0,4,101,19,0,120,379,34,533
1140047,11,0,11,107,21,10,138,178,10,326
1140048,5,0,5,121,28,3,152,371,46,569
1140049,21,4,25,55,39,0,94,361,16,471
1140050,5,0,5,92,30,3,125,295,9,429
1140051,6,0,6,91,24,0,115,254,17,386
1140052,6,0,6,65,16,3,84,171,12,267
1140053,9,3,15,121,17,8,146,265,24,435
1140054,8,0,8,79,18,3,100,309,31,440
1140055,19,6,25,99,34,0,133,343,27,503
1140056,6,0,6,81,9,3,93,202,24,319
1140101,9,3,12,106,34,9,149,358,24,531
1140102,7,0,7,152,19,5,176,266,23,465
1140103,6,0,6,121,26,6,153,325,20,498
1140104,0,0,0,63,19,0,82,134,4,220
1140105,0,0,0,0,3,0,3,3,0,6
1140106,0,0,0,0,0,0,0,0,0,0
1140107,0,0,0,0,0,0,0,0,0,0
1140108,3,3,6,3,0,0,3,13,16,32
1140109,3,0,3,39,6,0,45,341,18,404
1140110,3,0,3,42,16,0,58,252,33,343
1140111,9,3,12,158,19,9,186,265,20,471
1140112,3,0,3,55,20,3,78,103,5,186
1140113,0,0,0,140,31,7,178,412,32,622
1140114,3,3,6,57,29,3,89,229,23,341
1140115,4,0,4,58,13,0,71,292,27,390
1140116,0,0,0,55,9,0,64,216,12,292
1140117,0,0,0,57,12,0,69,286,48,403
1140118,4,0,4,118,13,15,146,264,6,416
1140119,3,0,3,52,17,0,69,493,38,600
1140120,0,0,0,16,4,0,20,218,23,261
1140121,7,0,7,98,35,0,133,852,154,1139
1140122,0,0,0,60,21,6,87,152,24,263
1140201,22,0,22,87,22,3,112,234,26,372
1140202,20,7,27,82,14,9,105,243,13,361
1140203,16,0,16,142,34,3,179,283,9,471
1140204,14,0,14,95,23,6,124,187,17,328
1140205,4,0,4,119,11,4,134,196,31,361
1140206,6,3,12,160,24,9,193,268,41,502
1140207,7,0,7,151,21,12,184,271,26,481
1140208,59,0,59,72,22,0,94,321,29,444
1140209,4,0,4,68,27,0,95,131,9,235
1140210,14,3,17,82,25,4,111,192,9,312
1140211,12,0,12,124,45,4,173,338,22,533
1140212,0,0,0,64,6,9,79,149,10,238
1140213,5,0,5,85,20,7,112,172,15,299
1140214,9,0,9,94,24,6,124,202,19,345
1140215,0,0,4,75,17,0,92,181,19,292
1140216,9,3,12,79,36,3,118,235,19,372
1140217,3,3,6,62,9,3,74,141,12,227
1140218,10,0,13,100,47,0,147,195,12,354
1140219,4,3,7,58,25,0,83,118,29,230
1140220,9,0,9,60,25,0,85,172,12,269
1140221,7,0,7,41,26,0,67,141,3,211
1140222,4,0,4,120,27,3,150,173,6,329
1140223,7,3,10,84,33,3,120,256,18,394
1140224,3,0,3,63,18,6,87,166,27,280
1140225,4,0,4,70,25,3,98,248,27,373
1140226,0,0,0,80,17,0,97,105,3,205
1140227,4,3,7,68,8,0,76,157,18,251
1140228,15,0,18,86,37,4,127,259,22,408
1140229,8,0,8,98,43,3,144,184,10,338
1140230,9,0,12,77,21,3,101,163,0,264
1140231,4,0,4,75,32,0,107,175,12,294
1140232,0,0,0,0,0,0,0,0,0,0
1140233,6,0,6,108,26,9,143,263,35,441
1140234,3,0,3,93,9,3,105,125,18,248
1140235,13,0,13,63,15,6,84,125,14,223
1140236,6,0,6,64,18,0,82,205,18,305
1140237,4,0,4,83,12,9,104,159,10,273
1140238,11,3,14,99,32,3,134,224,18,376
1140239,10,3,13,87,15,6,108,221,12,341
1140240,7,5,12,118,31,4,153,187,14,354
1140241,8,0,8,130,32,4,166,279,15,460
1140242,12,0,12,86,31,0,117,328,12,457
1140243,14,0,14,72,18,3,93,341,17,451
1140244,8,0,8,72,26,0,98,184,26,308
1140245,7,0,7,92,19,9,120,219,21,360
1140246,7,0,10,126,31,7,164,203,21,388
1140247,3,0,3,98,17,3,118,225,9,352
1140248,5,3,8,65,16,3,84,192,12,288
1140249,8,6,14,91,26,0,117,215,9,341
1140250,45,0,48,127,24,4,155,247,16,418
1140251,6,6,12,84,26,3,113,173,24,310
1140252,7,3,10,116,21,3,140,219,27,386
1140253,0,0,0,61,34,0,95,201,35,331
1140254,3,0,3,41,12,6,59,98,3,160
1140255,14,0,17,48,17,3,68,141,13,222
1140256,0,0,0,74,15,6,95,208,24,327
1140257,5,0,5,83,12,0,95,177,16,288
1140301,6,3,9,76,25,6,107,188,9,304
1140302,3,0,3,95,19,9,123,179,0,302
1140303,3,0,3,77,35,0,112,202,12,326
1140304,6,0,6,125,30,12,167,305,13,485
1140305,4,0,4,42,15,3,60,100,3,163
1140306,6,0,6,45,20,3,68,96,3,167
1140307,0,0,0,0,0,0,0,0,0,0
1140308,3,0,3,51,12,4,67,151,12,230
1140309,0,0,0,39,20,6,65,136,6,207
1140310,0,0,0,70,16,10,96,190,6,292
1140311,15,0,15,122,31,3,156,327,24,507
1140312,10,0,10,74,24,10,108,243,35,386
1140313,5,0,5,85,23,9,117,173,6,296
1140314,16,0,16,99,31,4,134,254,13,401
1140315,4,0,4,66,23,4,93,138,8,239
1140316,6,0,6,65,21,6,92,204,11,307
1140317,9,0,9,87,32,0,119,221,3,343
1140318,3,6,9,92,16,9,117,263,24,404
1140319,12,0,12,87,19,6,112,238,15,365
1140320,8,0,8,56,26,6,88,139,12,239
1140321,6,0,6,115,25,3,143,211,16,370
1140322,5,0,5,89,44,3,136,262,19,417
1140323,3,0,3,89,21,3,113,205,16,334
1140324,16,3,19,106,41,15,162,355,13,530
1140325,13,0,13,69,30,8,107,220,9,336
1140326,0,4,4,64,21,4,89,156,13,258
1140327,9,0,9,54,28,3,85,127,9,221
1140328,4,0,4,83,20,7,110,213,9,332
1140329,0,0,0,74,32,0,106,253,6,365
1140330,0,0,0,93,29,0,122,179,5,306
1140331,3,0,3,75,28,3,106,164,6,276
1140332,4,0,4,113,44,9,166,225,18,409
1140333,0,0,0,62,18,0,80,161,6,247
1140334,0,0,0,49,24,9,82,123,3,208
1140335,0,0,0,0,0,0,0,0,0,0
1140336,0,0,0,89,25,6,120,204,12,336
1140337,3,0,3,67,20,3,90,119,0,209
1140338,3,0,3,98,18,9,125,249,15,389
1140339,7,0,7,73,15,3,91,178,12,281
1140340,3,0,3,116,36,4,156,291,15,462
1140341,3,0,3,64,28,9,101,258,8,367
1140342,3,0,3,93,41,5,139,281,10,430
1140343,4,0,4,56,4,0,60,169,6,235
1140344,0,0,0,0,0,0,0,0,0,0
1140345,0,0,0,0,0,0,0,0,0,0
1140346,0,0,0,77,32,0,109,208,6,323
1140347,0,0,0,0,0,0,0,0,0,0
1140348,0,0,0,0,3,0,3,6,0,9
1140349,0,0,0,0,0,0,0,0,0,0
1140350,0,0,0,117,28,4,149,212,15,376
1140401,0,3,3,120,25,3,148,243,17,408
1140402,0,0,0,0,0,0,0,0,0,0
1140403,0,4,4,43,21,0,64,149,13,226
1140404,6,0,6,109,31,11,151,220,13,384
1140405,0,0,0,70,23,0,93,188,12,293
1140406,0,0,0,29,12,3,44,50,6,100
1140407,3,0,3,63,26,5,94,86,3,183
1140408,0,3,3,34,18,0,52,118,13,183
1140409,3,3,6,106,34,0,140,257,24,421
1140410,9,0,9,77,33,0,110,190,12,312
1140411,0,0,0,82,16,3,101,140,10,251
1140412,0,0,0,129,23,0,152,179,21,352
1140413,0,0,0,54,20,9,83,158,12,253
1140414,9,0,9,73,17,10,100,217,25,342
1140415,3,0,3,103,12,0,115,192,6,313
1140416,0,0,0,23,0,3,26,62,0,88
1140417,0,0,3,72,21,3,96,153,13,262
1140418,6,3,9,69,35,6,110,191,27,328
1140419,0,0,0,109,41,10,160,221,11,392
1140420,3,0,3,64,25,0,89,178,0,267
1140421,0,3,3,103,31,4,138,229,23,390
1140422,0,0,0,58,39,4,101,148,3,252
1140423,0,0,0,56,13,4,73,144,19,236
1140424,0,0,0,69,22,5,96,160,5,261
1140425,0,0,0,99,35,11,145,147,12,304
1140426,7,0,7,65,21,6,92,134,9,235
1140427,0,0,0,153,42,11,206,231,16,453
1140428,0,0,0,0,0,0,0,0,0,0
1140429,0,0,0,96,31,4,131,162,18,311
1140430,3,3,6,98,25,11,134,185,12,331
1140431,0,0,0,83,33,6,122,254,7,383
1140432,0,0,0,38,22,4,64,155,6,225
1140501,0,0,0,63,6,3,72,181,19,272
1140502,5,3,13,45,24,6,75,208,30,313
1140503,5,0,5,51,3,3,57,152,8,217
1140504,0,0,0,68,20,0,88,276,37,401
1140505,3,8,14,66,15,3,84,286,41,411
1140506,15,0,15,56,15,0,71,275,37,383
1140507,0,3,3,172,26,0,198,546,101,845
1140508,3,0,3,94,33,12,139,246,9,394
1140509,0,0,0,40,14,3,57,121,0,178
1140510,0,0,0,50,10,0,60,125,7,192
1140511,117,13,130,18,23,3,44,403,50,497
1140512,0,0,0,179,27,0,206,285,23,514
1140513,11,3,14,101,18,4,123,344,27,494
1140514,4,0,4,67,13,3,83,165,17,265
1140515,3,0,3,107,20,5,132,234,25,391
1140516,6,0,6,85,12,3,100,207,15,322
1140517,3,0,3,84,9,4,97,131,19,247
1140518,3,0,3,96,20,0,116,341,48,505
1140519,16,0,16,150,23,9,182,300,25,507
1140520,4,0,4,110,3,3,116,244,36,396
1140521,99,3,102,47,15,0,62,303,18,383
1140522,3,0,3,104,16,3,123,314,29,466
1140523,4,0,4,60,12,3,75,254,15,344
1140524,0,0,0,105,5,0,110,222,20,352
1140525,0,0,0,0,0,0,0,0,0,0
1140526,3,0,3,66,14,3,83,128,6,217
1140527,50,5,55,66,19,3,88,304,24,416
1140528,0,3,3,71,12,0,83,313,45,441
1140529,4,0,4,104,28,3,135,252,15,402
1140530,6,3,9,54,15,0,69,145,9,223
1140531,0,0,0,0,0,0,0,0,0,0
1140532,6,0,6,51,5,0,56,103,6,165
1140533,0,0,0,48,18,0,66,120,4,190
1140534,13,0,13,96,29,0,125,249,5,379
1140535,7,0,7,43,24,3,70,118,9,197
1140536,12,0,12,67,20,3,90,216,18,324
1140537,0,3,3,76,29,5,110,205,14,329
1140538,7,0,7,112,23,0,135,239,12,386
1140539,3,0,3,72,19,7,98,248,9,355
1140540,0,0,0,62,15,0,77,117,3,197
1140541,6,3,9,56,19,0,75,152,25,252
1140542,7,33,40,64,34,0,98,168,68,334
1140543,0,0,0,114,23,3,140,315,35,490
1140544,7,0,7,57,9,3,69,153,22,244
1140545,14,0,14,96,23,9,128,258,24,410
1140546,17,7,24,72,19,7,98,180,27,305
1140547,7,0,7,50,12,0,62,184,9,255
1140548,0,0,0,75,37,0,112,190,12,314
1140549,5,3,8,65,34,3,102,191,12,305
1140550,7,0,7,42,21,3,66,153,17,236
1140551,0,0,0,33,30,3,66,110,7,183
1140552,3,0,3,71,18,0,89,189,12,290
1140553,3,0,3,55,17,0,72,140,6,218
1140554,15,0,15,80,26,5,111,222,19,352
1140555,3,6,9,64,25,8,97,162,12,271
1140556,0,0,3,56,30,0,86,99,7,192
1140557,3,0,3,44,10,8,62,148,9,219
1140558,6,3,9,55,19,7,81,146,13,240
1140559,5,3,11,80,26,6,112,200,21,333
1140560,20,0,20,82,33,0,115,295,9,419
1140561,10,0,10,23,9,3,35,195,19,249
1140562,0,0,0,102,15,0,117,291,25,433
1140563,0,0,0,77,16,0,93,185,14,292
1140564,0,0,0,103,16,0,119,176,9,304
1140565,0,0,0,258,32,3,293,484,27,804
1140566,4,0,4,214,22,4,240,382,19,641
1140567,10,0,10,100,24,3,127,332,28,487
1140568,6,4,10,110,13,0,123,330,23,476
1140569,9,0,9,88,16,4,108,373,11,492
1140570,26,0,26,24,15,3,42,129,12,183
1140571,6,3,9,62,28,0,90,168,15,273
1140601,5,0,5,36,17,6,59,137,6,202
1140602,0,0,0,59,10,0,69,161,26,256
1140603,3,4,7,65,23,3,91,223,28,342
1140604,0,0,0,94,26,6,126,168,30,324
1140605,8,3,11,62,24,3,89,149,12,250
1140606,0,0,0,55,27,3,85,154,6,245
1140607,0,0,0,49,20,3,72,97,6,175
1140608,3,0,3,126,33,6,165,240,21,426
1140609,0,0,0,91,11,6,108,150,15,273
1140610,0,0,0,38,12,0,50,142,7,199
1140611,0,0,0,92,40,0,132,245,24,401
1140612,4,0,4,58,20,0,78,111,10,199
1140613,19,3,22,90,16,6,112,229,14,355
1140614,0,0,0,67,22,6,95,120,12,227
1140615,7,0,7,76,26,6,108,152,6,266
1140616,5,0,5,96,9,9,114,169,9,292
1140617,0,0,0,3,0,0,3,0,0,3
1140618,0,0,0,65,34,6,105,157,3,265
1140619,0,6,6,108,23,12,143,233,24,400
1140620,0,0,0,57,28,6,91,165,12,268
1140621,7,3,15,71,24,5,100,158,9,267
1140622,4,0,4,78,23,6,107,184,6,297
1140623,7,3,10,87,30,9,126,292,35,453
1140624,8,0,8,95,22,3,120,260,9,389
1140625,9,0,9,75,21,0,96,190,3,289
1140626,0,0,0,51,24,5,80,159,6,245
1140627,6,0,6,77,18,3,98,136,9,243
1140628,0,0,0,48,34,3,85,139,9,233
1140629,3,0,3,70,21,3,94,231,6,331
1140630,3,0,3,72,8,6,86,127,6,219
1140631,0,0,0,79,32,6,117,166,6,289
1140632,0,0,0,0,0,0,0,6,0,6
1140633,4,0,4,84,44,3,131,249,9,389
1140634,6,0,6,91,32,9,132,251,0,383
1140635,4,0,4,70,40,0,110,231,7,348
1140636,7,0,7,71,29,0,100,194,3,297
1140637,3,0,3,55,19,12,86,103,6,195
1140638,5,0,5,71,28,5,104,229,12,345
1140639,0,3,3,51,9,6,66,141,27,234
1140640,32,3,39,89,40,6,135,283,12,430
1140641,4,0,4,117,36,9,162,277,4,443
1140642,6,0,6,112,40,4,156,245,14,415
1140643,0,0,0,50,42,0,92,169,18,279
1140644,3,0,3,104,40,0,144,205,7,356
1140645,8,3,11,49,23,3,75,223,14,312
1140646,8,0,8,53,17,0,70,260,12,342
1140647,88,42,130,26,10,0,36,231,69,336
1140648,18,0,18,69,20,4,93,308,17,418
1140701,3,0,3,62,27,3,92,256,7,355
1140702,8,0,8,75,19,3,97,208,12,317
1140703,3,0,3,55,14,6,75,149,9,233
1140704,6,0,6,95,34,4,133,260,22,415
1140705,139,24,163,51,11,3,65,371,37,473
1140706,6,0,9,110,35,0,145,267,17,429
1140707,4,0,4,82,19,0,101,158,6,265
1140708,8,0,8,110,28,3,141,257,21,419
1140709,11,0,11,90,27,6,123,169,3,295
1140710,9,3,12,117,29,4,150,250,6,406
1140711,3,3,6,62,25,0,87,187,3,277
1140712,8,0,8,123,22,6,151,270,36,457
1140713,8,0,8,52,13,3,68,202,18,288
1140714,9,4,13,24,14,0,38,113,13,164
1140715,19,71,90,162,61,3,226,608,164,998
1140716,0,0,0,0,0,0,0,0,0,0
1140717,20,5,25,144,55,3,202,408,52,662
1140718,6,0,6,51,22,0,73,147,3,223
1140719,12,0,12,44,10,0,54,218,16,288
1140720,0,0,0,0,0,0,0,0,0,0
1140721,0,0,0,53,17,7,77,136,14,227
1140722,13,3,16,62,15,0,77,165,6,248
1140723,3,0,3,77,11,3,91,200,20,311
1140724,5,0,5,55,24,6,85,177,3,265
1140725,0,0,0,75,12,6,93,202,16,311
1140726,0,0,0,52,24,0,76,187,22,285
1140727,12,0,12,90,38,0,128,280,24,432
1140728,3,0,3,91,12,0,103,187,10,300
1140729,3,0,3,77,16,6,99,160,13,272
1140730,4,0,4,57,15,0,72,119,3,194
1140731,7,0,7,52,14,3,69,134,12,215
1140732,3,0,3,90,22,6,118,246,18,382
1140733,6,0,6,44,17,0,61,140,13,214
1140734,7,0,7,48,27,0,75,133,10,218
1140735,0,0,0,67,20,0,87,188,9,284
1140736,0,0,0,66,19,3,88,211,20,319
1140737,120,9,129,60,21,12,93,316,17,426
1140738,11,3,14,54,20,0,74,186,25,285
1140739,7,0,7,72,38,3,113,182,3,298
1140740,11,0,11,138,28,0,166,480,30,676
1140741,8,0,8,85,25,0,110,336,18,464
1140742,8,5,13,127,22,0,149,266,9,424
1140743,10,9,19,97,48,3,148,299,21,468
1140744,25,0,25,35,9,3,47,167,13,227
1140745,4,3,7,43,25,0,68,180,12,260
1140746,5,0,5,58,22,0,80,144,0,224
1140801,3,0,3,67,23,3,93,154,9,256
1140802,3,0,3,59,12,3,74,118,6,198
1140803,4,0,4,69,24,3,96,204,31,331
1140804,8,0,8,96,32,7,135,217,17,369
1140805,11,0,11,86,25,0,111,203,24,338
1140806,8,0,8,80,36,3,119,174,0,293
1140807,8,0,11,93,35,0,128,231,16,375
1140808,75,14,92,31,15,3,49,172,26,247
1140809,5,0,5,66,4,0,70,120,12,202
1140810,3,0,3,76,31,9,116,232,15,363
1140811,3,0,3,52,21,0,73,101,10,184
1140812,6,0,6,92,17,6,115,191,27,333
1140813,0,0,0,96,20,6,122,156,12,290
1140814,0,0,0,65,21,0,86,181,10,277
1140815,38,3,41,57,15,5,77,205,21,303
1140816,4,0,4,49,17,0,66,133,12,211
1140817,0,0,0,94,24,0,118,153,13,284
1140818,7,0,7,59,12,0,71,110,17,198
1140819,6,0,6,75,21,3,99,126,21,246
1140820,3,0,3,73,30,3,106,122,13,241
1140821,9,0,9,111,47,6,164,212,13,389
1140822,9,0,9,92,24,0,116,192,21,329
1140823,8,0,8,75,17,0,92,155,18,265
1140824,5,0,5,31,18,0,49,104,12,165
1140825,16,4,20,65,19,0,84,210,31,325
1140826,16,3,19,105,21,0,126,279,29,434
1140827,0,0,0,57,10,6,73,111,4,188
1140828,9,8,17,119,40,0,159,409,28,596
1140829,6,0,6,76,21,3,100,170,9,279
1140830,0,0,0,47,12,3,62,88,18,168
1140831,6,3,9,81,47,4,132,259,18,409
1140832,28,8,36,60,33,3,96,229,30,355
1140833,7,0,7,58,12,0,70,122,13,205
1140834,6,3,9,77,29,7,113,245,18,376
1140835,5,3,8,94,17,4,115,174,6,295
1140836,0,3,6,77,32,3,112,158,15,285
1140837,42,24,66,96,53,3,152,452,67,671
1140838,9,0,9,153,28,6,187,250,8,445
1140839,4,0,4,54,8,0,62,124,7,193
1140840,6,0,6,77,15,7,99,216,7,322
1140841,8,0,8,76,21,4,101,185,15,301
1140842,3,0,3,73,21,8,102,148,8,258
1140843,7,6,13,60,23,3,86,216,22,324
1140844,12,8,20,98,19,12,129,237,20,386
1140845,14,0,14,126,39,9,174,213,24,411
1140846,10,0,10,86,28,0,114,133,7,254
1140847,3,0,3,75,11,0,86,139,23,248
1140848,7,0,7,81,16,0,97,168,30,295
1140849,6,0,6,63,14,4,81,167,3,251
1140850,7,0,7,83,19,3,105,193,12,310
1140851,6,0,6,82,28,0,110,156,11,277
1140852,3,0,3,62,9,3,74,172,32,278
1140853,12,3,15,93,26,0,119,252,44,415
1140854,3,0,3,38,18,8,64,76,3,143
1140901,0,0,0,0,0,0,0,0,0,0
1140902,0,0,3,77,31,9,117,191,14,322
1140903,5,0,5,62,20,4,86,226,5,317
1140904,4,6,10,82,15,3,100,180,13,293
1140905,10,0,10,93,13,0,106,177,13,296
1140906,23,0,26,57,24,3,84,170,8,262
1140907,6,3,9,107,21,6,134,239,18,391
1140908,9,8,17,103,20,0,123,188,29,340
1140909,6,0,6,66,30,14,110,161,3,274
1140910,6,0,6,64,12,3,79,129,3,211
1140911,6,0,6,77,21,0,98,236,21,355
1140912,6,0,6,48,16,7,71,124,6,201
1140913,6,0,6,81,31,6,118,181,9,308
1140914,6,0,6,128,33,7,168,257,12,437
1140915,10,3,13,86,31,0,117,185,13,315
1140916,6,0,6,79,11,0,90,121,6,217
1140917,11,0,11,111,23,13,147,172,3,322
1140918,0,0,0,82,17,3,102,158,3,263
1140919,16,0,16,82,28,4,114,183,6,303
1140920,8,4,12,127,23,3,153,321,19,493
1140921,6,3,9,105,13,0,118,157,11,286
1140922,0,0,0,64,19,0,83,173,12,268
1140923,5,0,5,67,25,0,92,222,11,325
1140924,11,0,11,102,36,0,138,393,21,552
1140925,15,3,18,159,60,0,219,459,39,717
1140926,0,0,0,68,19,3,90,162,13,265
1140927,15,3,18,98,22,3,123,291,20,434
1140928,9,8,21,62,32,3,97,237,34,368
1140929,7,0,7,98,32,3,133,247,15,395
1140930,7,0,7,42,21,0,63,108,3,174
1140931,12,5,17,106,29,9,144,207,13,364
1140932,12,0,12,98,11,11,120,192,12,324
1140933,13,0,13,95,31,8,134,310,17,461
1140934,6,0,6,56,18,6,80,154,6,240
1140935,6,0,6,82,33,6,121,219,4,344
1140936,10,3,13,72,32,4,108,275,24,407
1140937,6,0,6,72,37,0,109,257,18,384
1141001,13,0,13,42,33,6,81,223,10,314
1141002,6,3,9,46,30,0,76,185,20,281
1141003,14,0,14,91,25,8,124,268,5,397
1141004,10,0,10,49,32,0,81,162,3,246
1141005,6,0,6,44,18,0,62,136,4,202
1141006,6,0,6,87,24,3,114,187,6,307
1141007,6,0,10,116,40,0,156,266,15,437
1141008,10,6,16,67,35,3,105,198,24,327
1141009,12,3,15,60,36,0,96,243,33,372
1141010,5,0,5,88,38,0,126,245,36,407
1141011,4,0,4,150,24,4,178,299,19,496
1141012,4,0,4,80,54,6,140,241,15,396
1141013,12,3,15,101,44,0,145,302,24,471
1141014,0,0,0,37,14,4,55,145,5,205
1141015,3,0,3,76,22,0,98,204,11,313
1141016,8,3,11,80,33,3,116,213,14,343
1141017,12,0,12,96,54,4,154,338,18,510
1141018,14,3,17,73,29,3,105,231,12,348
1141019,0,0,0,0,0,0,0,0,0,0
1141020,8,0,8,84,36,3,123,238,10,371
1141021,0,0,0,75,23,0,98,205,9,312
1141022,4,0,4,97,24,9,130,248,13,391
1141023,3,0,3,66,19,3,88,150,7,245
1141024,3,4,7,85,22,0,107,211,15,333
1141025,8,0,8,96,41,3,140,220,6,366
1141026,0,0,0,0,0,0,0,0,0,0
1141027,7,4,11,78,49,3,130,292,19,441
1141028,8,0,8,83,27,3,113,211,14,338
1141029,6,4,13,34,40,0,74,178,22,274
1141030,6,0,6,98,37,0,135,250,12,397
1141031,3,4,7,84,24,0,108,221,7,336
1141032,3,0,6,67,20,7,94,196,21,311
1141033,3,0,3,58,24,3,85,146,6,237
1141034,43,6,49,97,57,6,160,459,39,658
1141035,6,6,12,72,40,3,115,230,18,363
1141036,20,6,26,184,67,6,257,522,77,856
1141037,0,0,0,67,26,3,96,170,25,291
1141038,3,3,6,67,30,0,97,197,21,315
1141039,3,0,3,68,22,3,93,192,6,291
1141040,7,6,13,75,24,4,103,217,30,350
1141041,11,0,11,81,21,3,105,196,21,322
1141042,73,20,93,29,18,0,47,256,36,339
1141043,10,4,14,128,45,3,176,302,26,504
1141101,3,0,3,89,31,3,123,189,17,329
1141102,7,3,10,93,28,10,131,217,28,376
1141103,9,0,9,95,20,5,120,218,9,347
1141104,5,0,5,114,33,0,147,190,23,360
1141105,3,3,6,112,39,0,151,217,15,383
1141106,3,3,6,59,13,3,75,118,19,212
1141107,4,0,4,65,26,3,94,124,18,236
1141108,6,0,6,70,31,3,104,195,8,307
1141109,6,0,6,37,23,4,64,128,12,204
1141110,0,0,0,68,14,4,86,166,6,258
1141111,11,3,17,94,43,6,143,249,15,407
1141112,0,0,0,58,16,3,77,147,7,231
1141113,71,4,75,40,18,4,62,221,11,294
1141114,69,6,78,3,52,3,58,309,18,385
1141115,76,3,79,68,14,3,85,307,17,409
1141116,0,0,0,0,0,0,0,0,0,0
1141117,175,38,213,20,39,0,59,378,47,484
1141118,8,0,8,69,28,3,100,199,12,311
1141119,10,0,10,120,28,5,153,246,16,415
1141120,6,0,6,61,24,12,97,141,0,238
1141121,13,3,16,36,21,0,57,173,9,239
1141122,62,10,72,41,19,0,60,335,39,434
1141123,13,0,13,103,25,0,128,305,23,456
1141124,8,5,13,78,38,5,121,242,9,372
1141125,13,0,13,66,15,6,87,180,11,278
1141126,4,0,4,104,28,6,138,213,25,376
1141127,15,0,15,110,24,6,140,199,11,350
1141128,6,0,6,61,13,0,74,136,18,228
1141129,10,0,10,109,24,9,142,239,15,396
1141130,6,0,6,78,26,3,107,265,20,392
1141131,12,0,12,121,46,5,172,314,16,502
1141132,13,7,20,85,27,6,118,224,19,361
1141133,11,0,11,94,35,5,134,251,15,400
1141134,8,0,8,84,36,7,127,254,41,422
1141135,3,0,3,64,17,8,89,175,7,271
1141136,6,0,6,86,30,8,124,209,13,346
1141137,80,3,83,19,8,0,27,195,18,240
1141138,7,3,10,44,0,6,50,126,9,185
1141139,8,0,8,61,30,0,91,151,13,255
1141140,11,4,15,101,33,4,138,268,11,417
1141141,3,0,3,46,30,0,76,186,7,269
1141142,7,0,7,96,18,0,114,173,3,290
1141143,0,3,3,88,31,4,123,197,16,336
1141144,3,0,3,53,38,0,91,254,38,383
1141201,8,0,8,94,34,9,137,163,6,306
1141202,6,0,9,114,33,8,155,260,23,438
1141203,0,0,0,103,26,6,135,203,10,348
1141204,64,43,107,29,24,0,53,272,58,383
1141205,9,0,9,102,24,0,126,292,27,445
1141206,6,0,6,75,22,0,97,164,14,275
1141207,6,0,6,109,41,3,153,293,16,462
1141208,4,0,7,38,29,3,70,154,6,230
1141209,7,0,7,105,11,0,116,202,21,339
1141210,0,0,0,58,26,3,87,144,11,242
1141211,3,0,3,47,13,0,60,128,40,228
1141212,8,0,8,64,27,0,91,225,16,332
1141213,64,49,113,100,47,3,150,478,99,727
1141214,6,0,6,63,27,3,93,207,15,315
1141215,4,0,4,42,32,3,77,142,16,235
1141216,11,0,11,165,43,3,211,397,76,684
1141217,0,0,3,52,33,6,91,189,9,289
1141218,7,3,10,92,18,6,116,286,33,435
1141219,7,0,7,82,34,0,116,211,21,348
1141220,5,3,8,43,25,6,74,167,13,254
1141221,7,0,7,69,37,3,109,232,12,353
1141222,18,0,18,77,55,0,132,290,11,433
1141223,24,0,24,104,29,0,133,398,42,573
1141224,3,0,3,82,41,6,129,243,10,382
1141225,3,0,3,60,26,0,86,157,14,257
1141226,6,0,6,89,18,5,112,252,6,370
1141227,15,0,15,69,59,0,128,249,15,392
1141228,3,3,6,67,26,3,96,151,9,256
1141229,3,3,6,60,26,0,86,215,14,315
1141230,11,0,11,121,46,3,170,348,27,545
1141231,4,3,7,72,28,4,104,183,6,293
1141232,7,0,7,75,29,0,104,199,11,314
1141233,6,0,10,77,8,3,88,153,0,241
1141234,9,0,9,106,51,3,160,259,21,440
1141235,9,3,12,53,11,0,64,125,25,214
1141236,3,0,3,74,30,0,104,237,15,356
1141237,4,4,8,117,37,3,157,235,7,399
1141238,3,3,6,71,22,0,93,233,7,333
1141239,0,0,0,0,0,0,0,0,0,0
1141301,9,0,9,50,30,0,80,207,22,309
1141302,7,0,7,118,24,3,145,237,16,398
1141303,3,3,6,48,19,0,67,235,60,362
1141304,6,0,6,92,32,3,127,256,41,424
1141305,4,0,4,54,15,3,72,236,33,341
1141306,3,3,6,103,20,0,123,186,15,324
1141307,7,3,10,53,16,0,69,225,33,327
1141308,0,0,0,47,8,0,55,175,23,253
1141309,6,3,9,53,11,0,64,233,53,350
1141310,6,6,12,65,36,6,107,368,31,506
1141311,10,0,10,88,28,3,119,364,15,498
1141312,3,0,3,81,10,0,91,155,13,259
1141313,6,0,6,84,22,0,106,300,26,432
1141314,0,0,0,67,24,0,91,135,21,247
1141315,8,0,8,96,20,8,124,192,25,341
1141316,7,3,10,62,20,6,88,222,25,335
1141317,3,0,3,56,26,9,91,234,15,340
1141318,6,0,6,53,20,3,76,221,24,321
1141319,6,0,6,87,27,0,114,194,47,355
1141320,8,3,11,29,19,0,48,258,26,332
1141321,8,3,11,74,24,9,107,239,33,379
1141322,7,0,7,67,22,3,92,208,25,325
1141323,6,0,6,77,3,3,83,144,15,242
1141324,0,0,0,78,10,0,88,172,24,284
1141325,0,7,7,70,14,0,84,299,28,411
1141326,12,3,15,67,29,0,96,259,73,428
1141327,0,0,0,36,37,0,73,294,69,436
1141328,4,3,7,40,23,0,63,183,62,308
1141329,8,5,13,65,22,6,93,418,50,561
1141330,8,0,8,43,23,3,69,237,22,328
1141331,4,0,7,54,21,0,75,163,17,255
1141332,9,0,9,85,37,4,126,316,38,480
1141333,9,0,9,67,27,0,94,227,32,353
1141334,6,0,6,58,21,0,79,197,20,296
1141335,6,3,9,55,29,0,84,387,28,499
1141336,0,0,0,57,15,0,72,270,31,373
1141337,7,3,10,54,21,0,75,358,81,514
1141338,9,4,13,51,14,0,65,380,76,521
1141339,0,0,0,35,15,0,50,201,23,274
1141340,10,0,10,41,23,0,64,220,15,299
1141341,12,5,20,48,29,3,80,331,46,457
1141342,3,0,3,59,17,0,76,216,32,324
1141401,0,0,0,29,13,0,42,251,27,320
1141402,0,0,0,52,3,4,59,144,27,230
1141403,4,0,4,46,9,0,55,207,9,271
1141404,0,0,0,33,18,0,51,192,21,264
1141405,0,0,0,31,31,3,65,185,42,292
1141406,6,0,6,54,22,4,80,211,10,301
1141407,3,0,3,47,15,0,62,236,25,323
1141408,5,0,5,45,20,0,65,342,48,455
1141409,4,0,4,49,20,4,73,417,32,522
1141410,13,3,16,62,20,3,85,290,23,398
1141411,12,0,15,62,35,0,97,390,21,508
1141412,3,0,3,54,32,6,92,274,15,381
1141413,0,0,0,31,9,4,44,196,26,266
1141414,4,3,7,61,23,3,87,257,15,359
1141415,5,0,5,60,37,3,100,363,32,495
1141416,9,0,9,54,26,0,80,392,51,523
1141417,0,3,3,72,21,0,93,377,39,509
1141418,4,0,4,65,41,3,109,321,28,458
1141419,4,0,7,60,20,4,84,178,12,274
1141420,0,0,0,53,19,6,78,321,58,457
1141421,3,3,9,56,16,0,72,157,9,238
1141422,4,0,4,45,15,0,60,193,16,269
1141423,3,0,3,29,17,3,49,126,6,181
1141424,5,0,5,68,15,0,83,356,26,465
1141425,0,0,0,38,14,0,52,183,39,274
1141426,5,0,5,32,20,0,52,245,39,336
1141427,3,0,3,52,15,3,70,185,12,267
1141428,0,0,0,47,15,0,62,189,10,261
1141429,0,0,0,54,17,0,71,183,24,278
1141430,6,0,6,91,17,5,113,271,40,424
1141431,0,3,3,53,7,0,60,280,39,379
1141432,0,0,0,81,19,0,100,317,45,462
1141433,3,0,3,50,10,0,60,180,39,279
1141434,0,0,0,43,18,3,64,249,68,381
1141435,0,0,0,39,3,0,42,186,16,244
1141436,0,4,4,39,19,0,58,225,46,329
1141437,6,0,6,32,12,0,44,146,21,211
1141438,8,0,8,44,17,0,61,280,22,363
1141439,0,0,0,22,21,0,43,172,41,256
1141440,0,0,0,22,15,0,37,205,15,257
1141441,0,0,0,34,6,0,40,133,6,179
1141442,0,0,0,33,14,0,47,238,30,315
1141443,3,3,6,16,22,3,41,213,18,272
1141444,8,0,8,15,9,0,24,223,24,271
1141501,0,0,0,57,18,3,78,98,12,188
1141502,3,0,3,48,13,0,61,143,31,235
1141503,7,0,7,94,33,3,130,232,33,395
1141504,9,3,12,34,28,0,62,163,32,257
1141505,3,0,3,99,17,0,116,133,3,252
1141506,6,0,6,90,25,3,118,176,29,323
1141507,3,3,6,59,28,3,90,157,24,271
1141508,11,3,14,76,26,0,102,300,29,431
1141509,11,0,11,46,39,0,85,247,72,404
1141510,0,0,0,0,0,0,0,4,0,4
1141511,6,3,9,62,27,0,89,201,18,308
1141512,5,0,5,85,11,5,101,238,22,361
1141513,4,3,7,103,30,3,136,178,12,326
1141514,5,0,5,109,22,7,138,177,10,325
1141515,3,3,6,55,13,0,68,203,29,300
1141516,7,0,7,60,25,0,85,189,9,283
1141517,10,0,10,51,25,0,76,255,29,360
1141518,7,0,7,59,35,3,97,328,64,489
1141519,0,0,0,66,12,3,81,127,12,220
1141520,78,12,90,44,16,6,66,255,39,360
1141521,47,0,47,110,18,7,135,288,23,446
1141522,10,3,13,94,11,6,111,277,27,415
1141523,42,9,55,60,28,0,88,275,36,399
1141524,8,0,8,19,11,0,30,143,18,191
1141525,9,0,9,48,38,6,92,226,34,352
1141526,4,0,4,45,19,0,64,293,26,383
1141527,3,0,3,67,18,3,88,270,35,393
1141528,9,3,12,44,19,3,66,169,31,266
1141529,7,0,7,31,23,3,57,208,62,327
1141530,9,0,9,101,19,3,123,246,37,406
1141531,12,4,16,98,38,0,136,254,21,411
1141532,4,0,4,111,36,11,158,244,19,421
1141533,6,0,6,50,22,4,76,349,22,447
1141534,13,22,35,25,23,0,48,122,51,221
1141535,7,0,7,126,39,3,168,319,35,522
1141536,3,0,3,115,35,3,153,250,21,424
1141537,0,0,0,7,6,0,13,87,20,120
1141538,6,0,6,69,18,0,87,175,15,277
1141539,10,0,10,74,44,9,127,212,18,357
1141540,3,0,6,66,24,0,90,292,25,407
1141541,12,0,12,89,45,3,137,412,31,580
1141542,13,3,16,81,32,0,113,312,37,462
1141543,5,4,9,110,31,5,146,220,34,400
1141544,7,0,7,36,18,0,54,149,46,249
1141545,35,3,38,87,29,3,119,197,21,337
1141546,49,0,49,55,13,0,68,290,35,393
1141547,0,0,0,67,18,6,91,113,13,217
1141548,4,0,4,91,7,3,101,124,9,234
1141549,0,0,0,51,29,0,80,223,34,337
1141550,3,0,3,47,15,8,70,123,15,208
1141551,6,6,12,57,13,3,73,182,21,276
1141552,8,3,11,60,20,6,86,220,84,390
1141553,28,3,31,60,13,3,76,261,58,395
1141554,5,3,8,76,18,0,94,123,18,235
1141555,8,0,8,30,18,9,57,181,36,274
1141556,65,10,75,30,12,0,42,310,48,400
1141557,3,0,3,62,4,6,72,128,11,211
1141558,7,4,14,61,40,3,104,257,61,422
1141559,3,0,6,97,18,6,121,153,6,280
1141560,3,0,3,85,20,3,108,371,45,524
1141561,0,6,6,81,11,4,96,153,33,282
1141562,11,0,14,50,27,0,77,171,21,269
1141563,6,0,6,53,24,6,83,150,27,260
1141564,0,0,0,0,0,0,0,0,0,0
1141565,3,3,6,48,14,0,62,111,14,187
1141566,3,0,3,74,20,0,94,242,24,360
1141567,3,0,3,50,15,0,65,97,9,171
1141568,8,0,8,46,11,6,63,145,12,220
1141569,7,0,7,45,11,0,56,132,15,203
1141570,0,0,0,58,16,0,74,99,18,191
1141571,6,0,6,60,11,0,71,136,11,218
1141601,12,3,15,36,38,3,77,341,69,487
1141602,9,5,14,47,16,0,63,323,27,413
1141603,6,0,6,39,9,0,48,181,33,262
1141604,3,0,3,60,20,0,80,332,26,438
1141605,3,5,8,55,21,0,76,332,24,432
1141606,0,0,0,97,25,9,131,310,27,468
1141607,4,0,4,48,30,0,78,294,27,399
1141608,6,0,6,32,25,0,57,170,20,247
1141609,0,0,3,76,22,0,98,280,28,406
1141610,0,0,0,44,24,0,68,320,39,427
1141611,0,3,3,21,9,4,34,159,49,242
1141612,3,3,6,37,21,0,58,158,22,238
1141613,0,0,0,31,17,0,48,337,33,418
1141614,3,3,9,90,28,0,118,398,24,540
1141615,7,3,10,69,30,0,99,401,27,527
1141616,4,0,4,26,20,3,49,125,35,209
1141617,39,3,45,51,47,0,98,352,64,514
1141618,3,3,6,26,24,0,50,325,83,458
1141619,6,0,6,29,39,0,68,314,17,399
1141620,86,39,125,11,13,0,24,255,106,385
1141621,24,6,30,46,25,0,71,410,77,558
1141622,9,0,9,43,18,3,64,376,60,500
1141623,8,0,8,40,39,3,82,332,67,481
1141624,4,0,4,31,26,3,60,221,24,305
1141625,6,0,6,38,35,0,73,388,60,521
1141626,4,0,4,16,10,0,26,259,44,329
1141627,7,0,7,53,22,3,78,265,14,357
1141628,6,3,9,49,19,3,71,229,15,315
1141629,4,0,4,55,19,0,74,362,60,496
1141630,65,8,73,27,20,0,47,487,47,581
1141631,0,0,0,29,26,0,55,387,50,492
1141632,0,0,0,41,10,0,51,205,9,265
1141633,6,6,12,57,22,6,85,344,44,473
1141634,3,6,9,25,10,0,35,129,25,189
1141635,9,4,13,77,29,0,106,341,172,619
1141636,0,0,0,48,16,0,64,247,19,330
1141637,3,3,6,72,23,0,95,389,31,515
1141701,3,0,3,80,20,0,100,254,32,386
1141702,20,6,26,17,6,0,23,140,24,187
1141703,0,0,0,57,18,0,75,352,27,454
1141704,0,0,0,42,6,0,48,249,53,350
1141705,0,0,0,0,0,0,0,0,0,0
1141706,0,0,0,44,8,0,52,274,49,375
1141707,8,0,8,13,15,0,28,191,17,236
1141708,0,0,0,33,30,9,72,318,81,471
1141709,0,0,0,12,15,0,27,235,50,312
1141710,0,0,0,0,0,0,0,3,0,3
1141711,0,0,0,0,0,0,0,0,0,0
1141712,6,0,6,29,18,3,50,171,37,258
1141713,0,0,0,19,4,0,23,140,17,180
1141714,10,0,10,29,33,0,62,293,37,392
1141715,6,0,6,91,41,4,136,418,82,636
1141716,0,0,0,49,26,0,75,238,23,336
1141717,0,4,4,27,21,0,48,189,15,252
1141718,6,3,9,21,37,0,58,298,49,405
1141719,6,3,9,51,19,0,70,181,27,278
1141720,7,3,10,84,57,3,144,492,118,754
1141721,9,0,9,23,14,0,37,165,36,238
1141722,0,0,0,0,0,0,0,0,0,0
1141723,3,0,3,52,10,0,62,331,96,489
1141724,3,0,3,71,25,4,100,331,18,449
1141725,6,3,9,46,49,0,95,394,84,573
1141726,3,0,3,30,6,0,36,242,47,325
1141727,0,0,0,0,0,0,0,0,0,0
1141728,5,3,8,11,21,3,35,199,37,271
1141801,14,6,20,51,21,0,72,212,18,302
1141802,0,0,0,0,0,0,0,0,0,0
1141803,6,3,9,129,16,7,152,171,18,341
1141804,9,0,9,86,27,6,119,264,16,399
1141805,4,0,4,114,12,15,141,167,0,308
1141806,10,0,13,130,29,8,167,229,3,399
1141807,13,0,13,170,20,10,200,241,10,451
1141808,9,0,12,131,25,7,163,251,15,429
1141809,10,3,13,82,18,5,105,207,15,327
1141810,4,0,4,67,23,0,90,108,9,207
1141811,6,3,9,60,36,6,102,175,9,286
1141812,12,0,12,116,27,0,143,239,24,406
1141813,12,0,12,117,21,0,138,191,6,335
1141814,9,4,13,75,13,6,94,127,10,231
1141815,6,6,12,118,27,3,148,227,42,417
1141816,3,0,3,77,22,3,102,158,9,269
1141817,9,0,9,105,24,3,132,228,22,382
1141818,8,3,11,61,27,6,94,237,42,373
1141819,10,0,10,99,26,3,128,226,9,363
1141820,6,0,9,59,37,3,99,197,17,313
1141821,5,3,8,83,15,15,113,164,38,315
1141822,0,0,3,92,20,3,115,178,27,320
1141823,16,3,19,130,36,11,177,225,26,428
1141824,7,0,7,138,50,6,194,360,27,581
1141825,7,6,13,161,19,9,189,310,25,524
1141826,9,4,13,129,38,11,178,429,73,680
1141827,4,0,4,122,15,3,140,208,42,390
1141828,7,0,7,72,41,0,113,255,30,398
1141829,4,0,4,98,28,7,133,186,27,346
1141830,10,0,10,86,37,7,130,214,16,360
1141831,7,0,7,89,22,0,111,135,12,258
1141832,9,4,13,115,25,15,155,199,23,377
1141833,0,0,0,37,9,0,46,106,0,152
1141834,20,0,20,96,44,3,143,366,30,539
1141835,4,0,4,84,26,0,110,182,13,305
1141836,6,4,10,83,34,0,117,209,15,341
1141837,7,0,7,62,18,0,80,93,21,194
1141838,9,0,9,145,34,9,188,176,21,385
1141839,11,0,11,129,32,8,169,179,12,360
1141840,20,0,20,91,21,4,116,203,6,325
1141841,16,0,16,118,45,6,169,258,18,445
1141842,0,0,0,0,0,0,0,0,0,0
1141901,13,3,16,34,27,0,61,272,44,377
1141902,6,0,6,81,24,0,105,254,17,376
1141903,4,0,4,139,19,5,163,207,22,392
1141904,3,0,3,52,9,6,67,124,24,215
1141905,72,53,125,75,21,9,105,296,94,495
1141906,3,3,6,98,25,0,123,264,23,410
1141907,6,0,6,58,15,6,79,192,21,292
1141908,3,0,3,46,20,4,70,252,43,365
1141909,3,0,3,98,9,0,107,174,10,291
1141910,6,3,9,55,26,0,81,275,36,392
1141911,7,3,10,26,12,0,38,127,22,187
1141912,0,0,0,65,24,0,89,298,33,420
1141913,3,0,3,24,6,0,30,163,37,230
1141914,7,0,7,45,19,0,64,142,18,224
1141915,6,0,6,50,23,0,73,168,9,250
1141916,5,3,8,65,25,3,93,198,18,309
1141917,16,4,20,89,47,3,139,337,25,501
1141918,10,3,13,91,36,6,133,306,36,475
1141919,3,0,3,91,21,0,112,159,30,301
1141920,3,3,6,107,19,0,126,210,30,366
1141921,6,0,6,64,46,0,110,357,26,493
1141922,13,0,13,41,34,0,75,332,75,482
1141923,7,3,10,19,21,0,40,391,86,517
1141924,9,0,9,52,20,0,72,345,88,505
1141925,0,3,3,30,15,0,45,232,32,309
1141926,4,4,8,80,24,0,104,244,41,389
1141927,6,7,13,49,33,3,85,219,121,425
1141928,5,0,5,46,26,0,72,312,27,411
1141929,9,3,12,41,36,0,77,279,40,396
1141930,3,0,3,22,7,0,29,140,12,181
1141931,7,5,12,53,34,0,87,221,15,323
1141932,11,3,17,94,49,0,143,324,33,500
1141933,6,0,6,69,30,0,99,367,54,520
1141934,14,0,14,74,25,3,102,291,30,423
1141935,0,0,0,63,24,3,90,188,52,330
1141936,7,5,12,65,28,5,98,350,61,509
1141937,0,0,0,61,16,0,77,264,87,428
1141938,3,0,3,114,34,9,157,233,27,417
1141939,0,0,0,11,0,0,11,20,12,43
1141940,0,0,0,104,12,0,116,210,34,360
1141941,9,4,13,41,29,3,73,188,23,284
1141942,0,0,0,3,0,0,3,9,0,12
1141943,0,0,0,109,31,0,140,267,20,427
1141944,5,0,5,73,28,0,101,215,30,346
1141945,6,0,6,125,26,6,157,272,12,441
1141946,14,6,20,31,20,0,51,227,47,325
1141947,9,4,13,46,42,0,88,397,46,531
1141948,7,0,7,43,20,0,63,356,57,476
1142001,3,3,6,90,33,10,133,198,16,347
1142002,3,0,3,53,34,9,96,212,39,347
1142003,4,0,4,25,45,0,70,137,30,237
1142004,0,0,0,52,23,10,85,214,26,325
1142005,10,4,14,54,40,0,94,257,33,384
1142006,19,3,22,30,48,3,81,206,27,314
1142007,6,3,9,87,57,0,144,269,9,422
1142008,3,0,3,39,33,3,75,185,9,269
1142009,4,0,4,65,29,4,98,174,7,279
1142010,3,0,3,64,27,0,91,178,9,278
1142011,55,6,61,84,19,9,112,262,18,392
1142012,8,0,8,55,19,0,74,128,3,205
1142013,5,0,5,69,24,4,97,274,30,401
1142014,4,0,4,76,23,9,108,167,9,284
1142015,0,3,3,72,27,4,103,149,12,264
1142016,6,5,11,99,40,3,142,273,17,432
1142017,7,4,11,133,45,6,184,260,21,465
1142018,0,0,0,0,0,0,0,0,0,0
1142019,0,0,0,0,0,0,0,0,0,0
1142020,3,0,3,113,34,0,147,237,24,408
1142021,0,0,0,64,25,0,89,150,19,258
1142022,3,0,3,42,19,3,64,158,5,227
1142023,3,0,3,85,17,5,107,204,23,334
1142024,4,0,4,115,27,9,151,296,25,472
1142025,3,6,9,96,41,0,137,238,16,391
1142026,12,3,15,104,21,10,135,229,12,376
1142027,7,0,7,72,18,6,96,144,9,249
1142028,70,22,92,66,28,0,94,303,44,441
1142029,10,0,10,123,38,8,169,257,41,467
1142030,8,0,8,138,44,6,188,263,32,483
1142101,3,0,3,162,45,9,216,306,29,551
1142102,3,0,3,139,52,3,194,221,19,434
1142103,6,0,6,59,38,9,106,176,10,292
1142104,6,0,6,118,41,0,159,204,14,377
1142105,9,0,9,104,31,10,145,285,15,445
1142106,6,3,12,127,58,3,188,306,30,524
1142107,5,0,5,43,14,0,57,138,3,198
1142108,4,0,4,45,30,6,81,165,12,258
1142109,9,3,12,127,61,13,201,310,24,535
1142110,0,0,0,36,27,0,63,151,11,225
1142111,8,0,8,83,48,3,134,324,32,490
1142112,0,6,6,48,37,0,85,128,17,230
1142113,0,0,0,45,16,0,61,176,16,253
1142114,4,0,4,93,37,3,133,160,10,303
1142115,0,0,0,59,25,3,87,129,20,236
1142116,3,0,3,99,29,3,131,189,31,351
1142117,10,0,10,93,18,0,111,205,16,332
1142118,6,0,6,82,35,3,120,221,27,368
1142119,6,0,6,36,35,0,71,157,25,253
1142120,116,10,129,35,40,10,85,386,34,505
1142121,0,3,3,52,38,3,93,236,34,363
1142122,11,0,11,92,51,4,147,213,19,379
1142123,92,15,107,32,26,0,58,278,40,376
1142201,3,0,3,98,34,0,132,234,24,390
1142202,11,0,11,51,29,0,80,207,40,327
1142203,6,0,6,39,18,0,57,136,0,193
1142204,6,0,6,97,34,3,134,180,30,344
1142205,6,3,9,77,26,4,107,203,21,331
1142206,3,0,3,60,26,4,90,157,19,266
1142207,3,0,3,65,27,6,98,170,18,286
1142208,0,0,0,72,17,0,89,135,12,236
1142209,0,0,0,46,24,3,73,152,6,231
1142210,0,0,0,69,31,3,103,161,22,286
1142211,6,3,9,109,41,10,160,234,37,431
1142212,14,10,24,46,24,3,73,229,28,330
1142213,14,3,17,45,20,6,71,157,26,254
1142214,3,0,3,63,24,0,87,178,3,268
1142215,3,0,3,62,28,3,93,167,13,273
1142216,5,0,5,54,32,6,92,193,18,303
1142217,6,3,9,73,13,0,86,215,28,329
1142218,0,0,0,60,7,0,67,132,21,220
1142219,0,0,0,73,27,8,108,173,18,299
1142220,6,3,9,98,24,5,127,208,14,349
1142221,10,0,10,82,16,0,98,198,15,311
1142222,6,3,9,95,30,0,125,224,18,367
1142223,6,3,9,48,29,6,83,199,27,309
1142224,0,0,0,33,25,6,64,182,9,255
1142225,3,0,3,63,30,10,103,200,27,330
1142226,6,0,6,86,27,14,127,236,35,398
1142227,3,0,3,96,27,9,132,243,24,399
1142228,6,3,9,90,15,3,108,197,12,317
1142229,0,3,3,47,20,3,70,145,27,242
1142230,0,0,0,70,27,3,100,184,31,315
1142231,6,0,6,70,20,4,94,192,31,317
1142232,3,0,3,32,22,0,54,95,18,167
1142233,18,5,23,97,36,3,136,249,51,436
1142234,0,0,0,58,23,3,84,137,20,241
1142301,0,0,0,112,28,7,147,155,17,319
1142302,26,14,40,108,33,6,147,327,57,531
1142303,6,0,6,135,40,7,182,255,21,458
1142304,0,0,0,68,7,0,75,159,8,242
1142305,6,0,6,101,36,6,143,226,26,395
1142306,15,0,19,68,20,0,88,223,4,315
1142307,5,0,5,68,35,6,109,215,15,339
1142308,3,0,7,55,25,3,83,163,0,246
1142309,3,3,6,117,34,6,157,228,25,410
1142310,30,3,33,94,29,0,123,188,11,322
1142311,3,0,3,41,18,4,63,132,9,204
1142312,3,0,3,76,34,4,114,180,4,298
1142313,3,3,6,80,30,9,119,177,15,311
1142314,6,0,6,91,39,4,134,253,33,420
1142315,0,0,0,85,22,4,111,154,9,274
1142316,35,3,38,101,33,6,140,295,28,463
1142317,14,14,28,86,27,7,120,276,59,455
1142318,15,40,55,211,45,12,268,361,80,709
1142319,0,0,0,219,54,13,286,329,42,657
1142320,4,0,4,66,30,8,104,139,18,261
1142321,6,0,6,96,37,9,142,280,15,437
1142322,7,0,7,74,18,6,98,196,22,316
1142323,3,3,6,87,24,6,117,128,16,261
1142324,4,0,4,67,23,0,90,143,16,249
1142325,3,0,3,46,32,6,84,104,15,203
1142326,0,0,0,98,19,5,122,211,21,354
1142327,6,0,6,51,23,0,74,87,21,182
1142328,73,6,79,120,46,11,177,392,23,592
1142329,0,0,0,91,27,9,127,169,21,317
1142330,6,3,9,89,18,6,113,215,13,341
1142331,6,0,6,27,25,0,52,57,15,124
1142332,14,3,17,86,48,9,143,318,37,498
1142333,0,0,0,48,11,0,59,88,18,165
1142334,3,0,3,134,27,12,173,245,22,440
1142335,6,3,9,122,32,16,170,256,33,459
1142336,4,5,9,67,24,4,95,116,23,234
1142337,6,4,10,76,33,3,112,229,36,377
1142338,13,4,17,67,36,0,103,289,20,412
1142339,6,0,6,63,45,0,108,324,22,454
1142340,17,3,20,41,38,0,79,248,34,361
1142341,3,0,3,62,46,9,117,208,9,334
1142342,39,0,39,48,20,3,71,261,6,338
1142343,0,0,0,0,0,0,0,4,0,4
1142344,43,26,69,87,38,0,125,370,61,556
1142345,43,0,43,113,41,0,154,397,44,595
1142346,7,4,11,116,38,11,165,285,36,486
1142347,3,0,3,72,19,0,91,221,6,318
1142348,7,0,7,63,35,6,104,214,17,335
1142401,8,0,8,109,24,6,139,261,27,427
1142402,0,0,0,73,27,3,103,157,9,269
1142403,8,0,8,80,26,3,109,195,14,318
1142404,3,0,3,47,27,0,74,134,17,225
1142405,10,0,10,48,14,4,66,142,16,224
1142406,4,0,4,68,27,0,95,208,16,319
1142407,10,0,10,67,27,3,97,197,9,303
1142408,9,0,9,79,24,7,110,198,27,335
1142409,3,0,6,104,31,7,142,243,23,408
1142410,3,3,6,123,27,12,162,264,34,460
1142411,3,0,3,67,33,3,103,176,22,301
1142412,6,0,6,101,40,4,145,232,30,407
1142413,9,0,9,77,25,0,102,186,10,298
1142414,0,0,0,88,36,3,127,158,6,291
1142415,0,0,0,69,13,0,82,117,6,205
1142416,6,0,6,58,15,6,79,138,13,230
1142417,3,3,6,57,23,3,83,129,18,230
1142418,3,3,6,103,41,0,144,249,18,411
1142419,0,0,0,126,44,6,176,262,27,465
1142420,4,3,7,50,9,0,59,203,15,277
1142421,3,0,6,51,12,0,63,91,3,157
1142422,6,0,6,95,32,7,134,235,13,382
1142423,8,0,8,91,24,0,115,217,24,356
1142424,7,0,7,102,11,4,117,207,16,340
1142425,3,0,7,56,21,3,80,144,26,250
1142426,33,3,36,45,24,0,69,219,23,311
1142427,11,6,17,62,15,3,80,218,30,328
1142428,11,3,14,53,29,13,95,234,26,355
1142429,13,0,13,56,11,0,67,192,15,274
1142430,3,0,3,57,13,0,70,116,9,195
1142431,13,0,13,51,17,3,71,239,14,324
1142432,9,4,13,38,27,0,65,177,26,268
1142433,95,20,115,39,23,0,62,316,37,415
1142501,3,0,3,68,15,0,83,99,3,185
1142502,3,0,3,61,15,6,82,108,3,193
1142503,28,7,38,31,19,3,53,154,17,224
1142504,0,0,0,44,18,0,62,97,6,165
1142505,6,0,6,63,18,4,85,109,3,197
1142506,5,0,5,63,16,0,79,188,16,283
1142507,3,0,3,103,37,4,144,170,10,324
1142508,6,3,9,57,6,0,63,122,6,191
1142509,4,0,4,81,25,0,106,126,16,248
1142510,3,3,6,52,20,4,76,136,21,233
1142511,0,0,3,47,18,0,65,102,12,179
1142512,3,0,3,40,20,3,63,140,9,212
1142513,0,3,3,79,12,0,91,135,14,240
1142514,3,0,3,94,38,0,132,187,21,340
1142515,11,3,14,18,25,0,43,118,12,173
1142516,3,3,6,97,39,6,142,187,15,344
1142517,0,0,0,57,26,3,86,172,19,277
1142518,3,0,3,125,44,9,178,239,19,436
1142519,3,0,3,85,38,6,129,209,19,357
1142520,0,0,0,0,0,0,0,3,0,3
1142521,8,0,8,68,47,0,115,169,15,299
1142522,0,0,0,9,0,0,9,7,0,16
1142523,77,19,96,74,33,3,110,388,43,541
1142601,6,6,12,110,34,0,144,248,41,433
1142602,3,0,3,71,26,0,97,317,62,476
1142603,0,0,0,88,19,6,113,285,15,413
1142604,8,0,8,75,23,0,98,246,17,361
1142605,6,0,6,67,18,0,85,320,52,457
1142606,0,3,3,72,10,4,86,229,55,370
1142607,3,0,3,45,8,0,53,228,28,309
1142608,0,0,0,77,25,0,102,309,43,454
1142609,3,0,3,36,8,4,48,121,7,176
1142610,6,0,6,85,30,6,121,132,8,261
1142611,0,0,0,46,11,0,57,155,15,227
1142612,0,0,0,87,36,0,123,217,12,352
1142613,3,0,3,40,9,4,53,96,12,161
1142614,4,0,4,32,7,0,39,148,10,197
1142615,0,3,3,65,16,3,84,172,21,277
1142616,12,0,12,101,36,0,137,244,30,411
1142617,4,0,4,53,7,0,60,138,24,222
1142618,0,0,0,43,9,4,56,91,6,153
1142619,4,0,4,59,15,0,74,196,31,301
1142620,3,3,6,50,20,3,73,210,9,292
1142621,4,0,4,58,27,3,88,215,16,319
1142622,4,0,4,50,21,6,77,244,11,332
1142623,3,5,8,52,12,0,64,307,44,415
1142624,0,0,0,46,15,0,61,200,22,283
1142625,0,0,0,44,12,0,56,198,26,280
1142626,3,5,8,46,8,3,57,147,20,224
1142627,3,0,3,37,18,0,55,149,17,221
1142628,8,0,8,92,29,6,127,282,16,425
1142629,6,3,9,52,15,3,70,213,24,307
1142630,23,3,29,71,46,0,117,385,37,539
1142631,7,0,7,65,26,3,94,340,43,477
1142632,10,0,10,113,32,11,156,344,36,536
1142633,4,0,4,77,22,3,102,347,52,501
1142634,9,0,9,67,22,7,96,124,3,223
1142635,4,0,4,47,16,0,63,116,15,194
1142636,4,0,4,44,29,0,73,234,31,338
1142637,13,3,16,99,51,0,150,458,39,647
1142638,0,0,0,79,9,6,94,144,15,253
1142639,3,3,6,66,17,3,86,200,13,299
1142640,3,3,6,41,6,9,56,114,22,192
1142641,3,3,6,100,27,9,136,248,24,408
1142642,6,0,6,43,20,7,70,153,25,248
1142643,8,0,8,45,28,3,76,142,18,236
1142644,0,0,0,60,15,0,75,327,31,433
1142645,6,4,10,101,36,4,141,347,27,515
1142646,8,3,11,87,22,4,113,313,27,453
1142647,10,0,10,50,21,9,80,100,21,201
1142648,6,0,9,96,23,4,123,178,9,310
1142649,6,3,9,117,35,6,158,219,24,401
1142650,7,3,10,76,14,6,96,183,12,291
1142651,4,0,4,71,24,3,98,142,12,252
1142652,12,0,12,105,33,6,144,203,22,369
1142653,0,0,0,69,18,3,90,246,25,361
1142654,3,0,3,74,7,3,84,173,15,272
1142655,4,0,4,90,26,0,116,288,30,434
1142656,0,0,0,74,28,0,102,265,24,391
1142701,8,0,8,57,29,3,89,181,12,282
1142702,6,0,6,88,33,4,125,199,8,332
1142703,3,0,3,40,23,0,63,106,3,172
1142704,0,0,0,53,14,0,67,89,18,174
1142705,11,3,14,39,19,0,58,112,25,195
1142706,9,0,9,56,9,0,65,84,16,165
1142707,0,0,0,72,25,3,100,93,6,199
1142708,9,0,9,75,18,3,96,167,7,270
1142709,9,0,9,107,37,12,156,226,21,403
1142710,3,0,3,53,14,4,71,133,12,216
1142711,4,0,4,83,22,9,114,143,6,263
1142712,30,6,36,46,25,0,71,212,22,305
1142713,4,0,4,100,14,4,118,119,8,245
1142714,0,0,0,76,22,6,104,145,30,279
1142715,4,0,4,50,13,0,63,134,12,209
1142716,5,0,5,47,18,3,68,143,12,223
1142717,8,0,8,60,18,7,85,108,23,216
1142718,4,3,7,100,12,10,122,212,19,353
1142719,7,0,7,63,29,8,100,186,3,289
1142720,4,0,7,62,31,0,93,164,15,272
1142721,4,0,4,91,27,3,121,185,25,331
1142722,0,0,0,0,0,0,0,0,0,0
1142723,6,0,6,44,7,0,51,120,12,183
1142724,0,0,0,0,0,0,0,0,0,0
1142725,0,0,0,0,0,0,0,0,0,0
1142726,0,0,0,79,30,7,116,183,7,306
1142727,4,0,4,83,20,4,107,109,3,219
1142728,10,0,10,84,16,0,100,149,12,261
1142729,5,0,5,78,27,4,109,205,7,321
1142730,0,0,0,0,0,0,0,0,0,0
1142731,0,0,0,0,0,0,0,0,0,0
1142732,0,0,0,69,24,0,93,124,10,227
1142733,0,0,0,57,13,6,76,82,10,168
1142734,7,0,7,72,23,6,101,137,4,242
1142735,76,8,84,76,18,3,97,245,20,362
1142736,8,0,8,83,28,3,114,230,21,365
1142737,6,0,6,76,25,0,101,148,15,264
1142738,6,3,9,64,27,6,97,160,9,266
1142739,0,0,0,79,35,6,120,193,16,329
1142740,3,0,3,50,12,6,68,108,31,207
1142741,4,0,4,95,21,3,119,183,10,312
1142801,0,3,3,67,28,3,98,162,12,272
1142802,10,0,10,123,43,5,171,242,18,431
1142803,7,3,10,120,37,11,168,258,20,446
1142804,12,0,12,106,29,8,143,293,12,448
1142805,3,3,6,89,33,6,128,175,8,311
1142806,7,0,7,118,46,0,164,197,30,391
1142807,0,0,0,102,33,8,143,158,18,319
1142808,0,0,0,66,18,6,90,122,9,221
1142809,3,0,3,62,33,3,98,180,9,287
1142810,3,0,3,50,24,8,82,119,6,207
1142811,0,0,0,62,17,0,79,125,6,210
1142812,7,0,7,95,30,12,137,194,9,340
1142813,0,0,0,68,29,0,97,141,9,247
1142814,4,3,7,85,47,0,132,220,18,370
1142815,0,3,3,70,21,0,91,111,12,214
1142816,0,0,0,62,32,4,98,148,6,252
1142817,9,0,9,89,43,6,138,260,27,425
1142818,6,0,6,77,45,0,122,266,27,415
1142819,4,0,4,91,42,0,133,226,15,374
1142820,170,9,179,25,7,3,35,340,15,390
1142821,3,3,6,100,55,12,167,246,31,444
1142822,4,0,4,33,13,0,46,83,16,145
1142823,3,0,3,78,6,3,87,121,0,208
1142824,3,0,3,64,30,0,94,153,10,257
1142825,0,0,0,0,0,0,0,0,0,0
1142826,3,0,3,59,20,3,82,143,9,234
1142827,0,0,0,43,21,4,68,146,9,223
1142828,6,0,6,90,26,3,119,193,6,318
1142829,6,0,6,66,20,4,90,134,0,224
1142830,6,0,6,72,25,4,101,184,9,294
1142831,0,6,6,96,19,5,120,146,14,280
1142832,3,3,9,111,29,11,151,186,39,376
1142833,0,3,3,87,23,7,117,203,9,329
1142834,5,0,5,112,16,4,132,196,3,331
1142835,3,0,3,78,30,3,111,258,9,378
1142836,4,0,4,82,37,0,119,216,13,348
1142837,0,0,0,42,25,3,70,114,12,196
1142838,0,0,0,0,0,0,0,0,0,0
1142839,0,0,0,62,27,6,95,118,3,216
1142840,3,0,3,52,37,0,89,184,9,282
1142841,102,24,126,8,30,3,41,277,39,357
1142842,4,0,4,83,48,4,135,251,12,398
1142843,0,0,0,84,19,3,106,155,9,270
1142844,0,0,0,86,35,0,121,169,7,297
1142845,3,0,3,90,34,6,130,181,21,332
1142846,77,20,97,36,20,3,59,276,36,371
1142847,3,0,3,150,43,3,196,239,7,442
1142848,10,0,10,102,53,9,164,216,7,387
1142849,3,0,3,58,27,9,94,150,6,250
1142850,0,0,0,69,18,0,87,147,0,234
1142851,4,0,4,94,46,8,148,202,10,360
1142852,0,0,0,60,23,0,83,150,19,252
1142853,3,0,3,63,18,3,84,109,9,202
1142854,0,0,0,39,22,3,64,135,9,208
1142855,0,0,0,85,41,3,129,232,9,370
1142856,0,3,3,76,31,4,111,129,9,249
1142857,3,0,3,109,36,6,151,210,13,374
1142858,0,0,0,57,18,0,75,123,13,211
1142859,0,0,0,48,21,3,72,151,6,229
1142860,5,0,5,73,20,3,96,182,15,293
1142861,0,0,0,0,0,0,0,0,0,0
1142862,3,3,6,76,19,5,100,141,14,255
1142863,0,3,3,72,17,0,89,126,3,218
1142864,0,0,0,82,53,11,146,315,17,478
1142901,6,3,9,81,12,3,96,213,13,322
1142902,5,0,5,99,15,7,121,193,9,323
1142903,5,0,5,95,22,3,120,110,10,240
1142904,8,3,11,43,23,0,66,237,29,332
1142905,7,0,7,131,27,6,164,193,31,388
1142906,9,0,9,104,27,9,140,193,34,367
1142907,4,3,7,45,19,0,64,119,25,208
1142908,6,3,9,97,22,8,127,284,24,435
1142909,3,0,3,105,32,6,143,310,27,480
1142910,0,0,0,34,4,8,46,110,11,167
1142911,3,0,6,60,16,6,82,113,6,201
1142912,5,0,5,58,6,9,73,148,6,227
1142913,9,0,9,52,16,0,68,242,25,335
1142914,5,4,9,109,47,3,159,331,33,523
1142915,0,0,0,27,22,0,49,142,15,206
1142916,7,0,7,32,17,5,54,205,8,267
1142917,11,3,14,127,30,5,162,219,13,394
1142918,0,0,0,0,0,0,0,0,0,0
1142919,0,0,0,3,0,0,3,18,0,21
1142920,7,0,7,20,13,0,33,184,22,239
1142921,3,3,6,70,19,5,94,203,23,320
1142922,5,4,9,84,18,7,109,150,13,272
1142923,4,0,4,61,21,4,86,242,25,353
1142924,0,0,0,24,18,3,45,146,16,207
1142925,3,0,3,66,15,0,81,169,7,257
1142926,0,0,0,48,15,3,66,182,23,271
1142927,3,0,3,62,19,6,87,233,32,352
1142928,5,0,5,35,21,0,56,190,18,264
1142929,9,0,9,143,41,4,188,369,42,599
1142930,0,0,0,0,3,0,3,34,4,41
1142931,8,0,8,80,19,9,108,242,10,360
1142932,15,6,21,77,43,3,123,307,45,475
1142933,3,0,3,109,30,9,148,407,49,604
1142934,0,3,3,73,16,0,89,64,6,159
1142935,0,0,0,0,0,0,0,0,0,0
1142936,0,3,3,42,13,3,58,121,18,197
1142937,8,0,8,104,25,3,132,173,20,325
1142938,9,0,9,63,19,0,82,187,23,292
1142939,0,0,0,55,21,4,80,129,12,221
1142940,8,0,8,128,26,6,160,211,18,389
1142941,31,3,34,83,24,3,110,225,32,367
1142942,11,0,11,57,24,4,85,146,7,238
1142943,15,3,18,83,15,5,103,210,27,340
1142944,9,0,9,81,15,6,102,198,18,318
1142945,5,0,5,76,7,4,87,123,6,216
1142946,6,0,6,60,30,3,93,269,31,393
1142947,0,0,0,60,21,5,86,272,17,375
1142948,4,0,4,95,32,3,130,481,38,649
1142949,3,3,6,40,26,0,66,109,21,196
1142950,6,0,6,40,22,3,65,148,9,222
1142951,47,10,57,121,34,9,164,452,61,677
1143001,0,0,0,70,16,3,89,206,13,308
1143002,8,0,8,113,31,5,149,214,25,388
1143003,10,0,10,95,18,3,116,186,12,314
1143004,8,3,11,100,25,11,136,280,12,428
1143005,3,3,6,113,22,13,148,156,9,313
1143006,0,3,3,165,21,7,193,202,23,418
1143007,3,0,3,41,7,4,52,74,12,138
1143008,75,17,92,34,12,3,49,349,56,454
1143009,3,4,7,112,35,6,153,239,21,413
1143010,6,3,9,108,39,4,151,183,14,348
1143011,6,0,6,107,27,4,138,166,25,329
1143012,0,0,0,0,0,0,0,0,0,0
1143013,3,0,3,62,16,0,78,146,18,242
1143014,4,0,4,79,16,0,95,135,14,244
1143015,0,0,0,102,44,0,146,359,27,532
1143016,4,0,4,104,22,3,129,410,24,563
1143017,56,4,60,60,15,3,78,280,7,365
1143018,6,0,6,59,13,0,72,221,17,310
1143019,0,0,0,73,14,0,87,184,25,296
1143020,6,3,9,65,14,0,79,127,6,212
1143021,4,0,4,85,11,7,103,128,13,244
1143022,18,43,61,114,35,3,152,243,96,491
1143023,4,0,4,67,16,14,97,115,11,223
1143024,16,0,16,122,24,6,152,258,12,422
1143025,56,6,62,95,37,6,138,294,28,460
1143026,0,0,0,76,12,3,91,154,7,252
1143027,6,0,6,56,27,5,88,183,9,280
1143028,6,0,6,79,25,6,110,193,20,323
1143029,12,9,21,103,40,3,146,300,29,475
1143030,12,0,12,110,27,8,145,175,15,335
1143031,0,0,0,68,30,3,101,100,6,207
1143032,7,3,10,82,23,3,108,147,10,265
1143033,6,0,6,100,21,7,128,188,9,325
1143034,10,0,10,87,20,6,113,186,14,313
1143035,4,3,7,44,10,6,60,184,3,247
1143036,0,3,3,133,28,3,164,217,36,417
1143037,0,0,0,66,32,0,98,133,18,249
1143038,7,0,7,86,20,3,109,162,7,278
1143101,49,4,53,71,28,0,99,293,31,423
1143102,10,0,10,54,48,3,105,289,22,416
1143103,3,0,3,33,18,0,51,190,35,276
1143104,19,10,29,29,18,0,47,225,53,325
1143105,7,0,7,68,27,6,101,179,25,305
1143106,4,0,4,89,40,0,129,252,33,414
1143107,8,0,8,49,23,4,76,175,33,284
1143108,4,3,7,68,22,0,90,241,38,369
1143109,9,0,9,28,24,0,52,102,9,163
1143110,3,0,3,36,21,3,60,213,6,279
1143111,6,0,6,47,26,3,76,234,19,329
1143112,606,69,678,0,16,0,16,981,132,1129
1143113,6,0,6,42,34,0,76,125,18,219
1143114,3,0,6,50,6,0,56,143,12,211
1143115,0,0,0,0,0,0,0,0,0,0
1143116,5,0,5,36,22,0,58,185,34,277
1143117,22,0,22,123,25,5,153,226,3,382
1143118,6,0,6,128,45,0,173,204,21,398
1143119,4,0,4,62,22,0,84,223,14,321
1143120,7,3,10,105,43,0,148,307,27,482
1143121,3,0,3,26,11,0,37,143,18,198
1143122,3,6,9,117,51,4,172,451,50,673
1143123,3,0,3,87,19,0,106,245,54,405
1143124,0,0,0,89,18,0,107,274,20,401
1143125,3,0,3,95,31,6,132,165,21,318
1143126,4,0,4,95,33,6,134,154,8,296
1143127,3,0,3,110,27,3,140,210,10,360
1143128,3,0,3,92,24,4,120,169,12,301
1143129,6,3,9,112,26,8,146,210,15,371
1143130,8,0,8,92,15,6,113,154,9,276
1143131,12,0,12,105,22,10,137,211,11,359
1143132,5,0,5,36,8,0,44,164,3,211
1143133,6,4,10,82,14,6,102,135,15,252
1143134,3,4,7,65,19,0,84,102,12,198
1143135,6,0,6,60,22,6,88,147,9,244
1143136,16,0,16,81,34,3,118,314,11,443
1143137,6,0,6,130,66,4,200,197,16,413
1143138,13,3,16,113,33,7,153,317,29,499
1143139,3,3,6,79,14,6,99,135,12,246
1143140,3,4,7,90,23,0,113,159,8,280
1143141,7,0,7,102,25,0,127,204,12,343
1143142,13,3,16,58,43,0,101,217,9,327
1143143,6,0,6,74,26,0,100,150,15,265
1143144,4,0,4,72,31,0,103,222,18,343
1143145,35,9,44,11,21,3,35,135,16,186
1143146,6,0,6,60,34,4,98,208,22,328
1143147,15,0,15,98,37,3,138,223,24,385
1143148,8,3,11,131,27,7,165,248,18,431
1143149,3,0,3,61,12,6,79,101,6,186
1143150,3,0,3,72,19,3,94,251,9,354
1143151,8,3,11,70,28,3,101,303,48,452
1143152,0,0,0,71,36,0,107,267,30,404
1143153,3,3,6,46,21,0,67,169,36,272
1143154,0,0,0,44,15,3,62,101,9,172
1143155,3,0,6,31,15,0,46,98,5,149
1143156,7,0,7,68,18,3,89,162,10,261
1143201,0,0,0,45,17,3,65,126,18,209
1143202,0,0,0,82,30,7,119,159,3,281
1143203,0,0,0,29,8,0,37,63,3,103
1143204,0,0,0,77,45,9,131,225,9,365
1143205,0,0,0,0,0,0,0,0,0,0
1143206,0,0,0,13,11,0,24,63,16,103
1143207,0,0,0,0,0,0,0,3,0,3
1143208,7,0,7,36,16,0,52,141,12,205
1143209,0,0,0,35,4,7,46,98,11,155
1143210,4,0,4,45,25,0,70,195,11,276
1143211,4,0,4,27,13,4,44,182,29,255
1143212,0,0,0,118,40,9,167,246,21,434
1143213,3,0,3,45,17,4,66,113,3,182
1143214,0,36,36,54,21,0,75,101,52,228
1143301,3,0,3,32,29,6,67,170,3,240
1143302,251,17,268,0,12,0,12,546,52,610
1143303,0,0,0,104,35,0,139,345,14,498
1143304,10,0,10,25,14,3,42,137,14,193
1143305,0,0,0,121,44,3,168,191,22,381
1143306,0,0,0,201,38,6,245,314,15,574
1143307,0,0,0,96,57,0,153,238,16,407
1143308,4,0,4,87,35,4,126,256,6,388
1143309,109,12,121,45,16,0,61,355,43,459
1143310,9,0,9,84,34,9,127,242,41,410
1143311,3,3,6,60,32,0,92,175,9,276
1143312,3,0,3,64,21,3,88,153,7,248
1143313,0,0,0,61,28,3,92,175,15,282
1143314,20,0,20,76,26,3,105,286,28,419
1143315,5,0,5,29,18,0,47,92,21,160
1143316,0,0,0,138,25,10,173,170,3,346
1143317,0,0,0,85,47,0,132,286,7,425
1143318,3,0,3,69,46,7,122,187,20,329
1143319,0,4,4,83,26,4,113,225,13,351
1143320,24,6,33,51,32,0,83,191,28,302
1143321,6,0,6,71,30,12,113,208,17,338
1143322,0,0,0,103,40,3,146,243,21,410
1143323,3,0,3,94,35,0,129,211,21,361
1143324,9,0,9,67,38,9,114,229,12,355
1143325,3,0,3,69,22,3,94,129,24,247
1143326,3,3,6,70,49,0,119,232,6,357
1143327,6,0,6,65,47,15,127,249,9,385
1143401,0,0,0,88,26,0,114,141,3,258
1143402,0,0,0,74,9,4,87,119,4,210
1143403,0,0,0,112,19,11,142,164,3,309
1143404,0,0,0,103,16,0,119,106,10,235
1143405,3,0,3,129,25,8,162,200,18,380
1143406,3,0,3,109,10,0,119,191,9,319
1143407,3,0,3,71,19,6,96,120,14,230
1143408,0,0,0,113,21,3,137,167,10,314
1143409,0,0,0,109,28,5,142,192,28,362
1143410,3,0,3,158,25,3,186,258,13,457
1143411,0,0,0,131,30,0,161,127,13,301
1143412,3,3,6,72,12,4,88,215,12,315
1143413,4,0,4,106,34,9,149,199,16,364
1143414,3,0,3,103,41,3,147,263,5,415
1143415,6,3,9,72,23,3,98,221,31,350
1143416,0,0,0,69,20,5,94,132,6,232
1143417,0,3,3,70,18,0,88,125,12,225
1143418,0,0,0,90,22,4,116,151,10,277
1143419,3,3,6,41,16,3,60,148,9,217
1143420,3,3,6,62,31,9,102,140,8,250
1143421,0,0,0,119,23,6,148,235,25,408
1143422,0,0,0,4,3,0,7,31,6,44
1143423,0,0,0,0,0,0,0,0,0,0
1143424,3,0,3,51,25,0,76,151,13,240
1143425,0,0,0,47,15,3,65,107,21,193
1143426,0,0,0,47,22,0,69,102,24,195
1143427,0,0,0,140,28,7,175,206,5,386
1143428,0,0,0,66,17,0,83,80,0,163
1143429,0,0,0,87,33,6,126,222,9,357
1143430,0,0,0,58,26,6,90,139,12,241
1143431,6,0,6,54,11,3,68,157,0,225
1143432,6,0,6,42,15,0,57,90,12,159
1143433,0,0,0,54,28,0,82,152,21,255
1143434,0,0,0,80,36,9,125,237,9,371
1143435,14,0,14,77,45,4,126,243,16,385
1143436,8,3,11,104,45,0,149,257,27,433
1143437,6,0,6,31,18,3,52,125,9,186
1143438,7,0,7,39,55,12,106,247,38,391
1143439,3,0,3,179,43,9,231,241,27,499
1143440,0,0,0,46,22,3,71,129,8,208
1143441,0,0,0,0,0,0,0,0,0,0
1143442,3,0,3,58,3,4,65,84,3,152
1143443,4,0,4,43,18,0,61,100,6,167
1143444,5,0,5,58,39,12,109,206,9,324
1143501,5,0,5,95,22,0,117,170,4,291
1143502,0,0,0,76,17,0,93,132,9,234
1143503,0,0,0,122,27,0,149,105,20,274
1143504,0,3,3,86,18,4,108,133,12,253
1143505,0,0,0,76,28,9,113,152,18,283
1143506,0,0,0,112,35,4,151,214,16,381
1143507,0,0,0,141,27,3,171,187,27,385
1143508,0,0,0,105,22,6,133,217,19,369
1143509,0,0,0,108,30,15,153,196,15,364
1143510,0,0,0,71,13,3,87,119,12,218
1143511,0,0,0,6,0,0,6,9,0,15
1143512,0,0,0,67,13,9,89,90,6,185
1143513,3,0,3,80,13,4,97,113,15,225
1143514,3,0,3,114,16,8,138,170,12,320
1143515,4,0,4,60,21,0,81,137,11,229
1143516,0,0,0,96,22,3,121,185,4,310
1143517,3,0,3,66,17,6,89,149,23,261
1143518,0,0,0,149,15,6,170,191,9,370
1143519,0,3,3,78,22,6,106,154,24,284
1143520,0,0,0,112,33,3,148,198,18,364
1143521,0,0,0,88,19,3,110,104,12,226
1143522,3,0,3,120,19,6,145,193,13,351
1143523,0,0,0,126,25,0,151,149,6,306
1143524,0,0,0,75,10,3,88,117,12,217
1143525,4,0,4,110,25,3,138,221,32,391
1143526,0,0,0,158,34,9,201,244,20,465
1143527,0,0,0,88,30,6,124,178,25,327
1143528,3,0,3,90,22,6,118,137,27,282
1143529,0,3,3,108,17,6,131,211,12,354
1143530,6,0,6,108,23,0,131,181,20,332
1143531,0,0,0,128,23,6,157,188,14,359
1143532,0,0,0,57,9,3,69,91,9,169
1143533,0,0,0,41,21,6,68,117,0,185
1143534,0,0,0,122,29,6,157,216,13,386
1143535,3,0,3,112,40,4,156,210,8,374
1143536,0,3,3,88,29,6,123,139,13,275
1143537,0,0,0,103,15,5,123,171,8,302
1143538,0,0,0,112,28,5,145,182,0,327
1143539,4,0,4,67,30,9,106,177,10,293
1143540,0,0,0,62,23,0,85,125,22,232
1143541,0,0,0,93,30,6,129,240,29,398
1143542,4,0,4,109,22,7,138,178,6,322
1143543,3,0,3,15,3,0,18,49,9,76
1143544,3,0,3,78,27,0,105,140,7,252
1143545,4,0,4,97,21,9,127,211,24,362
1143546,0,0,0,140,22,8,170,191,14,375
1143547,0,0,0,103,13,8,124,211,8,343
1143548,3,0,3,67,9,9,85,118,7,210
1143549,0,0,0,54,25,4,83,123,6,212
1143550,0,0,0,106,34,3,143,192,26,361
1143551,0,3,3,94,34,16,144,304,18,466
1143552,3,0,3,103,40,8,151,228,27,406
1143553,0,0,0,69,9,4,82,140,16,238
1143554,3,0,3,265,70,0,335,549,39,923
1143555,0,0,0,44,9,0,53,67,4,124
1143556,0,0,0,153,43,7,203,240,12,455
1143557,0,0,0,54,18,0,72,85,15,172
1143601,4,0,4,77,34,4,115,171,38,324
1143602,0,0,0,0,0,0,0,0,0,0
1143603,0,0,0,66,26,4,96,211,50,357
1143604,8,3,11,61,14,0,75,187,47,309
1143605,3,0,3,48,26,3,77,159,48,284
1143606,0,0,0,58,36,10,104,284,30,418
1143607,0,0,0,135,31,3,169,270,14,453
1143608,3,6,9,86,33,0,119,216,40,375
1143609,4,0,4,75,41,6,122,246,37,405
1143610,0,0,0,47,29,0,76,129,15,220
1143611,0,0,0,128,38,0,166,237,27,430
1143612,0,0,0,81,19,0,100,206,15,321
1143613,0,0,0,74,28,0,102,248,22,372
1143614,0,0,0,64,25,3,92,212,24,328
1143615,4,3,7,103,58,0,161,277,26,464
1143616,6,0,6,101,40,6,147,264,30,441
1143617,0,0,0,71,47,6,124,250,38,412
1143618,3,0,3,38,23,9,70,141,22,233
1143619,3,3,6,61,55,8,124,271,29,424
1143620,0,3,3,50,29,3,82,221,74,377
1143621,0,0,0,29,17,0,46,119,26,191
1143622,0,0,0,66,30,0,96,189,42,327
1143623,0,0,0,32,15,3,50,115,12,177
1143624,6,0,6,59,34,0,93,207,4,304
1143625,3,0,3,52,37,0,89,172,19,280
1143626,0,0,0,47,18,0,65,131,16,212
1143627,0,0,0,105,27,0,132,182,27,341
1143628,0,0,0,45,13,3,61,165,8,234
1143629,0,0,0,0,0,0,0,0,0,0
1143630,0,0,0,70,26,0,96,220,30,346
1143631,7,0,7,64,16,3,83,206,35,324
1143632,0,0,0,54,25,6,85,111,28,224
1143633,4,0,4,48,48,4,100,225,18,343
1143634,0,3,3,101,28,0,129,193,26,348
1143635,0,0,0,130,35,7,172,200,33,405
1143636,0,0,0,70,22,0,92,125,9,226
1143637,3,0,3,122,9,0,131,167,6,304
1143638,4,0,4,61,28,3,92,131,13,236
1143639,3,0,3,42,27,4,73,232,40,345
1143640,4,0,4,103,54,5,162,293,37,492
1143641,7,0,7,96,63,0,159,217,35,411
1143642,0,0,0,47,7,0,54,91,16,161
1143643,0,0,0,74,42,6,122,200,27,349
1143644,3,0,3,47,29,0,76,177,20,273
1143645,0,0,0,92,13,4,109,123,27,259
1143646,0,0,3,115,31,12,158,229,14,401
1143701,3,0,3,50,23,3,76,139,18,233
1143702,3,0,3,32,8,3,43,112,12,167
1143703,0,4,4,69,33,0,102,196,34,332
1143704,77,8,85,108,87,4,199,801,77,1077
1143705,0,0,0,0,6,0,6,3,0,9
1143706,0,0,0,63,28,0,91,203,29,323
1143707,3,0,3,59,26,0,85,180,26,291
1143708,0,0,0,45,19,4,68,130,33,231
1143709,0,0,0,3,0,0,3,0,0,3
1143710,0,3,3,81,55,3,139,224,37,400
1143711,3,0,3,42,21,0,63,125,29,217
1143712,7,0,7,39,7,3,49,164,31,244
1143713,6,0,6,106,40,9,155,269,39,463
1143714,3,6,9,79,36,9,124,285,36,445
1143715,9,0,9,59,21,3,83,245,28,356
1143716,4,0,4,70,18,6,94,217,27,338
1143717,6,7,13,50,9,0,59,212,46,317
1143718,6,8,14,55,17,0,72,235,36,343
1143719,0,0,0,47,15,3,65,133,13,211
1143720,0,0,0,87,48,3,138,213,39,390
1143721,0,0,0,88,32,9,129,255,12,396
1143722,0,0,0,3,0,0,3,0,0,3
1143723,0,0,0,0,0,0,0,19,20,39
1143724,4,3,7,113,41,3,157,294,26,477
1143725,7,0,7,63,24,0,87,137,17,241
1143726,0,0,0,88,32,6,126,273,42,441
1143727,3,0,3,66,18,0,84,134,13,231
1143728,14,6,20,86,55,0,141,378,29,548
1143729,3,0,3,73,29,5,107,235,15,357
1143730,6,3,9,77,46,4,127,259,12,398
1143731,0,0,0,51,29,0,80,241,10,331
1143732,3,3,6,87,25,6,118,205,26,349
1143733,0,0,0,64,26,3,93,223,10,326
1143734,3,0,3,96,21,6,123,283,17,423
1143735,0,0,0,0,8,0,8,183,29,220
1143736,0,3,3,56,32,3,91,324,44,459
1143737,3,0,3,70,10,0,80,158,18,256
1143738,4,0,4,69,19,3,91,186,17,294
1143739,3,0,3,138,25,12,175,209,45,429
1143801,0,0,0,37,16,0,53,115,6,174
1143802,0,0,3,50,25,4,79,136,0,215
1143803,3,0,3,60,34,0,94,152,24,270
1143804,3,0,3,80,37,0,117,184,22,323
1143805,0,0,0,88,26,0,114,219,17,350
1143806,0,0,0,67,43,4,114,213,24,351
1143807,3,0,3,65,39,0,104,199,22,325
1143808,3,0,3,34,10,3,47,126,28,201
1143809,0,0,0,86,45,0,131,236,45,412
1143810,0,0,0,85,26,10,121,194,21,336
1143811,0,0,0,85,18,0,103,214,13,330
1143812,0,0,0,80,31,3,114,216,30,360
1143813,0,0,0,85,32,0,117,194,29,340
1143814,6,0,6,84,33,6,123,233,40,396
1143815,0,0,0,54,25,0,79,160,13,252
1143816,4,0,4,96,33,3,132,290,29,451
1143817,0,0,0,86,27,0,113,231,20,364
1143818,4,0,4,60,24,3,87,207,24,318
1143819,0,0,0,55,15,3,73,149,3,225
1143820,0,0,0,83,22,7,112,149,21,282
1143821,3,0,3,84,21,4,109,182,12,303
1143822,0,0,0,33,22,0,55,120,18,193
1143823,3,0,3,34,15,6,55,109,9,173
1143824,3,0,3,73,18,0,91,192,9,292
1143825,3,0,3,65,26,0,91,217,24,332
1143826,3,0,3,56,9,0,65,203,19,287
1143827,0,0,0,104,30,3,137,243,42,422
1143828,0,0,0,52,17,0,69,195,38,302
1143829,0,0,0,6,12,0,18,77,3,98
1143830,0,0,0,67,25,4,96,203,43,342
1143831,3,0,3,62,17,0,79,180,18,277
1143832,0,0,0,0,0,0,0,7,0,7
1143833,3,0,3,54,21,0,75,167,24,266
1143834,3,0,3,88,27,6,121,311,34,466
1143835,0,0,0,53,10,10,73,100,38,211
1143836,6,3,9,75,23,0,98,219,15,332
1143837,0,0,0,101,30,8,139,211,16,366
1143838,0,0,0,0,0,0,0,0,0,0
1143839,0,3,3,43,21,0,64,115,41,220
1143840,3,0,3,44,8,0,52,160,40,252
1143841,0,0,0,68,14,0,82,102,62,246
1143842,6,0,6,74,42,3,119,326,40,485
1143843,0,0,0,41,18,4,63,94,9,166
1143844,0,0,0,57,16,0,73,141,12,226
1143845,0,0,0,44,15,3,62,112,50,224
1143846,0,0,0,59,18,0,77,114,11,202
1143847,0,0,0,70,18,0,88,133,21,242
1143848,0,0,0,70,12,3,85,130,70,285
1143849,0,0,0,27,21,0,48,92,44,184
1143850,4,0,4,53,14,0,67,162,11,240
1143851,3,0,3,95,29,0,124,303,28,455
1143852,0,0,0,23,12,6,41,67,34,142
1143853,3,0,3,49,16,3,68,162,23,253
1143854,6,0,6,0,0,0,0,16,0,16
1143855,0,0,0,95,18,0,113,221,24,358
1143856,0,0,0,90,25,3,118,263,30,411
1143857,0,0,0,40,10,3,53,113,12,178
1143858,0,0,0,30,6,4,40,114,15,169
1143901,0,0,0,0,0,0,0,0,0,0
1144001,0,0,0,32,6,0,38,139,6,183
1144002,0,0,0,47,15,0,62,177,25,264
1144003,0,0,0,0,0,0,0,20,5,25
1144004,3,0,3,136,33,5,174,377,28,579
1144005,0,0,0,76,32,0,108,165,10,283
1144006,0,0,0,0,0,0,0,0,0,0
1144007,0,0,0,22,10,0,32,124,13,169
1144008,7,0,7,45,27,0,72,230,19,321
1144009,0,0,0,84,15,6,105,189,16,310
1144010,4,0,4,52,26,0,78,199,12,289
1144011,3,0,3,67,27,0,94,264,25,383
1144012,6,3,9,59,30,0,89,220,18,327
1144013,6,3,9,110,23,10,143,294,22,459
1144014,0,3,3,76,27,3,106,264,26,396
1144015,0,3,3,24,8,0,32,104,21,157
1144016,6,3,9,60,23,0,83,312,44,439
1144017,0,3,3,83,19,3,105,222,15,342
1144018,10,3,13,60,11,0,71,254,31,356
1144019,0,0,0,37,33,3,73,130,24,227
1144020,9,6,15,72,39,0,111,305,42,458
1144021,9,0,9,71,20,0,91,216,13,320
1144022,0,0,0,65,33,0,98,185,16,299
1144023,3,0,3,62,36,3,101,238,30,369
1144024,0,0,0,6,0,0,6,18,0,24
1144025,4,0,4,64,24,0,88,234,9,331
1144026,3,0,3,75,28,4,107,312,28,447
1144027,3,0,3,55,19,9,83,152,6,241
1144028,7,0,7,48,17,0,65,210,24,299
1144029,3,0,3,68,34,3,105,214,7,326
1144030,0,3,3,55,17,0,72,164,27,263
1144031,4,0,4,65,33,0,98,197,23,318
1144032,12,0,12,50,31,0,81,499,32,612
1144033,0,0,0,60,20,3,83,174,17,274
1144034,4,0,4,41,24,12,77,176,3,256
1144035,3,0,3,60,19,0,79,160,21,260
1144036,0,4,4,90,44,9,143,332,27,502
1144037,5,0,5,97,40,5,142,317,40,499
1144038,6,0,6,51,15,0,66,174,12,252
1144039,4,0,4,77,15,3,95,178,21,294
1144040,3,0,3,75,19,3,97,193,21,311
1144041,4,0,4,36,16,6,58,111,0,169
1144042,0,0,0,37,29,0,66,153,29,248
1144043,4,0,4,52,9,0,61,125,18,204
1144044,3,0,3,70,26,0,96,207,27,330
1144101,0,0,0,74,62,3,139,247,53,439
1144102,3,0,3,81,27,0,108,173,3,284
1144103,0,0,0,59,33,3,95,203,12,310
1144104,22,0,22,48,31,3,82,253,18,353
1144105,0,0,0,48,27,3,78,133,3,214
1144106,3,0,3,58,31,0,89,203,19,311
1144107,0,0,0,68,34,3,105,287,24,416
1144108,9,4,17,86,25,6,117,315,31,463
1144109,0,0,3,66,27,0,93,163,16,272
1144110,3,4,7,70,22,6,98,171,30,299
1144111,6,3,9,98,41,0,139,331,44,514
1144112,6,3,9,88,28,3,119,243,36,398
1144113,3,0,3,48,40,0,88,161,6,255
1144114,3,0,3,136,24,0,160,281,43,484
1144115,3,0,3,62,18,0,80,191,10,281
1144116,0,3,3,56,21,0,77,152,21,250
1144117,6,0,6,75,33,6,114,239,35,388
1144118,0,0,0,68,37,14,119,210,15,344
1144119,6,0,6,56,32,3,91,230,24,345
1144120,5,0,5,78,33,0,111,233,11,355
1144121,6,6,12,125,44,4,173,549,70,792
1144122,0,0,0,64,19,11,94,230,17,341
1144123,5,0,5,57,14,0,71,230,26,327
1144124,4,0,4,46,17,4,67,127,24,218
1144125,3,4,7,71,26,3,100,230,15,345
1144126,3,0,3,64,21,3,88,175,13,276
1144127,0,0,0,57,29,6,92,230,30,352
1144128,0,0,0,85,44,7,136,267,6,409
1144129,3,0,3,91,52,3,146,252,17,415
1144130,0,0,0,54,29,0,83,140,9,232
1144131,3,0,3,41,28,6,75,176,10,261
1144132,0,3,3,64,37,6,107,241,12,360
1144133,6,0,6,91,45,12,148,264,31,443
1144134,3,0,3,55,31,3,89,163,17,269
1144135,0,0,0,72,61,3,136,288,24,448
1144136,3,0,3,59,38,6,103,207,25,335
1144201,0,0,0,61,11,0,72,188,27,287
1144202,0,0,0,270,47,6,323,511,22,856
1144203,0,0,0,0,0,0,0,0,0,0
1144204,0,3,3,57,18,3,78,166,51,295
1144205,4,0,4,66,24,3,93,253,53,399
1144206,6,0,6,57,16,0,73,195,16,284
1144207,0,3,3,59,11,0,70,162,12,244
1144208,19,227,246,0,0,0,0,36,411,447
1144209,0,0,0,29,7,6,42,141,12,195
1144210,0,3,3,56,15,3,74,189,24,287
1144211,4,0,4,52,18,0,70,221,13,304
1144212,3,0,3,49,13,0,62,185,38,285
1144213,4,0,4,77,11,0,88,222,18,328
1144214,0,0,0,45,24,3,72,162,16,250
1144215,0,3,3,43,24,3,70,173,12,255
1144216,4,0,4,87,19,3,109,262,14,385
1144217,0,6,6,43,18,3,64,161,18,243
1144218,0,0,0,43,11,0,54,155,6,215
1144219,3,0,3,67,27,3,97,190,35,322
1144220,0,0,0,86,15,9,110,225,9,344
1144221,0,0,0,41,12,0,53,163,6,222
1144222,0,3,3,76,27,3,106,256,28,390
1144223,4,0,4,91,24,3,118,280,31,429
1144224,5,0,5,82,26,0,108,265,22,395
1144225,6,0,6,64,9,3,76,209,26,311
1144226,3,0,3,66,25,0,91,182,18,291
1144227,0,0,0,52,18,0,70,181,18,269
1144228,0,0,0,109,16,0,125,198,9,332
1144229,3,0,3,54,26,0,80,205,28,313
1144230,0,0,0,40,12,0,52,139,53,244
1144231,3,0,3,68,37,0,105,200,46,351
1144232,0,0,0,57,16,6,79,202,40,321
1144233,0,0,0,0,0,0,0,0,0,0
1144234,0,0,0,43,28,3,74,191,9,274
1144235,0,0,0,82,41,0,123,269,25,417
1144236,3,0,3,71,31,0,102,220,34,356
1144237,0,0,0,62,15,0,77,183,19,279
1144238,0,0,0,54,20,0,74,141,7,222
1144239,0,0,0,80,21,0,101,228,28,357
1144240,0,0,0,37,10,0,47,168,11,226
1144241,0,3,3,63,26,3,92,214,24,330
1144242,0,0,0,45,6,0,51,124,10,185
1144243,3,0,3,81,16,0,97,179,13,289
1144244,4,0,4,71,18,0,89,231,26,346
1144245,3,0,3,76,25,3,104,211,33,348
1144246,0,0,0,55,10,0,65,231,23,319
1144247,0,0,0,60,30,7,97,197,24,318
1144248,6,3,9,99,24,0,123,245,25,393
1144249,0,0,3,70,14,4,88,190,20,298
1144250,0,0,0,89,28,0,117,253,38,408
1144251,0,0,0,27,27,4,58,103,12,173
1144252,3,3,6,94,26,0,120,284,48,452
1144253,0,0,0,61,19,0,80,221,43,344
1144301,0,0,0,54,18,0,72,213,9,294
1144302,0,0,0,52,15,3,70,143,3,216
1144303,0,0,0,38,29,5,72,160,15,247
1144304,0,0,0,57,18,3,78,123,9,210
1144305,0,0,0,66,29,0,95,159,6,260
1144306,0,0,0,81,19,0,100,292,18,410
1144307,3,0,3,73,29,6,108,166,6,280
1144308,0,0,0,37,18,6,61,173,16,250
1144309,0,3,3,64,44,0,108,328,18,454
1144310,3,0,3,87,38,6,131,258,9,398
1144311,0,0,0,85,18,3,106,187,22,315
1144312,0,0,0,0,0,0,0,0,0,0
1144313,0,0,0,0,0,0,0,26,3,29
1144314,0,0,0,55,28,6,89,172,18,279
1144315,0,0,0,50,29,0,79,219,0,298
1144316,0,0,0,56,4,3,63,157,28,248
1144317,3,0,3,71,35,3,109,150,21,280
1144318,0,0,0,90,22,0,112,275,5,392
1144319,0,0,0,36,12,0,48,87,24,159
1144320,0,0,0,12,3,0,15,29,3,47
1144321,0,0,0,47,11,0,58,178,34,270
1144322,0,0,0,72,12,6,90,175,3,268
1144323,0,0,0,52,25,3,80,157,18,255
1144324,0,0,0,68,17,0,85,218,26,329
1144325,0,0,0,54,15,5,74,120,0,194
1144326,0,0,0,0,0,0,0,12,0,12
1144327,0,0,0,83,23,0,106,185,21,312
1144328,0,0,0,3,0,0,3,15,9,27
1144329,3,0,3,43,20,0,63,169,17,249
1144330,0,4,4,84,25,0,109,245,39,393
1144331,0,0,0,64,25,3,92,241,28,361
1144332,0,0,0,55,18,0,73,143,9,225
1144333,3,0,3,71,32,4,107,184,14,305
1144334,3,0,3,60,28,0,88,250,30,368
1144335,0,0,0,79,24,0,103,230,31,364
1144336,0,0,0,83,16,4,103,240,63,406
1144337,0,0,0,118,21,3,142,276,65,483
1144338,30,21,51,73,25,6,104,268,60,432
1144339,3,0,3,87,27,3,117,211,24,352
1144340,3,0,3,130,14,0,144,344,45,533
1144341,0,0,0,97,18,0,115,223,10,348
1144342,0,0,0,0,0,0,0,0,0,0
1144343,0,0,0,57,12,0,69,120,29,218
1144344,3,0,3,73,20,4,97,220,50,367
1144345,0,0,0,24,17,0,41,144,25,210
1144346,0,0,0,53,24,0,77,208,17,302
1144347,0,3,3,84,22,0,106,201,26,333
1144348,6,0,6,62,15,3,80,153,30,263
1144349,3,0,3,67,19,0,86,150,22,258
1144350,3,0,3,25,20,3,48,117,13,178
1144401,3,0,3,29,11,0,40,104,31,175
1144402,0,0,0,11,12,3,26,92,37,155
1144403,0,0,0,30,21,3,54,88,11,153
1144404,0,0,0,59,22,3,84,147,74,305
1144405,0,4,4,30,22,0,52,87,36,175
1144406,0,0,0,66,26,4,96,188,72,356
1144407,6,0,6,85,19,6,110,258,43,411
1144408,0,0,0,66,32,0,98,198,19,315
1144409,74,4,78,22,33,0,55,254,13,322
1144410,3,0,3,47,39,0,86,241,37,364
1144411,0,0,0,55,5,3,63,168,18,249
1144412,0,0,0,89,33,0,122,245,37,404
1144413,0,0,0,73,28,3,104,240,18,362
1144414,0,0,0,59,17,0,76,163,6,245
1144415,6,0,6,62,34,6,102,245,12,359
1144416,0,0,0,59,34,8,101,212,15,328
1144417,3,3,6,103,52,0,155,367,12,534
1144418,4,0,4,56,12,0,68,121,3,192
1144419,3,0,3,31,15,3,49,141,3,193
1144420,3,0,3,73,46,3,122,209,32,363
1144421,0,0,0,50,9,0,59,132,9,200
1144422,0,0,0,84,15,0,99,92,10,201
1144423,3,0,3,75,25,7,107,279,43,429
1144424,0,0,0,43,12,0,55,99,45,199
1144425,6,3,9,107,27,0,134,231,59,424
1144426,0,0,0,69,30,0,99,199,37,335
1144427,8,0,8,34,26,0,60,124,17,201
1144428,3,0,3,44,26,0,70,219,18,307
1144429,3,0,3,30,26,0,56,157,22,235
1144430,0,0,0,80,15,3,98,158,12,268
1144431,3,0,3,41,6,3,50,101,33,184
1144432,0,0,0,109,31,6,146,258,21,425
1144433,0,0,0,76,24,6,106,211,23,340
1144434,0,0,0,60,29,3,92,213,22,327
1144435,3,0,3,41,23,0,64,208,4,276
1144436,0,0,0,62,21,3,86,173,22,281
1144437,3,0,3,63,32,0,95,205,45,345
1144438,0,0,0,37,19,0,56,115,19,190
1144439,0,0,0,56,19,4,79,189,33,301
1144440,0,0,0,43,26,0,69,142,10,221
1144441,6,0,6,53,23,6,82,211,45,338
1144442,0,0,0,51,22,0,73,125,39,237
1144443,0,0,0,26,0,0,26,66,21,113
1144444,0,0,0,32,20,3,55,151,13,219
1144445,0,0,0,40,24,0,64,168,12,244
1144446,4,0,4,62,28,4,94,141,12,247
1144447,0,0,0,99,30,6,135,266,26,427
1144448,0,0,0,48,16,0,64,123,18,205
1144449,0,0,0,75,22,0,97,133,24,254
1144450,3,0,3,48,16,0,64,153,13,230
1144451,0,0,0,47,10,0,57,92,4,153
1144452,0,0,0,69,21,0,90,224,24,338
1144453,0,0,3,44,29,3,76,135,20,231
1144454,0,0,0,73,23,6,102,226,19,347
1144455,0,0,0,40,11,3,54,124,24,202
1144456,0,3,3,73,25,4,102,180,7,289
1144501,0,0,0,38,22,3,63,122,18,203
1144502,11,3,14,19,17,0,36,171,18,225
1144503,0,0,0,134,35,7,176,285,32,493
1144504,6,0,6,45,17,4,66,168,7,241
1144505,3,0,3,81,11,6,98,156,3,257
1144506,6,3,9,111,49,0,160,294,33,487
1144507,3,0,3,38,19,6,63,117,6,186
1144508,0,0,0,28,14,3,45,61,12,118
1144509,0,0,0,34,19,0,53,117,3,173
1144510,0,0,0,93,13,9,115,159,11,285
1144511,4,0,4,78,29,0,107,151,22,280
1144512,0,0,4,110,37,9,156,257,30,443
1144513,0,0,0,46,29,4,79,137,20,236
1144514,0,0,0,60,13,0,73,131,22,226
1144515,6,0,6,59,20,0,79,180,16,275
1144601,3,0,3,73,42,0,115,275,18,408
1144602,0,0,0,52,21,0,73,196,13,282
1144603,6,0,6,72,23,6,101,152,20,273
1144604,3,0,3,82,43,5,130,223,20,373
1144605,3,0,3,65,19,6,90,180,9,279
1144606,4,0,4,135,45,9,189,217,28,434
1144607,0,0,0,52,12,8,72,103,14,189
1144608,0,0,0,65,17,0,82,145,9,236
1144609,38,0,38,77,37,0,114,297,15,426
1144610,3,0,3,34,24,0,58,143,6,207
1144611,3,0,3,61,14,0,75,89,15,179
1144612,3,0,3,63,34,8,105,247,28,380
1144613,0,0,0,35,17,0,52,147,9,208
1144614,0,0,0,132,24,3,159,205,15,379
1144615,0,0,0,80,36,5,121,184,16,321
1144616,0,0,0,42,20,0,62,121,6,189
1144617,3,0,3,62,30,0,92,150,21,263
1144618,0,0,0,36,10,3,49,119,6,174
1144619,6,0,6,61,19,0,80,207,18,305
1144701,6,0,6,43,18,0,61,154,3,218
1144702,3,0,3,19,21,0,40,129,9,178
1144703,3,3,6,44,15,9,68,127,39,234
1144704,0,0,0,71,20,3,94,118,9,221
1144705,0,0,0,120,28,6,154,207,11,372
1144706,0,3,3,44,13,0,57,136,12,205
1144707,0,0,0,101,39,3,143,219,29,391
1144708,6,3,9,45,24,0,69,138,18,225
1144709,0,0,0,72,28,3,103,132,7,242
1144710,0,0,0,40,10,3,53,82,9,144
1144711,0,0,0,31,9,0,40,158,24,222
1144712,33,18,51,39,16,3,58,171,49,278
1144713,40,0,40,59,25,5,89,276,30,395
1144714,4,0,4,75,26,6,107,198,18,323
1144715,0,0,0,108,31,3,142,176,22,340
1144716,0,0,0,17,5,0,22,44,9,75
1144717,0,0,0,62,12,7,81,100,9,190
1144718,3,0,3,42,24,0,66,171,16,253
1144719,0,0,0,47,16,0,63,150,8,221
1144720,6,0,6,75,18,0,93,196,28,317
1144721,6,0,6,64,19,4,87,184,23,294
1144722,0,3,3,85,39,12,136,217,28,381
1144723,3,0,3,97,30,5,132,258,16,406
1144724,0,0,0,75,17,0,92,128,17,237
1144725,6,0,6,37,24,3,64,139,18,221
1144726,5,0,5,102,32,6,140,224,31,395
1144727,3,0,3,46,17,4,67,159,40,266
1144728,3,0,3,59,30,0,89,194,32,315
1144729,10,5,15,91,30,0,121,231,30,382
1144730,0,6,6,107,62,6,175,302,23,500
1144731,3,3,6,61,30,3,94,178,26,298
1144732,0,0,0,0,0,0,0,0,0,0
1144733,3,0,3,82,17,0,99,157,18,274
1144734,0,0,0,66,18,8,92,165,24,281
1144735,3,0,3,92,17,0,109,153,24,286
1144736,6,0,6,52,23,0,75,198,3,276
1144737,0,5,5,128,38,3,169,301,18,488
1144738,5,3,8,67,18,3,88,241,28,357
1144739,3,0,3,69,24,0,93,186,14,293
1144740,6,3,9,69,26,3,98,156,21,275
1144741,0,0,0,60,15,5,80,178,22,280
1144742,3,0,3,64,17,0,81,126,3,210
1144743,0,0,0,26,14,0,40,53,0,93
1144801,3,0,3,69,15,4,88,130,20,238
1144802,3,0,3,76,29,4,109,125,3,237
1144803,3,0,3,61,9,0,70,133,4,207
1144804,0,0,0,33,18,0,51,130,3,184
1144805,3,3,6,75,57,0,132,279,39,450
1144806,3,0,3,37,9,3,49,129,3,181
1144807,6,0,6,29,23,0,52,157,19,228
1144808,3,0,3,45,24,0,69,115,4,188
1144809,3,0,3,73,26,3,102,178,12,292
1144810,3,0,3,84,33,0,117,225,30,372
1144811,6,0,6,104,49,9,162,307,21,490
1144812,0,0,0,37,12,0,49,73,6,128
1144813,3,3,6,41,28,0,69,209,25,303
1144814,4,0,4,82,45,0,127,297,27,451
1144815,4,0,4,46,19,0,65,109,15,189
1144816,0,0,0,53,28,4,85,160,6,251
1144817,3,0,3,61,28,6,95,144,6,245
1144818,6,3,9,60,31,0,91,178,25,294
1144819,6,0,6,58,17,3,78,232,30,340
1144820,0,0,0,71,6,0,77,161,13,251
1144821,0,0,0,75,16,12,103,141,16,260
1144822,3,0,3,67,26,9,102,165,34,301
1144823,6,0,6,73,16,3,92,184,34,310
1144824,0,0,0,78,20,3,101,123,9,233
1144901,0,0,0,37,24,3,64,143,70,277
1144902,7,0,7,44,19,9,72,202,77,351
1144903,0,0,0,30,15,6,51,109,134,294
1144904,12,3,15,39,23,3,65,257,54,376
1144905,6,3,9,56,34,3,93,213,15,321
1144906,8,0,8,29,11,3,43,203,10,256
1144907,4,0,4,69,37,6,112,250,38,400
1144908,0,0,0,9,3,0,12,36,6,54
1144909,4,3,7,53,24,3,80,186,25,291
1144910,6,3,9,66,30,9,105,258,29,392
1144911,6,0,6,38,10,6,54,114,5,173
1144912,4,4,8,68,31,10,109,223,14,346
1144913,4,3,7,60,16,16,92,265,15,372
1144914,0,0,0,39,15,6,60,113,22,195
1144915,12,0,12,70,21,6,97,245,78,420
1145001,0,0,0,37,18,3,58,115,0,173
1145002,0,0,0,36,17,0,53,86,7,146
1145003,6,0,6,70,19,7,96,167,17,280
1145004,0,0,0,43,17,10,70,119,9,198
1145005,4,0,4,87,43,6,136,231,9,376
1145006,3,0,3,23,29,6,58,88,3,149
1145007,6,3,9,46,18,0,64,154,12,230
1145008,3,3,6,60,23,5,88,176,15,279
1145009,6,0,6,112,27,3,142,231,12,385
1145010,8,0,8,73,38,0,111,262,7,380
1145011,3,0,3,70,25,3,98,143,12,253
1145012,5,0,5,100,47,3,150,256,21,427
1145013,4,0,4,51,19,0,70,92,7,169
1145014,0,0,0,50,21,4,75,86,3,164
1145015,6,0,6,60,32,3,95,193,6,294
1145016,0,0,0,71,33,4,108,226,26,360
1145017,0,0,0,71,32,15,118,182,10,310
1145018,0,3,3,86,11,3,100,159,6,265
1145019,6,0,6,80,39,13,132,262,9,403
1145020,7,0,7,60,22,6,88,138,16,242
1145021,0,0,0,3,0,0,3,12,3,18
1145022,3,0,3,66,45,6,117,175,15,307
1145023,11,0,11,86,55,3,144,279,13,436
1145024,7,0,7,70,29,15,114,227,18,359
1145025,10,0,10,70,43,5,118,272,6,396
1145026,3,0,3,43,20,4,67,159,6,232
1145027,7,3,10,122,57,4,183,286,16,485
1145028,5,0,5,42,46,9,97,135,6,238
1145029,0,0,0,119,33,5,157,186,3,346
1145030,5,0,5,83,50,3,136,212,10,358
1145031,5,3,8,87,23,12,122,190,18,330
1145032,3,0,3,61,23,3,87,131,4,222
1145033,6,0,6,102,48,9,159,272,13,444
1145034,3,0,3,47,31,9,87,190,18,295
1145035,0,0,0,0,3,0,3,0,0,3
1145036,6,0,6,62,36,7,105,180,9,294
1145037,0,0,0,107,32,0,139,244,14,397
1145038,11,0,11,110,24,6,140,254,9,403
1145039,0,0,0,0,0,0,0,0,0,0
1145040,7,0,7,60,33,0,93,143,10,246
1145041,4,0,4,95,61,4,160,326,26,512
1145042,3,0,3,65,25,9,99,172,3,274
1145043,6,0,6,48,22,0,70,160,4,234
1145044,0,0,0,85,29,6,120,225,9,354
1145045,6,0,6,67,38,10,115,218,0,333
1145046,6,6,12,57,32,6,95,192,21,308
1145047,3,0,3,67,30,6,103,145,7,255
1145048,9,0,9,78,44,8,130,260,14,404
1145049,0,4,4,54,31,8,93,173,27,293
1145050,8,0,8,36,23,0,59,104,0,163
1145051,0,0,0,28,24,6,58,163,16,237
1145101,0,0,0,9,0,0,9,7,0,16
1145201,6,0,9,30,26,3,59,161,17,237
1145202,3,0,3,84,21,8,113,234,26,373
1145203,0,0,0,51,26,7,84,166,15,265
1145204,3,0,3,55,19,12,86,146,18,250
1145205,7,0,7,60,21,5,86,223,21,330
1145206,4,0,4,26,14,0,40,150,36,226
1145207,4,0,4,71,27,3,101,215,23,339
1145208,18,0,18,76,16,3,95,192,20,307
1145209,3,5,8,43,15,0,58,132,31,221
1145210,0,0,0,50,24,0,74,165,18,257
1145211,10,0,10,42,16,3,61,213,58,332
1145212,8,3,14,70,32,9,111,307,48,466
1145213,3,3,6,69,27,0,96,216,31,343
1145214,3,0,3,30,8,5,43,127,29,199
1145215,0,0,0,0,3,0,3,18,0,21
1145216,6,0,6,56,32,4,92,185,27,304
1145217,11,0,11,54,18,0,72,195,28,295
1145218,6,3,9,46,25,0,71,173,79,323
1145219,4,5,9,57,23,8,88,177,47,312
1145220,3,3,6,42,14,0,56,144,28,228
1145221,0,0,0,38,18,6,62,133,26,221
1145222,0,0,0,0,0,0,0,15,4,19
1145223,4,8,12,100,36,13,149,323,59,531
1145224,54,42,96,45,25,3,73,314,101,488
1145225,31,0,31,34,22,6,62,200,22,284
1145226,6,0,6,26,12,0,38,152,30,220
1145227,6,8,14,35,20,0,55,165,64,284
1145228,13,3,16,49,28,0,77,406,41,524
1145229,11,0,11,33,14,3,50,144,4,198
1145230,8,0,8,42,16,0,58,316,17,391
1145231,8,0,8,55,29,4,88,213,33,334
1145232,0,3,3,78,38,4,120,277,37,434
1145233,3,0,3,83,24,9,116,166,21,303
1145234,3,0,3,51,12,0,63,121,16,200
1145235,3,0,3,37,16,3,56,116,0,172
1145236,7,3,10,50,24,0,74,177,45,296
1145237,31,0,31,11,5,0,16,219,33,268
1145301,0,0,0,0,0,0,0,9,0,9
1145302,6,0,6,82,38,6,126,195,3,324
1145303,7,0,7,75,29,3,107,161,13,281
1145304,0,0,0,39,19,4,62,158,10,230
1145305,0,0,0,96,44,14,154,267,28,449
1145306,6,3,9,75,47,5,127,312,36,475
1145307,12,0,12,103,50,7,160,295,24,479
1145308,3,0,3,56,11,0,67,140,6,213
1145309,8,3,11,87,18,6,111,177,23,311
1145310,3,0,3,96,20,8,124,256,28,408
1145311,3,3,6,102,26,5,133,249,25,407
1145312,4,0,4,91,19,3,113,239,20,372
1145313,0,0,0,55,21,7,83,145,9,237
1145314,0,0,0,49,15,3,67,145,4,216
1145315,3,0,3,55,24,0,79,141,15,235
1145316,5,0,5,90,32,8,130,257,21,408
1145317,0,0,0,6,0,0,6,3,0,9
1145318,9,0,9,91,45,3,139,258,39,436
1145319,0,0,0,95,20,3,118,155,4,277
1145320,5,0,5,92,31,8,131,170,12,313
1145321,3,0,3,108,39,7,154,319,19,492
1145322,3,0,3,52,15,0,67,151,0,218
1145323,3,3,6,38,18,4,60,168,40,268
1145324,3,0,3,92,26,12,130,224,25,379
1145325,0,0,0,56,17,0,73,119,4,196
1145326,3,0,3,94,26,10,130,219,22,371
1145327,3,0,3,110,37,7,154,249,22,425
1145328,0,0,0,66,21,4,91,125,6,222
1145401,3,0,3,83,36,9,128,231,3,362
1145402,3,0,3,93,32,7,132,216,18,366
1145403,0,0,0,64,32,0,96,151,10,257
1145404,3,0,3,94,46,9,149,269,8,426
1145405,6,0,6,123,41,9,173,250,15,438
1145406,0,0,0,106,29,6,141,182,0,323
1145407,0,0,0,107,48,8,163,250,19,432
1145408,0,0,0,59,26,4,89,193,9,291
1145409,0,0,0,110,38,5,153,254,11,418
1145410,0,0,3,45,39,3,87,172,15,274
1145411,5,0,5,100,36,9,145,234,18,397
1145412,9,0,9,108,33,5,146,221,15,382
1145413,0,0,0,61,28,9,98,151,14,263
1145414,5,0,5,52,21,3,76,179,4,259
1145415,13,4,17,63,28,0,91,227,34,352
1145416,7,0,7,71,38,6,115,160,9,284
1145417,3,0,3,65,33,0,98,194,0,292
1145418,7,0,7,86,32,4,122,251,9,382
1145419,13,0,13,73,40,7,120,226,9,355
1145420,8,0,8,46,36,9,91,193,15,299
1145421,8,0,8,53,45,10,108,252,13,373
1145422,0,0,0,80,39,7,126,244,15,385
1145423,14,6,20,82,39,10,131,251,23,405
1145424,10,3,13,100,43,11,154,250,18,422
1145425,6,0,6,46,29,0,75,135,16,226
1145426,5,0,5,75,30,3,108,183,12,303
1145427,33,52,85,50,25,6,81,232,90,403
1145428,6,0,6,60,31,6,97,179,6,282
1145429,0,0,0,47,19,6,72,176,9,257
1145430,3,3,6,94,45,8,147,257,18,422
1145431,6,0,6,86,25,6,117,163,3,283
1145432,6,0,9,79,50,0,129,243,12,384
1145433,0,0,0,117,61,7,185,306,13,504
1145434,121,19,140,14,19,3,36,299,41,376
1145435,3,3,6,89,41,8,138,186,29,353
1145436,3,4,7,63,29,4,96,203,8,307
1145437,3,0,6,99,35,6,140,307,10,457
1145438,0,0,0,56,24,3,83,189,0,272
1145439,0,0,0,54,26,0,80,140,3,223
1145440,0,0,0,95,36,6,137,209,9,355
1145441,8,3,11,72,25,4,101,158,6,265
1145442,3,0,3,53,36,3,92,203,0,295
1145443,8,0,8,43,31,0,74,133,8,215
1145444,3,3,6,74,34,4,112,185,18,315
1145445,4,0,4,86,27,0,113,266,6,385
1145446,4,0,4,67,46,9,122,272,6,400
1145447,6,6,12,111,61,7,179,292,27,498
1145448,3,0,3,77,20,3,100,148,6,254
1145449,7,0,7,53,26,6,85,141,6,232
1145450,6,0,6,88,37,4,129,202,12,343
1145451,72,14,86,33,16,5,54,230,31,315
1145501,6,6,12,64,34,9,107,205,81,393
1145502,5,0,5,31,17,3,51,140,25,216
1145503,4,0,4,77,32,13,122,247,18,387
1145504,3,0,3,52,28,3,83,172,10,265
1145505,4,0,4,79,23,0,102,177,24,303
1145506,14,4,18,82,32,3,117,346,61,524
1145507,12,0,12,59,24,0,83,273,19,375
1145508,11,6,17,43,40,3,86,304,41,431
1145509,3,3,6,48,15,0,63,189,12,264
1145510,60,3,63,35,9,0,44,201,12,257
1145511,0,0,0,51,28,3,82,186,21,289
1145512,3,0,3,60,26,0,86,159,15,260
1145513,8,0,8,59,27,6,92,180,28,300
1145514,0,0,0,61,23,0,84,187,14,285
1145515,5,3,8,57,21,0,78,202,63,343
1145601,0,0,0,0,0,0,0,6,0,6
1145701,0,0,0,53,15,0,68,166,7,241
1145702,0,0,0,77,15,6,98,269,18,385
1145703,4,0,4,89,39,3,131,176,19,326
1145704,6,4,10,80,50,0,130,207,34,371
1145705,3,0,3,67,25,9,101,173,15,289
1145706,3,0,6,39,18,3,60,86,18,164
1145707,0,0,0,47,15,0,62,154,10,226
1145708,6,0,6,50,18,3,71,116,15,202
1145709,6,0,6,48,33,3,84,191,16,291
1145710,0,0,0,56,28,3,87,141,15,243
1145711,3,3,6,85,47,7,139,231,16,386
1145712,0,0,0,101,57,3,161,290,17,468
1145713,3,3,6,85,33,4,122,232,18,372
1145714,0,0,0,45,22,0,67,104,4,175
1145715,0,0,0,122,40,3,165,250,27,442
1145716,3,0,3,62,25,0,87,168,15,270
1145717,3,4,7,84,33,9,126,228,48,402
1145718,8,3,11,74,36,7,117,265,46,428
1145719,0,0,0,39,17,6,62,133,18,213
1145720,6,0,6,42,48,0,90,208,11,309
1145721,7,0,7,95,60,6,161,254,30,445
1145722,0,0,0,51,17,0,68,130,19,217
1145723,3,0,3,91,16,4,111,184,7,302
1145724,3,0,3,63,40,0,103,154,18,275
1145725,0,0,0,75,41,3,119,134,21,274
1145726,5,0,5,42,23,0,65,109,3,177
1145727,3,0,3,47,17,6,70,140,6,216
1145728,6,0,6,44,34,0,78,125,7,210
1145729,0,0,0,66,27,3,96,159,9,264
1145730,0,0,0,61,22,8,91,170,12,273
1145731,3,0,3,55,14,0,69,94,10,173
1145732,0,0,0,78,22,6,106,244,21,371
1145733,0,0,0,70,34,6,110,188,9,307
1145734,6,0,6,78,49,9,136,212,28,376
1145735,0,0,0,34,19,0,53,107,15,175
1145736,3,0,3,46,24,0,70,118,6,194
1145737,3,0,3,66,43,7,116,247,19,382
1145738,3,3,6,58,22,4,84,218,6,308
1145739,4,0,4,45,19,4,68,149,27,244
1145740,6,0,6,91,48,3,142,239,19,400
1145741,3,0,3,56,20,3,79,132,12,223
1145801,0,0,0,75,32,12,119,203,18,340
1145802,3,0,3,69,29,0,98,168,12,278
1145803,3,0,3,64,27,0,91,135,9,235
1145804,3,0,3,53,9,0,62,120,19,201
1145805,0,0,0,52,22,3,77,134,6,217
1145806,0,0,3,62,15,3,80,189,7,276
1145807,3,0,3,101,17,7,125,173,17,315
1145808,0,0,0,91,27,12,130,221,15,366
1145809,0,0,0,51,14,0,65,219,17,301
1145810,3,0,3,64,30,3,97,217,31,345
1145811,4,0,4,44,16,6,66,189,21,276
1145812,3,0,3,54,32,0,86,213,38,337
1145813,0,0,0,135,23,7,165,206,32,403
1145814,0,0,0,113,28,6,147,158,3,308
1145815,0,0,0,96,7,4,107,105,6,218
1145816,0,0,0,52,14,4,70,182,31,283
1145817,0,0,0,55,18,0,73,134,17,224
1145818,0,0,0,54,21,9,84,113,18,215
1145819,0,0,0,70,28,0,98,166,19,283
1145820,0,0,0,116,23,3,142,201,9,352
1145821,0,0,0,45,19,3,67,145,8,220
1145822,5,0,5,71,40,0,111,294,12,417
1145823,3,0,3,41,13,0,54,158,16,228
1145824,0,0,0,40,10,0,50,130,11,191
1145825,0,0,0,0,0,0,0,8,0,8
1145826,3,0,3,84,19,6,109,202,34,345
1145827,0,0,0,28,21,0,49,99,9,157
1145828,6,0,6,77,30,0,107,148,12,267
1145829,0,0,0,91,34,9,134,140,4,278
1145830,4,0,4,119,17,0,136,177,4,317
1145831,3,0,3,78,25,10,113,190,3,306
1145832,5,0,5,58,6,0,64,152,12,228
1145833,0,0,0,50,21,3,74,121,52,247
1145834,0,0,0,30,12,6,48,120,12,180
1145835,3,0,3,59,32,9,100,155,0,255
1145836,0,0,0,42,10,3,55,86,12,153
1145837,0,0,0,94,35,0,129,244,13,386
1145838,3,0,3,86,47,3,136,221,26,383
1145839,3,0,3,39,16,0,55,133,11,199
1145840,0,0,0,51,21,0,72,158,15,245
1145841,0,0,0,92,22,9,123,208,12,343
1145842,0,0,3,115,26,6,147,218,19,384
1145843,0,0,0,73,29,4,106,205,40,351
1145844,0,3,3,64,10,9,83,133,21,237
1145845,0,0,0,42,13,0,55,157,15,227
1145846,0,0,0,83,34,0,117,200,12,329
1145847,0,4,4,60,17,4,81,65,13,159
1145848,0,0,0,0,0,0,0,0,0,0
1145849,3,0,3,83,25,4,112,163,22,297
1145901,10,0,10,55,31,3,89,177,16,282
1145902,0,0,0,101,57,3,161,278,43,482
1145903,0,0,0,47,35,3,85,137,12,234
1145904,6,3,9,84,46,4,134,200,18,352
1145905,95,5,100,58,39,4,101,331,12,444
1145906,4,0,4,96,58,6,160,258,17,435
1145907,0,0,0,70,35,0,105,181,24,310
1145908,0,0,4,57,25,0,82,123,9,214
1145909,0,5,5,78,33,3,114,190,23,327
1145910,6,0,6,89,49,3,141,267,23,431
1145911,0,0,0,43,20,0,63,133,12,208
1145912,6,3,9,60,34,6,100,213,24,337
1145913,0,4,4,106,57,6,169,280,19,468
1145914,0,0,0,59,28,9,96,117,9,222
1145915,0,3,3,101,41,3,145,299,21,465
1145916,0,0,0,53,15,3,71,105,10,186
1145917,0,0,3,95,16,6,117,239,15,371
1145918,3,0,3,59,33,12,104,208,13,325
1145919,0,0,0,35,19,3,57,100,13,170
1145920,4,0,4,42,34,3,79,164,11,254
1145921,0,0,0,50,27,0,77,128,15,220
1145922,0,0,0,72,39,9,120,179,18,317
1145923,6,0,6,73,40,0,113,174,20,307
1145924,3,0,3,69,22,10,101,165,6,272
1145925,0,0,0,75,29,7,111,182,10,303
1145926,0,0,0,62,27,0,89,181,12,282
1145927,3,0,3,94,33,12,139,204,5,348
1145928,6,6,12,107,25,0,132,305,42,479
1145929,0,0,0,68,41,3,112,231,15,358
1145930,0,5,5,71,33,4,108,139,13,260
1145931,3,0,3,86,39,3,128,174,23,325
1145932,0,0,0,6,10,0,16,128,186,330
1145933,0,0,0,130,28,10,168,222,21,411
1145934,0,0,0,79,30,3,112,191,16,319
1146001,0,0,0,61,17,0,78,166,9,253
1146002,0,0,0,71,39,3,113,199,9,321
1146003,0,0,0,56,20,0,76,183,6,265
1146004,0,0,0,69,3,4,76,92,3,171
1146005,0,0,0,133,13,6,152,142,9,303
1146006,0,0,0,50,12,0,62,90,12,164
1146007,3,0,3,45,16,3,64,159,6,229
1146008,0,0,0,89,24,7,120,217,12,349
1146009,0,0,0,83,24,3,110,145,9,264
1146010,3,0,3,115,18,4,137,179,18,334
1146011,0,0,0,84,16,3,103,130,9,242
1146012,3,0,3,141,41,4,186,268,6,460
1146013,0,0,0,106,18,3,127,152,15,294
1146014,0,0,0,146,25,4,175,208,21,404
1146015,3,0,3,133,19,6,158,257,19,434
1146016,0,0,0,131,24,7,162,232,19,413
1146017,0,0,0,0,0,0,0,0,0,0
1146018,0,0,0,113,36,6,155,232,15,402
1146019,0,3,3,111,30,0,141,302,39,482
1146020,3,0,3,73,26,7,106,185,6,297
1146021,4,0,4,85,40,6,131,246,38,415
1146022,11,0,11,108,31,4,143,193,24,360
1146023,0,0,0,96,16,0,112,143,9,264
1146024,0,0,0,107,43,4,154,282,7,443
1146025,0,0,0,39,20,0,59,136,15,210
1146026,0,0,0,108,21,5,134,166,12,312
1146027,3,0,3,120,32,15,167,236,5,408
1146028,3,0,3,111,18,6,135,198,13,346
1146029,3,0,3,86,20,3,109,173,10,292
1146030,4,0,4,54,17,3,74,153,12,239
1146031,6,0,6,120,47,8,175,206,25,406
1146032,0,0,0,55,13,0,68,109,3,180
1146033,3,0,3,82,20,0,102,152,6,260
1146034,0,0,0,95,16,3,114,204,6,324
1146035,3,0,3,159,37,8,204,203,19,426
1146036,6,4,10,98,26,3,127,224,12,363
1146037,0,0,0,73,15,0,88,78,4,170
1146038,0,0,0,81,28,0,109,113,7,229
1146039,0,0,0,78,16,10,104,148,3,255
1146040,0,0,0,76,16,3,95,140,9,244
1146041,3,0,3,93,23,4,120,183,20,323
1146042,3,0,3,127,26,7,160,205,33,398
1146043,3,0,3,136,38,3,177,316,15,508
1146044,3,4,7,96,29,7,132,250,28,410
1146045,3,0,3,103,25,0,128,178,16,322
1146046,0,0,0,50,16,6,72,98,9,179
1146047,3,0,3,145,32,9,186,229,15,430
1146048,0,0,0,122,10,5,137,202,11,350
1146049,0,0,0,96,21,0,117,139,23,279
1146101,0,0,0,46,30,0,76,168,10,254
1146102,0,0,0,44,18,3,65,171,11,247
1146103,5,0,5,109,39,6,154,235,51,440
1146104,0,0,0,52,29,6,87,131,3,221
1146105,0,0,0,73,20,3,96,160,26,282
1146106,3,0,3,116,65,9,190,272,42,504
1146107,3,0,3,60,24,0,84,155,12,251
1146108,6,0,6,63,28,0,91,118,7,216
1146109,6,0,6,57,56,0,113,232,7,352
1146110,8,0,8,74,42,12,128,210,34,372
1146111,0,0,0,49,26,6,81,133,63,277
1146112,3,0,3,99,42,4,145,237,23,405
1146113,7,6,13,47,33,3,83,185,18,286
1146114,0,0,0,44,40,0,84,173,9,266
1146115,0,0,0,61,32,0,93,171,14,278
1146116,3,0,6,71,39,0,110,243,9,362
1146117,4,0,4,104,56,0,160,312,27,499
1146118,3,0,3,94,49,0,143,198,8,349
1146119,6,0,6,78,57,0,135,254,12,401
1146120,9,0,9,106,80,3,189,305,29,523
1146121,3,3,6,101,53,0,154,268,28,450
1146122,0,0,0,23,15,0,38,115,0,153
1146123,3,0,3,65,27,0,92,140,8,240
1146124,0,0,0,51,25,6,82,151,14,247
1146125,3,0,3,50,27,6,83,145,15,243
1146126,0,0,0,81,43,0,124,193,24,341
1146127,5,3,8,105,54,12,171,256,39,466
1146128,3,0,3,59,18,0,77,177,18,272
1146129,0,3,3,63,23,9,95,257,18,370
1146130,4,0,4,60,25,0,85,215,16,316
1146131,0,0,0,86,33,0,119,197,3,319
1146132,3,3,6,53,15,6,74,131,41,246
1146133,0,0,0,0,0,0,0,3,4,7
1146134,3,3,6,68,25,6,99,204,21,324
1146135,0,0,0,30,12,3,45,128,9,182
1146136,0,0,0,77,19,0,96,302,41,439
1146137,3,0,3,91,39,3,133,321,37,491
1146138,43,9,52,66,32,7,105,294,46,445
1146139,6,0,6,75,60,0,135,329,28,492
1146140,8,6,14,12,20,0,32,182,25,239
1146141,15,0,15,93,49,9,151,269,26,446
1146201,5,23,28,130,23,3,156,361,188,705
1146202,11,0,11,56,39,6,101,268,12,381
1146203,4,0,4,52,26,0,78,216,8,302
1146204,4,0,4,78,56,0,134,248,22,404
1146205,0,0,0,72,48,0,120,243,19,382
1146206,4,0,4,99,34,0,133,342,102,577
1146207,5,3,8,105,47,12,164,317,30,511
1146208,0,0,0,77,13,0,90,207,16,313
1146209,3,0,3,56,16,0,72,130,7,209
1146210,6,0,6,33,22,0,55,88,3,146
1146211,0,0,0,3,4,0,7,124,6,137
1146212,0,0,0,19,21,3,43,92,12,147
1146213,3,3,6,82,31,7,120,155,9,284
1146214,6,0,6,68,26,3,97,246,29,372
1146215,0,0,0,0,0,0,0,0,0,0
1146216,0,0,0,154,47,3,204,405,81,690
1146217,0,0,0,80,18,0,98,179,29,306
1146218,0,0,0,39,14,4,57,141,21,219
1146219,0,0,0,101,40,5,146,269,44,459
1146220,3,0,3,51,24,0,75,156,15,246
1146221,0,0,0,47,23,0,70,127,6,203
1146222,3,0,3,172,19,6,197,271,21,489
1146223,6,0,6,85,29,4,118,266,37,421
1146224,5,4,9,128,34,3,165,352,46,563
1146225,32,3,35,114,26,0,140,295,27,462
1146226,0,3,3,19,14,3,36,110,18,164
1146227,3,0,3,48,14,3,65,226,48,339
1146228,3,3,6,91,31,4,126,264,30,420
1146229,0,0,0,114,25,7,146,216,16,378
1146230,0,0,0,37,16,0,53,129,21,203
1146231,0,0,0,109,12,0,121,221,30,372
1146232,0,0,0,37,6,0,43,101,14,158
1146233,0,0,0,109,20,6,135,227,19,381
1146234,0,0,0,73,14,6,93,153,9,255
1146235,3,3,6,117,17,11,145,175,19,339
1146236,4,0,4,144,39,10,193,243,9,445
1146237,0,0,0,40,16,3,59,153,13,225
1146238,0,6,6,58,37,0,95,180,11,286
1146239,6,6,12,94,52,7,153,243,18,414
1146301,6,0,6,26,4,0,30,86,9,125
1146302,0,0,0,36,23,4,63,137,3,203
1146303,4,0,4,61,30,0,91,211,20,322
1146304,0,3,3,41,18,3,62,175,18,255
1146305,10,0,10,42,29,0,71,268,15,354
1146306,3,0,3,56,23,3,82,194,6,282
1146307,4,0,4,97,35,3,135,209,15,359
1146308,3,4,7,110,45,10,165,278,41,484
1146309,0,4,4,72,40,0,112,207,40,359
1146310,4,0,4,79,23,0,102,170,4,276
1146311,3,0,3,34,27,0,61,109,16,186
1146312,4,0,4,77,35,9,121,210,16,347
1146313,3,0,3,41,19,0,60,146,30,236
1146314,7,0,7,32,30,3,65,161,21,247
1146315,0,3,3,74,33,4,111,233,15,359
1146316,0,0,0,34,9,0,43,112,9,164
1146317,0,0,0,26,27,0,53,112,25,190
1146318,8,3,11,48,16,3,67,182,16,265
1146319,6,0,6,44,20,3,67,118,3,188
1146401,10,4,14,41,9,3,53,174,25,252
1146402,3,3,9,39,21,0,60,139,21,220
1146403,19,3,22,60,31,0,91,211,40,342
1146404,10,0,10,43,30,3,76,237,39,352
1146405,3,0,3,74,35,3,112,330,64,506
1146406,0,0,0,19,20,0,39,144,38,221
1146407,6,0,6,76,41,0,117,244,28,389
1146408,6,0,6,120,49,6,175,259,20,454
1146409,4,0,4,93,36,0,129,240,21,390
1146410,3,0,3,43,15,0,58,149,32,239
1146411,3,0,3,82,17,0,99,171,28,298
1146412,6,3,9,48,13,3,64,152,30,246
1146413,43,57,100,43,27,6,76,184,138,398
1146414,8,0,8,80,35,3,118,382,38,538
1146415,3,5,8,50,20,3,73,148,28,249
1146416,0,0,0,26,14,0,40,105,51,196
1146417,6,0,6,25,19,3,47,102,14,163
1146418,4,3,7,69,19,4,92,172,20,284
1146419,7,6,13,54,24,6,84,251,34,369
1146420,6,3,9,53,27,0,80,183,41,304
1146421,9,6,15,69,27,3,99,215,52,366
1146422,0,0,0,31,11,0,42,117,4,163
1146423,3,6,9,44,20,0,64,216,25,305
1146424,107,12,119,9,4,0,13,305,32,350
1146425,3,0,3,32,14,3,49,201,26,276
1146426,0,0,0,0,0,0,0,15,0,15
1146427,0,0,0,6,0,0,6,3,0,9
1146428,0,0,0,0,0,0,0,9,0,9
1146429,3,0,3,57,30,4,91,182,24,297
1146430,54,5,59,91,44,3,138,346,29,513
1146431,0,0,0,79,43,0,122,247,13,382
1146432,3,0,3,74,25,0,99,291,28,418
1146433,0,0,0,49,15,3,67,204,26,297
1146501,4,0,4,122,23,3,148,251,12,411
1146502,0,0,0,0,0,0,0,0,0,0
1146503,0,0,0,0,0,0,0,0,0,0
1146504,3,0,3,121,31,9,161,251,25,437
1146505,0,0,0,63,29,0,92,195,3,290
1146506,0,0,0,131,31,7,169,292,36,497
1146507,0,0,0,93,25,6,124,187,24,335
1146508,0,3,3,55,16,4,75,143,21,239
1146509,0,0,0,39,9,3,51,91,9,151
1146510,6,3,9,68,22,3,93,157,22,272
1146511,7,0,7,75,24,4,103,260,30,393
1146512,4,0,4,58,20,9,87,181,22,290
1146513,0,0,0,41,11,6,58,174,21,253
1146514,3,3,6,71,31,3,105,143,33,281
1146601,3,0,3,88,33,0,121,293,28,442
1146602,0,0,0,23,15,3,41,86,15,142
1146603,0,0,0,81,20,0,101,158,15,274
1146604,6,0,6,93,44,5,142,211,30,383
1146605,0,0,0,91,35,6,132,209,15,356
1146606,29,0,29,4,7,0,11,186,3,200
1146607,0,0,0,15,0,0,15,71,6,92
1146608,3,0,6,22,22,0,44,107,18,169
1146609,23,3,26,84,39,0,123,265,44,432
1146610,50,7,57,33,19,6,58,265,25,348
1146611,0,0,0,108,13,7,128,152,15,295
1146612,0,5,5,95,47,4,146,172,26,344
1146613,3,0,3,114,27,3,144,193,20,357
1146614,3,0,3,78,39,6,123,252,24,399
1146615,0,0,0,88,31,0,119,243,20,382
1146616,3,0,3,69,40,6,115,266,18,399
1146617,6,0,6,110,49,7,166,241,20,427
1146618,108,14,122,7,11,0,18,227,28,273
1146619,14,3,17,51,30,6,87,292,43,422
1146620,8,0,8,87,39,8,134,246,48,428
1146621,9,8,17,44,31,0,75,186,33,294
1146622,7,3,10,62,31,0,93,207,25,325
1146623,13,0,16,66,29,0,95,297,24,416
1146624,6,0,6,15,9,0,24,128,18,170
1146625,3,0,3,52,33,4,89,182,17,288
1146626,0,0,0,77,10,3,90,138,9,237
1146627,0,0,0,123,46,7,176,314,21,511
1146628,3,0,3,63,36,3,102,213,21,336
1146629,7,3,10,62,36,6,104,279,36,419
1146630,3,0,3,51,30,0,81,119,7,207
1146631,6,0,6,66,25,0,91,391,19,501
1146632,8,3,14,33,30,6,69,157,19,245
1146633,5,6,11,83,42,9,134,240,31,405
1146701,0,0,0,6,0,0,6,9,0,15
1146702,0,0,0,82,26,6,114,186,12,312
1146703,8,6,14,37,17,0,54,165,24,243
1146704,4,0,4,47,11,4,62,107,10,179
1146705,0,0,0,0,0,0,0,0,0,0
1146706,0,0,0,0,0,0,0,0,0,0
1146707,3,0,3,94,27,12,133,186,21,340
1146708,0,0,0,0,0,0,0,9,0,9
1146709,0,0,0,33,17,6,56,131,31,218
1146710,0,0,0,73,23,0,96,220,29,345
1146711,5,3,8,43,20,0,63,148,24,235
1146712,7,0,7,31,35,4,70,176,12,258
1146713,3,0,3,58,7,3,68,144,20,232
1146714,3,0,3,60,18,3,81,153,8,242
1146715,0,0,0,136,30,6,172,200,18,390
1146716,0,0,0,109,25,4,138,148,11,297
1146717,0,0,0,48,27,0,75,118,16,209
1146718,4,0,4,102,34,0,136,199,17,352
1146719,0,0,0,47,29,3,79,82,6,167
1146720,0,0,0,40,11,0,51,123,12,186
1146721,0,0,0,86,37,0,123,190,24,337
1146722,3,0,3,62,24,6,92,160,9,261
1146723,0,0,0,55,7,4,66,86,6,158
1146724,0,0,0,50,31,4,85,177,9,271
1146725,7,0,7,67,16,12,95,244,19,358
1146726,6,0,6,67,24,3,94,221,29,344
1146727,10,3,13,53,25,4,82,194,16,292
1146728,5,0,5,49,8,0,57,112,9,178
1146729,4,0,4,35,20,0,55,94,12,161
1146730,6,0,6,95,34,9,138,287,15,440
1146731,3,0,3,87,32,0,119,216,25,360
1146732,0,0,0,48,17,3,68,155,19,242
1146733,3,0,3,68,29,6,103,159,18,280
1146734,30,6,36,38,24,0,62,191,30,283
1146735,0,0,0,92,32,0,124,172,9,305
1146736,6,0,6,93,18,3,114,182,12,308
1146737,3,0,3,94,29,6,129,172,16,317
1146738,3,0,3,80,35,3,118,246,28,392
1146739,0,0,0,114,28,6,148,218,24,390
1146740,0,0,0,95,27,3,125,145,11,281
1146741,0,0,0,122,30,6,158,226,25,409
1146742,0,0,0,92,31,0,123,196,10,329
1146743,3,3,6,64,19,6,89,96,14,199
1146744,3,3,6,125,33,6,164,235,21,420
1146745,3,0,3,91,18,4,113,145,6,264
1146801,6,0,6,79,31,9,119,226,9,354
1146802,3,0,3,74,35,6,115,271,25,411
1146803,0,0,0,72,37,0,109,285,23,417
1146804,0,0,0,37,20,0,57,106,23,186
1146805,0,0,0,54,13,3,70,198,16,284
1146806,0,0,0,35,14,6,55,77,16,148
1146807,3,0,3,69,23,9,101,161,22,284
1146808,0,0,0,0,0,0,0,0,667,667
1146809,0,0,0,0,0,0,0,0,0,0
1146810,0,0,0,39,20,9,68,109,13,190
1146811,3,0,3,67,13,6,86,170,33,289
1146812,0,0,0,37,19,0,56,95,6,157
1146813,0,0,0,48,18,6,72,128,18,218
1146814,0,0,0,48,16,0,64,141,10,215
1146815,0,0,0,56,24,0,80,199,25,304
1146816,4,0,4,77,19,3,99,198,11,308
1146817,0,0,0,58,38,3,99,218,20,337
1146818,0,0,0,108,25,5,138,177,3,318
1146819,0,0,0,80,37,6,123,199,24,346
1146901,3,0,3,103,15,0,118,208,17,343
1146902,0,0,0,77,16,3,96,223,24,343
1146903,3,0,3,53,13,0,66,133,19,218
1146904,0,0,0,64,6,7,77,137,3,217
1146905,0,0,0,47,15,6,68,168,15,251
1146906,0,0,0,83,26,9,118,206,33,357
1146907,0,0,0,0,3,0,3,6,0,9
1146908,0,0,0,0,0,0,0,0,0,0
1146909,3,0,3,74,34,7,115,271,20,406
1146910,0,0,0,34,9,0,43,88,3,134
1146911,0,0,0,78,39,4,121,263,28,412
1146912,0,0,0,49,16,6,71,156,11,238
1146913,6,3,9,65,24,0,89,171,15,275
1146914,0,0,0,44,10,0,54,116,12,182
1146915,3,0,3,72,16,0,88,229,18,335
1146916,3,0,3,65,16,0,81,222,15,318
1146917,0,0,0,38,9,0,47,91,12,150
1146918,0,0,0,95,25,0,120,211,9,340
1146919,0,0,0,76,21,0,97,184,14,295
1146920,3,0,3,71,23,6,100,213,24,337
1147001,4,0,4,59,31,3,93,180,16,289
1147002,3,0,3,80,23,0,103,201,8,312
1147003,0,0,0,77,47,3,127,347,24,498
1147004,3,0,3,58,19,0,77,174,7,258
1147005,6,0,6,97,42,0,139,346,18,503
1147006,3,0,3,116,28,7,151,344,34,529
1147007,0,0,0,98,47,3,148,381,26,555
1147008,3,0,3,94,43,0,137,236,11,384
1147009,3,0,3,64,31,10,105,213,12,330
1147010,3,0,3,102,19,10,131,315,29,475
1147011,3,3,6,73,33,0,106,216,15,337
1147012,0,0,0,84,31,6,121,194,15,330
1147013,3,0,3,113,33,5,151,304,34,489
1147014,3,0,3,48,16,0,64,122,3,189
1147015,3,6,9,73,27,9,109,235,15,359
1147016,0,0,0,93,16,3,112,232,28,372
1147017,3,0,3,83,29,5,117,266,37,420
1147018,0,0,0,54,24,0,78,150,22,250
1147019,0,0,0,107,24,3,134,261,25,420
1147020,3,0,3,97,17,9,123,273,14,410
1147021,0,0,0,85,21,3,109,292,12,413
1147022,0,0,0,72,20,3,95,193,21,309
1147023,3,0,3,101,15,0,116,295,15,426
1147024,0,0,0,96,38,0,134,333,27,494
1147025,4,0,4,142,36,7,185,334,50,569
1147026,3,0,3,72,30,6,108,256,6,370
1147027,0,0,0,44,22,0,66,122,17,205
1147028,0,0,0,67,20,3,90,165,14,269
1147029,0,0,0,90,30,9,129,226,18,373
1147030,3,0,3,93,24,3,120,206,42,368
1147031,0,0,0,74,23,0,97,216,0,313
1147032,0,3,3,69,44,3,116,272,21,409
1147033,0,0,0,70,22,4,96,174,13,283
1147034,0,0,0,79,27,3,109,220,20,349
1147035,3,0,3,71,27,0,98,181,22,301
1147036,0,0,0,102,22,3,127,219,17,363
1147037,0,0,0,74,27,0,101,207,10,318
1147038,0,0,0,49,28,3,80,147,12,239
1147039,6,3,9,55,25,3,83,187,19,289
1147040,0,0,0,67,31,0,98,204,13,315
1147041,6,0,6,121,49,0,170,443,35,648
1147042,6,0,6,48,25,3,76,200,0,276
1147101,7,0,7,72,34,4,110,222,44,376
1147102,3,0,3,42,18,0,60,175,22,257
1147103,3,3,6,39,22,0,61,116,13,190
1147104,7,0,7,48,16,3,67,172,17,256
1147105,6,6,12,44,27,4,75,213,30,318
1147106,3,3,6,58,24,3,85,224,30,339
1147107,0,0,0,73,32,6,111,251,21,383
1147108,4,3,7,66,27,7,100,291,37,428
1147109,7,0,7,52,25,0,77,120,23,220
1147110,0,0,0,72,29,4,105,172,22,299
1147111,3,0,3,69,24,0,93,211,24,328
1147112,0,3,3,78,43,0,121,220,20,361
1147113,0,0,0,100,33,3,136,253,27,416
1147114,6,0,6,91,43,0,134,255,37,426
1147115,5,0,5,80,24,6,110,305,34,449
1147116,0,0,0,55,26,9,90,189,35,314
1147117,3,0,3,41,20,0,61,200,13,274
1147118,4,3,7,60,19,3,82,203,28,313
1147119,6,3,9,99,28,3,130,279,33,442
1147120,3,0,3,91,40,7,138,288,15,441
1147121,3,0,3,91,46,5,142,281,27,450
1147122,0,0,0,108,34,8,150,290,16,456
1147123,3,0,3,78,29,0,107,189,32,328
1147124,3,62,65,106,23,5,134,291,162,587
1147125,6,0,6,101,31,0,132,348,12,492
1147126,3,0,3,50,24,3,77,156,15,248
1147127,8,0,8,70,25,9,104,190,22,316
1147128,3,6,9,75,47,4,126,265,54,445
1147129,10,3,13,43,22,6,71,197,51,319
1147130,6,0,6,58,22,0,80,234,62,376
1147131,0,0,0,48,17,3,68,150,14,232
1147132,6,0,6,78,23,4,105,239,29,373
1147133,3,0,3,58,24,0,82,223,51,356
1147134,0,3,3,74,28,6,108,249,69,426
1147135,0,0,0,76,22,3,101,232,50,383
1147136,8,3,11,36,15,0,51,163,84,298
1147137,4,0,4,68,27,3,98,204,20,322
1147138,6,0,6,64,15,4,83,247,53,383
1147139,13,0,13,110,37,11,158,379,43,580
1147140,6,0,6,58,7,3,68,181,22,271
1147141,0,4,4,67,18,4,89,251,37,377
1147142,12,0,12,125,45,11,181,364,43,588
1147143,3,0,3,68,31,3,102,244,40,386
1147144,0,0,0,3,0,0,3,0,0,3
1147145,0,0,0,0,0,0,0,0,0,0
1147146,0,0,0,0,0,0,0,0,0,0
1147147,3,0,6,101,52,6,159,291,51,501
1147148,3,0,3,75,30,0,105,206,35,346
1147149,3,5,8,104,41,9,154,289,21,464
1147150,3,0,3,78,23,3,104,239,36,379
1147151,3,0,3,54,26,4,84,224,39,347
1147152,6,0,6,72,26,6,104,226,18,348
1147153,0,0,0,108,32,3,143,265,42,450
1147154,0,0,0,0,0,0,0,0,0,0
1147155,6,0,6,109,60,0,169,308,88,565
1147156,7,0,7,75,33,7,115,239,61,415
1147157,12,0,12,49,24,4,77,322,78,477
1147201,6,0,6,46,10,0,56,153,39,248
1147202,0,0,0,58,22,0,80,194,25,299
1147203,0,0,0,69,3,0,72,219,38,329
1147204,0,0,0,29,14,0,43,147,17,207
1147205,3,0,3,85,12,8,105,301,79,485
1147206,0,0,0,124,14,0,138,281,94,513
1147207,0,0,0,77,7,3,87,208,56,351
1147208,6,3,12,62,22,0,84,227,41,352
1147209,0,0,0,99,6,0,105,334,64,503
1147210,0,0,0,60,6,3,69,305,25,399
1147211,4,0,4,40,6,0,46,143,41,230
1147212,0,3,3,45,18,0,63,179,38,280
1147213,3,0,3,48,16,6,70,221,46,337
1147214,0,0,0,83,18,0,101,193,66,360
1147215,8,0,8,85,12,0,97,215,49,361
1147216,6,0,6,87,19,0,106,243,32,381
1147217,3,0,3,44,26,0,70,158,34,262
1147218,6,4,10,79,10,0,89,237,15,341
1147219,0,0,0,31,0,4,35,157,43,235
1147220,0,0,0,63,19,6,88,236,19,343
1147221,6,0,6,84,9,0,93,266,23,382
1147222,0,0,0,30,10,0,40,131,25,196
1147223,6,4,10,60,13,0,73,261,61,395
1147224,3,3,6,40,15,0,55,165,22,242
1147225,4,3,7,67,23,0,90,254,46,390
1147226,4,0,4,77,25,3,105,298,24,427
1147227,0,3,3,164,12,0,176,370,22,568
1147228,56,3,59,69,15,0,84,333,46,463
1147229,3,0,3,72,8,0,80,204,25,309
1147230,3,0,3,57,11,9,77,159,39,275
1147231,0,0,0,0,0,0,0,0,0,0
1147232,0,0,0,0,0,0,0,6,0,6
1147233,3,3,10,87,3,0,90,222,29,341
1147234,6,3,9,57,12,0,69,203,21,293
1147235,0,0,0,0,0,0,0,0,0,0
1147236,3,0,3,67,17,9,93,275,38,406
1147237,0,0,0,0,0,0,0,3,0,3
1147238,3,0,3,77,21,0,98,288,33,419
1147239,0,0,0,62,25,0,87,256,54,397
1147240,5,4,9,69,15,6,90,257,38,385
1147241,13,0,13,57,18,0,75,300,41,416
1147242,0,0,0,24,9,0,33,110,13,156
1147243,3,0,3,68,12,6,86,270,37,393
1147244,0,0,0,46,16,0,62,166,8,236
1147245,7,0,7,75,9,0,84,255,29,368
1147246,60,6,66,44,10,0,54,258,38,350
1147247,0,0,0,81,27,3,111,267,61,439
1147248,3,3,6,58,22,0,80,224,41,345
1147249,0,0,0,67,0,0,67,260,95,422
1147250,0,0,0,134,32,0,166,666,240,1072
1147251,0,0,0,94,6,3,103,269,92,464
1147252,0,0,0,0,0,0,0,15,6,21
1147253,3,0,3,80,12,0,92,343,42,477
1147254,0,0,0,5,0,0,5,29,0,34
1147255,4,0,4,83,8,0,91,244,28,363
1147256,3,0,3,77,31,0,108,284,16,408
1147257,6,0,6,52,15,0,67,221,21,309
1147258,0,0,0,84,20,0,104,168,37,309
1147259,0,0,0,64,13,0,77,210,40,327
1147260,6,6,12,61,6,0,67,195,116,378
1147261,0,0,0,113,8,0,121,331,35,487
1147262,5,0,5,125,20,0,145,399,72,616
1147263,9,0,9,112,12,0,124,354,41,519
1147264,3,0,3,98,12,0,110,325,65,500
1147265,0,4,4,119,15,0,134,436,63,633
1147266,0,0,0,26,3,0,29,69,0,98
1147267,3,0,3,39,3,0,42,220,28,290
1147268,6,0,6,51,0,0,51,204,33,288
1147269,0,0,0,125,4,0,129,539,88,756
1147270,6,0,6,36,22,0,58,178,44,280
1147271,0,0,0,0,0,0,0,0,0,0
1147272,7,0,7,47,15,0,62,180,16,258
1147273,0,0,0,52,18,0,70,171,19,260
1147274,0,0,0,63,23,3,89,309,54,452
1147275,3,0,3,45,10,0,55,167,21,243
1147276,0,0,0,79,14,0,93,192,26,311
1147301,0,0,0,58,4,0,62,132,9,203
1147302,0,0,0,102,14,4,120,217,21,358
1147303,0,0,0,52,4,0,56,102,3,161
1147304,3,0,3,98,18,6,122,252,34,408
1147305,0,0,0,45,6,0,51,119,28,198
1147306,0,0,0,0,0,0,0,0,0,0
1147307,0,0,0,0,0,0,0,4,1345,1349
1147308,0,0,0,134,22,3,159,189,20,368
1147309,0,0,0,84,18,0,102,154,12,268
1147310,6,0,6,123,20,0,143,363,35,541
1147311,0,0,0,111,24,0,135,243,6,384
1147312,0,0,0,9,0,0,9,24,19,52
1147313,0,0,0,76,5,4,85,121,8,214
1147314,6,0,6,149,49,3,201,750,137,1088
1147315,9,0,9,148,46,3,197,696,107,1000
1147316,3,0,6,39,21,3,63,217,71,351
1147317,0,0,0,0,0,0,0,3,0,3
1147318,0,0,0,65,18,0,83,188,47,318
1147319,0,0,0,95,9,0,104,142,30,276
1147320,3,0,3,70,7,0,77,117,9,203
1147321,6,0,6,67,16,3,86,180,22,288
1147322,0,0,0,94,15,0,109,273,19,401
1147323,6,0,6,95,18,3,116,347,40,503
1147324,3,0,3,94,29,0,123,278,20,421
1147401,3,0,3,93,27,0,120,384,80,584
1147402,0,0,0,0,0,0,0,0,0,0
1147403,0,0,0,0,0,0,0,0,0,0
1147404,0,0,0,0,0,0,0,0,0,0
1147405,3,0,3,49,3,3,55,231,29,315
1147406,4,0,4,74,22,0,96,222,30,348
1147407,4,3,7,32,12,0,44,180,20,244
1147408,3,0,6,33,6,0,39,104,19,162
1147409,0,0,0,3,0,0,3,6,3,12
1147410,3,0,3,40,17,0,57,142,31,230
1147411,3,0,3,67,20,0,87,189,23,299
1147412,7,0,7,46,29,0,75,247,22,344
1147413,8,0,8,85,28,6,119,263,42,424
1147414,14,3,17,61,37,0,98,318,55,471
1147415,8,4,12,46,21,6,73,231,29,333
1147416,10,0,10,47,7,0,54,172,28,254
1147417,6,3,9,45,11,0,56,171,28,255
1147418,3,0,3,41,17,0,58,197,24,279
1147419,11,0,11,48,9,0,57,207,21,285
1147420,11,6,17,71,16,0,87,250,47,384
1147421,3,3,6,73,24,0,97,205,64,366
1147422,0,0,0,79,5,0,84,212,49,345
1147423,4,0,4,71,22,0,93,168,34,295
1147424,12,0,12,87,19,0,106,198,34,338
1147425,6,3,9,43,15,0,58,176,12,246
1147426,6,3,9,41,14,0,55,169,25,249
1147427,3,0,3,47,15,0,62,174,16,252
1147428,6,4,10,58,12,3,73,197,12,282
1147429,0,0,0,0,0,0,0,0,0,0
1147430,3,4,7,58,18,0,76,204,14,294
1147431,7,0,7,69,19,0,88,278,57,423
1147432,7,0,7,49,31,0,80,192,9,281
1147433,10,0,10,73,27,0,100,315,30,445
1147434,3,0,3,96,9,0,105,338,34,477
1147435,0,0,0,76,21,3,100,320,32,452
1147436,12,0,12,52,16,0,68,240,32,340
1147437,3,5,8,91,17,0,108,419,26,553
1147438,6,0,6,51,12,0,63,182,21,266
1147439,9,0,9,28,15,0,43,194,34,271
1147440,0,0,0,0,0,0,0,0,0,0
1147441,6,0,6,78,31,0,109,335,28,472
1147442,3,0,3,51,17,3,71,323,38,432
1147443,0,0,0,45,11,0,56,166,7,229
1147444,8,0,8,39,24,0,63,181,4,248
1147445,0,0,0,277,64,11,352,853,74,1279
1147446,7,4,11,90,25,6,121,327,23,471
1147447,3,0,3,71,15,0,86,203,50,339
1147448,0,0,0,99,20,3,122,433,32,587
1147449,0,3,3,92,24,4,120,369,16,505
1147450,4,3,7,83,0,0,83,229,36,348
1147451,3,3,6,45,31,0,76,183,31,290
1147452,0,0,0,62,18,0,80,204,16,300
1147453,0,0,0,34,9,0,43,80,0,123
1147454,0,0,0,51,9,0,60,106,19,185
1147455,6,0,6,49,7,0,56,283,50,389
1147456,0,0,0,0,0,0,0,0,0,0
1147457,3,3,6,94,15,3,112,403,61,576
1147458,60,4,64,131,15,5,151,566,33,750
1147459,8,0,8,88,12,0,100,358,70,528
1147460,7,0,7,45,15,0,60,236,32,328
1147461,10,0,13,62,32,0,94,345,46,485
1147462,5,0,5,40,18,0,58,225,32,315
1147463,5,0,5,58,10,0,68,173,10,251
1147464,3,3,6,23,4,0,27,132,34,193
1147465,6,0,6,42,21,0,63,177,12,252
1147466,3,0,3,80,15,3,98,281,18,397
1147467,5,0,5,52,15,0,67,167,24,258
1147468,7,0,7,58,14,0,72,239,27,338
1147469,6,3,9,43,15,3,61,149,27,237
1147470,10,0,10,67,23,3,93,299,18,410
1147471,0,0,0,44,9,0,53,185,24,262
1147472,0,0,0,49,3,6,58,129,7,194
1147473,0,0,0,48,22,0,70,168,18,256
1147474,6,0,6,44,28,0,72,175,26,273
1147475,3,0,3,48,15,0,63,198,24,285
1147476,6,0,6,54,10,0,64,175,12,251
1147501,0,0,0,3,0,0,3,3,0,6
1147601,6,0,6,51,16,0,67,133,9,209
1147602,0,0,0,73,32,0,105,206,9,320
1147603,13,115,128,67,28,3,98,253,263,614
1147604,4,0,4,96,12,3,111,237,10,358
1147605,3,0,3,90,14,0,104,216,15,335
1147606,3,0,3,74,8,7,89,209,13,311
1147607,4,0,4,74,14,7,95,161,12,268
1147608,6,0,6,94,31,6,131,284,10,425
1147609,6,0,6,76,31,0,107,261,6,374
1147610,0,0,0,93,29,3,125,252,15,392
1147611,3,0,3,55,32,0,87,192,27,306
1147612,5,0,5,93,18,0,111,308,39,458
1147613,0,0,0,56,15,0,71,133,33,237
1147614,6,0,6,94,14,6,114,254,18,386
1147615,7,0,7,111,41,6,158,347,20,525
1147616,0,0,0,58,17,0,75,165,3,243
1147617,0,0,0,109,18,6,133,253,18,404
1147618,4,0,4,66,23,6,95,168,7,270
1147619,6,0,6,82,26,0,108,258,14,380
1147620,0,0,0,60,8,6,74,181,0,255
1147621,0,0,0,59,46,3,108,147,4,259
1147622,8,3,11,79,28,3,110,209,11,330
1147623,0,9,9,107,25,4,136,310,20,466
1147624,0,0,0,146,35,0,181,413,44,638
1147625,9,0,9,86,34,7,127,285,9,421
1147626,3,4,7,64,19,11,94,305,17,416
1147627,0,0,0,47,13,6,66,129,12,207
1147628,12,3,15,88,24,3,115,250,12,377
1147629,4,0,4,75,13,0,88,195,15,298
1147630,6,0,6,80,23,0,103,210,19,332
1147631,3,0,3,51,44,3,98,314,14,426
1147632,0,0,0,71,39,0,110,222,15,347
1147633,3,0,3,102,56,0,158,280,27,465
1147634,6,0,6,69,32,0,101,159,15,275
1147635,7,0,7,67,53,0,120,278,15,413
1147636,0,3,3,49,13,0,62,184,12,258
1147637,6,0,6,92,32,6,130,314,19,463
1147638,6,0,6,59,26,6,91,223,19,333
1147639,0,0,0,97,19,3,119,153,18,290
1147640,8,0,8,68,12,0,80,196,9,285
1147641,4,0,4,56,47,4,107,199,5,311
1147642,10,0,13,111,45,5,161,332,7,500
1147643,9,0,9,58,30,4,92,198,17,307
1147644,5,3,8,86,27,0,113,219,21,353
1147645,3,0,3,69,43,6,118,182,12,312
1147646,5,0,5,86,45,4,135,264,5,404
1147647,4,0,4,55,28,0,83,175,25,283
1147648,4,4,8,82,26,0,108,224,16,348
1147649,6,0,6,77,38,6,121,281,21,423
1147650,0,0,0,45,30,3,78,215,16,309
1147651,8,0,8,33,13,0,46,181,24,251
1147652,3,0,3,113,26,0,139,264,15,418
1147653,0,0,0,100,59,0,159,293,9,461
1147654,0,3,3,72,3,6,81,122,6,209
1147655,3,0,3,107,40,0,147,286,21,454
1147656,89,18,107,33,11,0,44,277,32,353
1147701,0,3,3,89,18,0,107,231,25,363
1147702,0,0,0,0,0,0,0,0,0,0
1147703,6,3,9,30,18,0,48,127,9,184
1147704,6,3,9,30,19,3,52,167,10,229
1147705,0,0,0,0,0,0,0,168,0,168
1147706,11,0,11,88,28,0,116,306,30,452
1147707,0,0,0,77,9,3,89,148,6,243
1147708,0,0,0,85,12,0,97,121,3,221
1147709,0,0,4,42,15,0,57,157,16,230
1147710,6,0,6,43,14,0,57,176,10,243
1147711,4,0,4,81,27,8,116,188,18,322
1147712,4,0,4,35,16,3,54,121,12,187
1147713,7,3,10,57,13,0,70,205,25,300
1147714,3,0,6,77,15,0,92,174,41,307
1147715,6,4,10,87,39,3,129,285,39,453
1147716,3,0,3,39,11,0,50,147,22,219
1147717,3,6,9,96,14,0,110,319,64,493
1147718,0,0,0,134,27,4,165,339,20,524
1147719,11,0,11,70,25,6,101,230,12,343
1147720,6,3,9,73,21,6,100,221,22,343
1147721,0,0,0,0,0,0,0,13,0,13
1147722,6,0,6,53,21,6,80,186,36,302
1147723,0,0,0,0,0,0,0,0,0,0
1147724,3,3,6,56,13,0,69,178,56,303
1147725,12,0,12,89,15,0,104,198,21,323
1147726,3,3,6,78,35,6,119,220,27,366
1147727,0,3,3,110,20,6,136,213,12,361
1147728,3,3,6,51,25,9,85,137,9,231
1147729,4,0,4,87,29,0,116,268,16,400
1147730,0,0,0,4,0,0,4,0,0,4
1147731,4,0,4,36,12,5,53,113,4,170
1147732,6,0,6,45,21,3,69,192,18,279
1147733,7,0,7,72,19,0,91,163,20,274
1147734,4,3,7,109,23,3,135,277,37,449
1147735,5,0,5,41,13,3,57,149,9,215
1147736,5,3,8,71,15,6,92,192,9,293
1147737,3,0,3,89,37,10,136,254,19,409
1147738,0,0,0,68,13,0,81,153,19,253
1147739,0,0,0,0,0,0,0,8,0,8
1147740,8,0,8,109,33,9,151,295,20,466
1147741,4,0,4,74,14,3,91,311,16,418
1147742,12,3,15,81,18,0,99,255,32,386
1147743,0,0,0,50,13,0,63,239,36,338
1147744,7,0,7,106,39,6,151,261,50,462
1147745,9,0,9,87,25,3,115,297,10,422
1147746,0,0,0,116,10,0,126,172,25,323
1147747,6,0,6,85,16,0,101,196,31,328
1147748,3,3,6,76,14,0,90,236,22,348
1147749,29,0,29,77,15,3,95,275,33,403
1147750,70,6,76,83,44,3,130,397,30,557
1147751,7,0,7,42,15,3,60,119,12,191
1147752,3,0,3,47,14,3,64,186,30,280
1147801,7,0,7,75,24,0,99,288,46,433
1147802,10,0,10,49,12,6,67,188,30,285
1147803,9,0,9,47,27,0,74,147,38,259
1147804,6,6,12,46,4,6,56,155,36,247
1147805,7,3,10,65,16,3,84,218,43,345
1147806,8,0,8,51,24,3,78,393,86,557
1147807,7,0,7,60,7,0,67,188,14,269
1147808,3,3,6,47,24,3,74,164,10,248
1147809,6,3,9,55,13,0,68,195,13,276
1147810,0,0,0,93,25,0,118,229,31,378
1147811,0,6,6,72,19,3,94,187,21,302
1147812,7,9,16,41,13,0,54,145,25,224
1147813,4,0,4,92,24,3,119,250,16,385
1147814,0,0,0,47,81,11,139,167,18,324
1147815,4,0,4,50,31,9,90,217,34,341
1147816,6,0,6,72,31,6,109,338,30,477
1147817,0,4,4,62,13,4,79,175,31,285
1147818,7,0,7,52,22,3,77,197,21,295
1147819,7,0,7,103,18,3,124,299,19,442
1147820,0,0,0,31,3,0,34,138,15,187
1147821,0,0,0,45,19,6,70,155,30,255
1147822,0,0,0,50,19,0,69,144,20,233
1147823,0,0,0,68,18,0,86,183,18,287
1147824,13,0,13,102,35,0,137,307,24,468
1147825,6,0,6,114,40,5,159,461,37,657
1147826,6,0,6,96,19,9,124,228,21,373
1147827,3,0,3,57,18,0,75,210,9,294
1147828,6,3,9,54,23,3,80,236,25,341
1147829,3,3,6,93,25,0,118,279,29,426
1147830,3,0,3,96,13,3,112,265,30,407
1147831,9,0,9,55,29,0,84,245,15,344
1147832,0,0,0,73,24,0,97,135,7,239
1147833,6,0,6,49,0,6,55,137,14,206
1147834,6,3,9,88,12,6,106,243,13,362
1147835,0,0,0,57,0,0,57,157,6,220
1147836,11,0,11,66,41,3,110,269,9,388
1147837,5,0,5,87,15,0,102,206,47,355
1147838,4,0,4,98,16,9,123,256,36,415
1147901,44,0,44,83,11,0,94,308,27,429
1147902,9,0,9,99,34,3,136,265,24,425
1147903,6,3,9,75,25,3,103,297,25,425
1147904,15,0,15,63,23,0,86,240,27,353
1147905,8,0,8,38,18,0,56,183,17,256
1147906,10,0,10,63,29,0,92,201,24,317
1147907,14,0,14,74,19,6,99,342,22,463
1147908,7,3,10,83,18,0,101,232,26,359
1147909,0,0,0,0,0,0,0,0,3,3
1147910,8,0,8,36,14,0,50,167,24,241
1147911,11,0,11,82,22,0,104,279,36,419
1147912,6,0,6,69,12,0,81,241,23,345
1147913,3,0,3,126,32,0,158,274,22,454
1147914,0,0,0,48,20,0,68,194,9,271
1147915,6,0,6,57,8,6,71,219,18,308
1147916,0,3,3,51,9,0,60,185,34,279
1147917,0,0,0,0,0,0,0,0,0,0
1147918,14,0,14,92,21,7,120,275,10,405
1147919,8,0,8,73,16,0,89,213,25,327
1147920,35,3,38,58,19,6,83,353,47,483
1147921,9,0,9,56,33,0,89,245,27,361
1147922,3,6,9,36,12,0,48,148,28,224
1147923,10,0,10,85,15,0,100,300,23,423
1147924,8,3,11,96,24,0,120,365,62,547
1147925,10,3,13,78,28,0,106,326,31,463
1147926,4,0,4,95,22,0,117,241,18,376
1147927,6,4,10,70,20,3,93,253,27,373
1147928,0,0,0,0,0,0,0,0,0,0
1147929,3,3,6,24,12,6,42,82,15,139
1147930,7,0,7,97,27,0,124,315,20,459
1147931,9,0,9,47,11,3,61,242,24,327
1147932,5,0,5,45,13,0,58,170,25,253
1147933,0,6,6,37,9,0,46,100,12,158
1147934,7,3,10,64,24,3,91,246,16,353
1147935,0,0,0,0,0,0,0,0,362,362
1147936,0,0,0,0,0,0,0,3,0,3
1147937,0,0,0,0,0,0,0,4,0,4
1147938,0,0,0,0,0,0,0,0,0,0
1147939,3,3,6,45,8,0,53,127,22,202
1147940,8,4,12,75,29,0,104,278,33,415
1147941,4,4,8,57,21,6,84,233,21,338
1147942,10,0,10,81,33,6,120,309,18,447
1147943,13,3,20,69,24,0,93,291,28,412
1148001,6,0,6,95,26,0,121,298,51,470
1148002,3,6,9,29,6,0,35,156,27,218
1148003,6,3,9,41,10,0,51,186,46,283
1148004,14,3,17,52,31,0,83,337,28,448
1148005,3,0,3,56,19,0,75,191,31,297
1148006,9,3,12,91,24,0,115,266,28,409
1148007,3,3,6,60,7,5,72,207,31,310
1148008,3,0,3,80,16,0,96,290,27,413
1148009,6,0,6,63,15,0,78,154,27,259
1148010,6,0,6,67,13,0,80,215,39,334
1148011,3,0,3,37,13,0,50,143,22,215
1148012,3,0,3,68,9,0,77,183,29,289
1148013,6,0,6,91,32,6,129,278,57,464
1148014,3,0,3,28,12,0,40,153,16,209
1148015,8,0,8,103,20,0,123,294,27,444
1148016,12,0,12,83,27,0,110,401,41,552
1148017,70,3,73,42,19,4,65,291,21,377
1148018,0,0,0,0,0,0,0,4,4,8
1148019,3,0,3,62,6,3,71,202,24,297
1148020,11,3,14,87,44,3,134,347,40,521
1148021,4,0,4,21,23,0,44,99,10,153
1148022,33,0,33,51,18,3,72,240,30,342
1148023,3,0,3,51,9,0,60,182,21,263
1148024,32,0,32,81,21,0,102,344,25,471
1148025,6,0,6,74,22,0,96,268,39,403
1148026,8,0,8,90,11,4,105,268,49,422
1148027,10,0,10,62,8,0,70,231,26,327
1148028,9,3,12,70,21,0,91,259,27,377
1148029,0,0,0,63,19,0,82,204,24,310
1148030,5,0,8,73,18,0,91,229,32,352
1148031,39,0,39,70,10,0,80,314,64,458
1148032,7,4,11,70,26,3,99,363,28,490
1148101,3,0,3,56,23,0,79,255,19,353
1148102,4,0,4,32,18,0,50,169,18,237
1148103,6,0,6,116,28,0,144,410,48,602
1148104,0,0,0,95,22,0,117,214,65,396
1148105,0,0,0,50,18,0,68,149,23,240
1148106,3,0,3,85,15,0,100,240,46,386
1148107,3,0,3,37,16,0,53,147,17,217
1148108,3,0,3,80,18,6,104,242,44,390
1148109,9,0,9,52,15,3,70,187,34,291
1148110,6,0,6,72,23,0,95,179,37,311
1148111,10,0,10,63,8,3,74,215,51,340
1148112,8,0,8,100,16,0,116,287,45,448
1148113,3,4,7,94,20,4,118,280,28,426
1148114,0,0,0,78,10,0,88,181,56,325
1148115,0,0,0,56,22,0,78,132,14,224
1148116,5,0,5,53,6,0,59,155,38,252
1148117,6,0,6,49,19,3,71,174,27,272
1148118,3,0,3,52,16,0,68,141,7,216
1148119,3,0,3,68,19,0,87,260,51,398
1148120,0,0,0,59,6,0,65,176,33,274
1148121,10,0,10,26,21,3,50,160,18,228
1148122,3,0,3,74,22,6,102,264,36,402
1148123,5,0,5,39,20,3,62,280,33,375
1148124,3,0,3,77,15,0,92,338,27,457
1148125,9,5,14,88,20,0,108,275,140,523
1148126,5,0,5,56,22,0,78,253,56,387
1148127,6,0,6,71,18,0,89,188,26,303
1148128,3,3,6,36,26,6,68,200,34,302
1148129,0,0,0,46,21,0,67,300,68,435
1148130,3,5,8,56,15,0,71,198,78,347
1148131,0,0,0,89,14,0,103,360,53,516
1148132,3,0,3,32,12,3,47,201,27,275
1148133,0,0,0,0,0,0,0,0,0,0
1148134,0,0,0,0,0,0,0,0,0,0
1148135,0,0,0,15,0,6,21,167,14,202
1148136,0,0,0,64,11,0,75,240,22,337
1148137,0,0,3,69,32,4,105,269,17,391
1148138,3,0,3,72,12,3,87,228,48,363
1148139,8,0,8,65,17,0,82,262,37,381
1148140,7,5,12,69,15,3,87,223,35,345
1148141,7,3,10,55,15,0,70,185,31,286
1148142,6,0,6,46,7,0,53,189,17,259
1148143,0,0,0,0,0,0,0,0,0,0
1148144,0,0,0,0,0,0,0,0,0,0
1148145,6,0,6,94,12,0,106,248,38,392
1148146,0,0,0,41,15,0,56,150,18,224
1148201,0,0,3,205,41,3,249,358,24,631
1148202,0,0,0,146,16,9,171,217,6,394
1148203,0,0,0,12,0,0,12,19,0,31
1148204,0,0,0,189,25,3,217,376,9,602
1148205,0,0,0,44,18,5,67,127,22,216
1148206,0,0,0,62,29,0,91,180,3,274
1148207,0,0,0,0,0,0,0,0,0,0
1148208,0,0,0,61,15,6,82,160,9,251
1148209,3,0,3,73,37,0,110,189,26,325
1148210,0,0,0,52,22,3,77,141,11,229
1148211,24,6,30,50,31,0,81,286,28,395
1148212,0,0,0,107,64,6,177,300,17,494
1148213,0,0,0,46,26,3,75,169,20,264
1148214,3,3,6,55,32,0,87,238,28,353
1148215,3,3,6,118,40,0,158,278,27,463
1148216,6,3,9,81,30,0,111,260,23,394
1148217,6,0,6,47,19,0,66,198,12,276
1148218,4,0,4,39,19,0,58,151,9,218
1148219,6,0,6,97,45,0,142,279,17,438
1148220,0,0,0,86,33,0,119,200,6,325
1148221,4,3,7,86,27,0,113,253,23,389
1148222,0,4,4,42,40,0,82,149,13,244
1148223,3,0,3,67,23,0,90,181,22,293
1148224,6,3,9,92,41,0,133,271,29,433
1148225,0,0,0,60,32,0,92,204,21,317
1148226,0,0,0,82,42,3,127,259,21,407
1148227,0,0,0,42,29,0,71,109,13,193
1148228,5,0,5,82,41,0,123,231,32,386
1148229,4,0,4,43,19,0,62,158,3,223
1148230,4,0,4,86,41,4,131,291,56,478
1148231,0,0,0,64,22,0,86,144,17,247
1148232,3,0,3,39,30,0,69,144,13,226
1148233,4,0,4,38,26,3,67,133,9,209
1148234,0,0,0,59,26,0,85,139,12,236
1148235,0,0,0,34,14,3,51,95,16,162
1148236,3,3,6,93,47,0,140,268,18,426
1148237,40,0,40,58,29,0,87,313,22,422
1148238,3,0,3,43,19,0,62,144,10,216
1148239,3,0,3,75,23,3,101,210,12,323
1148240,3,0,3,59,20,0,79,147,12,238
1148241,0,0,0,49,24,0,73,178,18,269
1148242,0,0,0,40,19,9,68,168,8,244
1148243,0,0,0,48,35,3,86,145,7,238
1148244,3,0,3,70,29,3,102,238,16,356
1148245,0,0,0,82,34,0,116,221,13,350
1148246,3,0,3,68,40,3,111,218,20,349
1148247,3,0,3,72,37,0,109,327,37,473
1148248,3,0,3,83,35,4,122,253,21,396
1148249,0,0,0,106,34,6,146,261,21,428
1148250,0,0,0,73,22,3,98,237,21,356
1148251,0,3,3,54,27,7,88,142,14,244
1148252,8,0,8,90,27,3,120,215,21,356
1148253,0,0,0,46,15,0,61,110,7,178
1148254,4,39,43,45,15,0,60,141,100,301
1148255,6,0,6,64,25,0,89,168,27,284
1148256,6,0,6,168,36,0,204,358,45,607
1148257,0,0,0,39,13,0,52,101,0,153
1148258,6,0,6,82,29,3,114,256,20,390
1148301,7,0,7,57,12,0,69,163,34,266
1148302,3,3,6,90,25,0,115,248,53,416
1148303,3,3,6,44,13,0,57,107,46,210
1148304,3,3,6,78,14,0,92,214,45,351
1148305,11,0,11,85,24,6,115,299,28,442
1148306,0,0,0,0,0,0,0,6,0,6
1148307,3,3,6,53,11,0,64,162,25,251
1148308,7,0,7,44,16,0,60,170,31,261
1148309,3,3,6,34,13,0,47,141,20,208
1148310,0,0,0,54,16,3,73,206,31,310
1148311,3,3,6,76,30,0,106,216,69,391
1148312,6,0,9,70,15,0,85,168,35,288
1148313,0,5,5,65,4,0,69,168,44,281
1148314,4,3,7,71,28,7,106,316,69,491
1148315,0,7,7,124,27,0,151,438,72,661
1148316,6,3,9,29,9,3,41,132,51,224
1148317,6,0,6,72,27,3,102,225,31,358
1148318,8,0,8,66,10,0,76,191,85,352
1148319,4,0,4,32,14,0,46,194,15,255
1148320,5,0,5,58,3,0,61,179,26,266
1148321,3,0,3,66,18,3,87,204,87,378
1148322,40,3,46,91,35,3,129,371,30,530
1148323,7,0,7,58,20,4,82,185,15,282
1148324,9,0,9,77,11,0,88,305,33,426
1148325,6,0,9,70,31,0,101,293,11,405
1148326,3,0,3,32,27,0,59,118,18,195
1148327,0,0,0,24,16,0,40,106,6,152
1148328,0,0,4,67,11,0,78,160,6,244
1148329,5,0,5,78,23,4,105,281,61,447
1148330,5,0,5,67,27,0,94,282,50,426
1148331,3,6,9,74,29,3,106,240,43,389
1148332,9,0,9,113,25,3,141,295,24,460
1148333,7,0,7,82,12,6,100,259,36,395
1148334,0,0,0,0,0,0,0,6,6,12
1148335,0,0,0,67,22,0,89,224,22,335
1148336,7,0,7,63,5,0,68,198,21,287
1148337,3,0,3,72,22,3,97,195,39,331
1148338,3,6,9,53,21,3,77,185,47,309
1148339,6,0,6,54,14,3,71,238,55,364
1148340,8,3,14,73,26,0,99,293,57,449
1148341,6,0,6,60,18,0,78,175,23,276
1148342,7,7,14,91,42,0,133,310,43,486
1148401,11,3,14,89,38,3,130,322,43,495
1148402,5,10,15,69,18,0,87,267,27,381
1148403,6,0,6,122,18,4,144,364,52,560
1148404,8,3,11,47,22,6,75,242,47,364
1148405,9,3,12,58,37,0,95,245,48,388
1148406,7,3,10,119,18,0,137,340,61,538
1148407,6,6,12,65,9,0,74,198,18,290
1148408,0,0,0,84,19,0,103,229,32,364
1148409,75,72,147,36,6,3,45,296,148,489
1148410,8,0,8,62,23,0,85,244,43,372
1148411,3,3,6,41,18,0,59,155,26,240
1148412,4,0,4,40,21,3,64,204,13,281
1148413,6,3,9,79,22,6,107,299,48,454
1148414,0,0,0,74,4,0,78,225,35,338
1148415,0,0,0,66,9,0,75,198,51,324
1148416,3,0,3,63,20,0,83,221,42,346
1148417,0,0,0,34,20,0,54,114,15,183
1148418,0,0,0,0,0,0,0,0,0,0
1148419,5,0,5,77,11,0,88,261,38,387
1148420,3,3,6,81,48,3,132,286,18,436
1148421,26,3,29,77,31,0,108,316,36,460
1148422,0,0,0,47,20,0,67,136,13,216
1148423,3,3,6,67,31,0,98,265,40,403
1148424,6,3,9,62,6,0,68,198,42,308
1148425,5,0,5,67,11,3,81,200,36,317
1148426,5,0,5,51,14,0,65,205,25,295
1148427,0,0,0,110,33,0,143,219,9,371
1148428,0,0,0,77,29,0,106,194,18,318
1148429,4,0,4,58,35,3,96,203,19,318
1148430,6,0,6,84,20,0,104,226,18,348
1148431,5,0,5,66,34,0,100,208,26,334
1148432,6,0,6,88,32,0,120,252,10,382
1148433,0,0,0,54,18,0,72,223,15,310
1148434,7,3,10,74,11,0,85,201,33,319
1148435,3,0,3,80,23,9,112,189,35,336
1148436,0,0,0,49,25,0,74,183,31,288
1148437,3,0,3,104,35,10,149,309,39,497
1148438,7,0,7,63,5,3,71,202,21,294
1148439,0,0,0,59,18,6,83,170,9,262
1148440,7,0,7,76,17,0,93,244,50,387
1148441,9,0,9,75,18,0,93,258,32,383
1148442,8,0,8,113,22,0,135,315,47,497
1148501,9,0,9,61,12,3,76,248,15,339
1148502,10,3,13,94,35,9,138,212,6,356
1148503,4,0,4,87,32,0,119,282,54,455
1148504,7,4,11,80,27,6,113,258,39,410
1148505,6,0,6,75,14,0,89,268,15,372
1148506,3,3,6,62,12,0,74,149,18,241
1148507,8,6,14,54,6,0,60,233,34,327
1148508,6,0,6,47,14,0,61,249,51,361
1148509,6,4,10,69,20,0,89,254,41,384
1148510,11,3,14,43,27,3,73,232,28,333
1148511,5,0,5,57,31,10,98,269,24,391
1148512,10,0,10,96,21,0,117,275,37,429
1148513,7,3,10,77,22,0,99,208,30,337
1148514,8,0,11,76,19,3,98,248,28,374
1148515,0,0,0,41,19,0,60,128,16,204
1148516,6,0,6,80,23,0,103,279,55,437
1148517,7,0,7,78,25,3,106,203,19,328
1148518,3,0,3,69,17,0,86,216,24,326
1148519,11,6,17,79,23,4,106,266,29,401
1148520,7,3,10,73,12,0,85,173,14,272
1148521,4,3,7,70,19,0,89,317,12,418
1148522,8,0,8,90,15,5,110,273,12,395
1148523,0,0,0,43,10,0,53,159,36,248
1148524,6,0,6,63,9,0,72,197,68,337
1148525,3,0,3,49,12,0,61,161,28,250
1148526,0,0,0,122,32,3,157,399,105,661
1148527,8,0,8,24,12,3,39,127,24,190
1148528,4,0,4,66,21,0,87,215,40,342
1148529,6,0,6,86,16,0,102,183,49,334
1148530,4,0,4,73,19,3,95,186,30,311
1148531,7,0,7,81,18,3,102,223,34,359
1148532,7,0,7,76,29,0,105,262,19,386
1148533,17,0,17,80,22,0,102,281,23,406
1148534,0,0,0,57,18,0,75,168,23,266
1148535,5,3,8,92,27,0,119,238,43,400
1148536,6,9,15,52,20,0,72,328,33,433
1148537,12,3,15,38,21,0,59,222,18,299
1148538,5,5,10,64,39,3,106,343,30,479
1148539,3,0,3,57,21,3,81,218,33,332
1148540,0,0,0,63,10,0,73,180,39,292
1148541,3,3,6,104,15,0,119,266,35,420
1148542,0,0,0,110,17,0,127,276,34,437
1148543,0,0,0,63,6,3,72,231,20,323
1148544,3,0,3,66,0,0,66,217,31,314
1148545,0,0,0,63,3,0,66,204,31,301
1148546,0,0,0,73,7,0,80,165,29,274
1148547,4,0,4,100,10,0,110,304,101,515
1148548,0,0,0,36,10,0,46,146,55,247
1148549,3,0,3,80,11,0,91,257,76,424
1148550,0,0,0,88,6,0,94,231,34,359
1148551,6,6,12,70,37,0,107,286,27,420
1148552,6,0,6,58,26,0,84,196,12,292
1148553,8,0,8,65,21,3,89,261,20,370
1148554,0,3,3,52,15,0,67,194,36,297
1148555,6,0,6,29,12,6,47,158,21,226
1148556,0,0,0,85,14,0,99,237,32,368
1148557,0,0,0,46,12,0,58,159,30,247
1148558,0,3,3,56,10,0,66,204,75,345
1148601,0,0,0,0,0,0,0,6,0,6
1148701,0,0,0,0,0,0,0,6,0,6
1148801,3,0,3,40,5,0,45,140,11,196
1148802,5,0,5,130,9,0,139,276,22,437
1148803,0,0,0,82,6,3,91,231,27,349
1148804,6,0,6,102,30,0,132,254,53,439
1148805,4,0,4,114,21,0,135,238,34,407
1148806,5,4,9,27,9,3,39,124,28,191
1148807,6,0,6,61,23,4,88,205,36,329
1148808,3,0,3,72,16,3,91,161,9,261
1148809,18,3,21,83,27,0,110,299,31,440
1148810,0,0,0,56,6,3,65,179,16,260
1148811,4,0,10,94,40,0,134,326,30,490
1148812,0,0,0,0,0,0,0,3,0,3
1148813,8,0,8,88,17,0,105,176,25,306
1148814,3,0,3,100,15,0,115,150,25,290
1148815,6,3,9,107,25,6,138,255,22,415
1148816,3,0,3,64,10,3,77,157,16,250
1148817,3,3,6,134,26,3,163,314,30,507
1148818,3,0,3,75,6,0,81,137,43,261
1148819,7,0,7,56,11,0,67,155,21,243
1148820,4,0,4,40,13,0,53,141,18,212
1148821,3,0,6,59,20,0,79,191,24,294
1148822,3,0,3,63,25,0,88,221,31,340
1148823,9,0,9,90,20,0,110,312,18,440
1148824,12,3,15,98,34,6,138,256,24,418
1148825,3,0,3,80,12,0,92,212,31,335
1148826,3,0,3,106,12,0,118,207,38,363
1148827,9,3,15,89,16,6,111,260,48,419
1148828,4,0,4,97,21,3,121,270,41,432
1148829,0,0,0,55,8,0,63,110,3,176
1148830,3,0,3,96,36,0,132,309,32,473
1148831,6,0,6,67,31,0,98,247,19,364
1148832,5,0,5,90,33,0,123,250,18,391
1148833,3,0,3,66,25,0,91,177,17,285
1148834,10,0,10,123,27,0,150,318,41,509
1148835,0,0,0,40,18,3,61,146,13,220
1148836,3,0,3,111,13,0,124,206,29,359
1148837,0,3,3,60,15,0,75,174,51,300
1148838,6,0,6,82,21,0,103,237,30,370
1148839,3,0,3,124,9,0,133,301,48,482
1148840,36,0,36,28,11,0,39,168,11,218
1148841,6,0,6,60,15,0,75,174,27,276
1148842,0,0,0,49,15,3,67,164,6,237
1148843,31,0,31,51,6,0,57,235,28,320
1148844,6,0,6,78,30,0,108,213,55,376
1148845,0,0,0,115,18,4,137,249,64,450
1148846,0,0,0,30,0,3,33,135,21,189
1148847,3,0,3,61,32,3,96,219,11,326
1148848,4,0,4,104,18,0,122,256,49,427
1148849,0,3,3,85,9,0,94,152,39,285
1148850,40,111,151,41,13,0,54,223,190,467
1148851,9,0,9,74,20,0,94,205,36,335
1148852,3,3,6,83,26,3,112,225,66,403
1148853,6,3,9,125,25,3,153,315,38,506
1148854,6,3,9,33,17,3,53,114,20,187
1148855,4,0,4,60,17,3,80,173,20,273
1148856,6,0,6,52,0,0,52,157,3,212
1148857,5,0,5,79,12,0,91,205,20,316
1148858,6,3,9,67,18,0,85,194,25,304
1148859,5,3,8,47,15,6,68,157,24,249
1148860,3,3,6,92,14,0,106,170,27,303
1148861,0,0,0,90,12,0,102,191,37,330
1148862,0,0,0,45,6,3,54,97,34,185
1148901,0,0,0,103,19,0,122,283,45,450
1148902,3,3,6,85,18,0,103,305,38,446
1148903,6,0,6,67,14,0,81,210,10,301
1148904,0,0,0,107,24,5,136,386,40,562
1148905,3,0,3,23,10,0,33,157,15,205
1148906,0,0,0,69,13,0,82,184,25,291
1148907,8,3,11,31,15,0,46,190,58,294
1148908,3,3,6,40,9,0,49,151,21,221
1148909,0,0,0,45,6,0,51,153,14,218
1148910,0,0,0,59,16,3,78,252,30,360
1148911,3,0,3,76,15,3,94,261,60,415
1148912,0,0,0,45,3,0,48,170,44,262
1148913,0,0,0,73,21,0,94,311,45,450
1148914,0,0,0,0,0,0,0,117,432,549
1148915,3,3,6,76,16,3,95,256,27,378
1148916,0,7,7,78,18,0,96,273,36,405
1148917,159,10,172,15,10,0,25,320,28,373
1148918,4,0,4,50,11,0,61,120,12,193
1148919,6,0,6,59,19,3,81,261,32,374
1148920,3,3,6,95,19,3,117,362,27,506
1148921,0,0,0,45,10,0,55,250,38,343
1148922,3,0,3,62,16,0,78,337,50,465
1148923,0,3,3,40,26,0,66,294,96,456
1148924,6,0,6,45,11,3,59,179,24,262
1148925,7,0,7,53,25,0,78,189,27,294
1148926,6,3,9,84,18,0,102,255,53,410
1148927,0,0,0,40,27,3,70,281,10,361
1148928,9,0,9,56,24,0,80,291,45,416
1148929,6,0,6,50,11,0,61,194,21,276
1148930,0,0,0,34,10,0,44,147,20,211
1148931,0,0,0,55,16,4,75,224,32,331
1148932,0,0,0,47,13,0,60,188,35,283
1148933,10,0,10,44,17,3,64,158,27,249
1148934,5,0,5,59,19,0,78,180,34,292
1148935,0,0,0,61,22,4,87,150,29,266
1148936,0,0,0,37,13,0,50,141,7,198
1148937,52,0,55,59,12,0,71,326,31,428
1148938,3,0,3,55,6,0,61,180,12,253
1148939,3,4,7,33,3,0,36,189,7,232
1148940,3,0,3,50,7,6,63,181,21,265
1148941,6,0,6,97,27,3,127,347,56,530
1148942,0,0,0,64,0,4,68,204,35,307
1148943,0,0,0,52,12,0,64,150,6,220
1148944,13,3,19,73,20,0,93,297,29,419
1148945,5,0,5,41,21,0,62,232,13,307
1148946,3,0,3,93,15,0,108,412,43,563
1148947,6,0,6,68,15,0,83,189,17,289
1148948,47,0,47,23,3,0,26,266,22,314
1148949,23,3,26,36,9,0,45,136,15,196
1148950,3,3,6,92,30,0,122,251,24,397
1149001,4,0,4,84,40,6,130,282,10,422
1149002,9,0,9,99,33,0,132,223,22,377
1149003,0,0,0,59,23,0,82,155,6,243
1149004,0,0,0,64,20,0,84,185,15,284
1149005,3,0,3,49,20,0,69,147,12,228
1149006,0,3,3,79,38,0,117,218,19,354
1149007,10,0,10,112,44,4,160,226,9,395
1149008,0,0,0,68,30,3,101,154,9,264
1149009,3,0,3,82,32,3,117,244,13,374
1149010,6,0,6,78,20,3,101,142,18,261
1149011,6,0,6,63,9,0,72,181,15,268
1149012,0,0,0,54,32,0,86,175,8,269
1149013,4,0,4,69,44,0,113,207,28,348
1149014,3,0,3,60,35,0,95,184,3,282
1149015,7,0,7,115,38,8,161,231,6,398
1149016,3,0,6,77,52,7,136,271,15,422
1149017,83,0,83,94,26,6,126,356,15,497
1149018,7,3,10,90,52,3,145,289,12,446
1149101,0,0,0,67,29,0,96,139,6,241
1149102,3,6,9,63,50,7,120,216,23,359
1149103,0,0,0,84,35,7,126,238,18,382
1149104,0,0,0,0,0,0,0,9,0,9
1149105,0,0,0,97,14,0,111,208,20,339
1149106,0,0,0,284,37,4,325,792,53,1170
1149107,0,0,0,154,11,0,165,391,34,590
1149108,3,0,3,137,9,0,146,356,26,528
1149109,14,3,17,103,12,0,115,467,68,650
1149110,11,3,14,33,6,0,39,88,23,150
1149111,0,0,0,115,13,3,131,270,44,445
1149112,0,0,0,56,10,0,66,241,30,337
1149113,3,0,3,68,21,0,89,176,15,280
1149114,6,0,6,77,25,0,102,255,32,389
1149115,3,0,3,139,12,0,151,311,10,472
1149116,66,21,87,114,7,0,121,422,71,614
1149117,7,3,10,101,12,0,113,235,12,360
1149118,5,0,8,105,21,3,129,257,25,411
1149119,0,3,3,58,48,3,109,214,9,332
1149120,72,16,91,51,23,0,74,276,40,390
1149121,3,3,6,59,32,0,91,198,12,301
1149122,6,0,6,70,27,3,100,149,5,254
1149123,4,0,4,80,31,0,111,197,24,332
1149124,7,3,10,61,34,6,101,192,12,305
1149125,7,3,10,61,24,4,89,213,18,320
1149126,0,3,3,56,15,0,71,211,18,300
1149127,0,0,0,0,0,0,0,0,0,0
1149128,0,3,3,53,24,0,77,216,16,309
1149129,8,0,8,129,31,10,170,263,23,456
1149130,6,0,10,79,13,5,97,190,8,295
1149131,9,0,9,146,32,3,181,411,51,643
1149132,0,3,3,179,41,0,220,690,40,950
1149133,4,0,4,126,21,4,151,246,27,424
1149134,3,3,6,46,9,3,58,162,6,226
1149135,10,3,13,97,46,9,152,282,52,486
1149201,31,3,34,86,18,0,104,410,63,577
1149202,5,0,5,53,0,3,56,221,19,296
1149203,4,0,4,65,6,0,71,275,42,388
1149204,0,0,0,231,26,0,257,941,169,1367
1149205,0,0,0,62,6,0,68,158,29,255
1149206,0,0,0,26,0,0,26,108,19,153
1149207,4,0,4,74,6,0,80,229,21,330
1149208,0,0,0,78,12,0,90,248,22,360
1149209,0,0,0,0,0,0,0,0,0,0
1149210,0,0,0,0,0,0,0,9,0,9
1149211,3,0,3,79,27,3,109,346,197,652
1149212,0,0,0,73,18,0,91,173,80,344
1149213,3,0,3,85,10,0,95,196,62,353
1149214,3,0,3,46,20,3,69,185,25,279
1149215,4,0,4,68,15,0,83,278,36,397
1149216,6,0,6,42,4,4,50,157,25,232
1149217,0,0,0,89,14,0,103,269,34,406
1149218,0,0,0,67,6,0,73,163,39,275
1149219,3,0,3,87,18,0,105,335,71,511
1149220,4,0,4,98,6,0,104,263,48,415
1149221,0,0,0,88,4,0,92,223,45,360
1149222,0,3,3,50,0,3,53,118,20,191
1149223,14,0,14,39,9,3,51,224,37,312
1149224,14,3,17,52,0,0,52,197,20,269
1149225,0,0,0,65,13,0,78,192,24,294
1149226,3,0,3,38,15,0,53,129,4,186
1149227,4,0,4,67,15,0,82,257,45,384
1149228,0,0,0,90,0,0,90,361,73,524
1149229,3,0,3,85,10,3,98,282,20,400
1149230,3,0,3,86,4,0,90,227,23,340
1149231,3,0,3,45,7,0,52,269,31,352
1149232,0,3,3,62,9,0,71,377,75,523
1149233,0,0,0,53,23,6,82,268,16,366
1149234,3,0,3,80,18,0,98,350,121,569
1149235,0,0,0,116,14,0,130,487,88,705
1149236,3,0,3,62,3,0,65,245,38,348
1149237,0,0,0,63,4,0,67,271,47,385
1149238,0,3,3,107,11,0,118,175,37,330
1149239,0,0,0,44,3,7,54,93,12,159
1149240,0,0,0,61,4,0,65,197,37,299
1149241,0,0,0,67,20,4,91,219,50,360
1149242,0,0,0,107,17,0,124,404,52,580
1149243,0,0,0,67,12,3,82,192,24,298
1149244,0,0,0,57,7,0,64,258,29,351
1149245,0,0,0,39,21,0,60,192,25,277
1149246,0,0,0,46,7,0,53,230,53,336
1149247,6,0,6,72,25,3,100,219,39,358
1149248,11,0,11,83,27,0,110,306,61,477
1149249,3,0,3,99,18,0,117,271,76,464
1149250,0,0,0,61,13,0,74,228,40,342
1149251,3,0,3,65,8,0,73,253,45,371
1149301,3,0,3,63,17,0,80,151,15,246
1149302,5,0,5,85,44,3,132,217,7,356
1149303,3,0,3,62,22,0,84,258,22,364
1149304,0,0,0,60,31,9,100,218,20,338
1149305,3,0,3,93,16,3,112,206,15,333
1149306,3,0,3,86,30,3,119,233,33,385
1149307,7,0,7,93,38,0,131,319,21,471
1149308,102,93,195,0,42,0,42,469,169,680
1149309,3,0,3,74,37,0,111,239,9,359
1149310,6,0,6,54,21,0,75,204,9,288
1149311,35,0,35,31,12,3,46,254,22,322
1149312,6,0,6,89,32,6,127,323,38,488
1149313,6,0,6,57,9,0,66,255,39,360
1149314,0,0,0,59,27,0,86,164,30,280
1149315,0,0,0,88,37,3,128,301,15,444
1149316,0,0,0,69,29,0,98,183,11,292
1149317,3,0,3,58,27,3,88,297,15,400
1149318,5,3,8,55,17,0,72,141,9,222
1149319,0,0,0,0,3,0,3,0,3,6
1149320,4,0,4,106,34,0,140,241,20,401
1149321,4,0,4,66,29,6,101,194,24,319
1149322,3,6,9,70,23,0,93,190,55,338
1149323,0,0,0,68,23,0,91,226,18,335
1149324,17,3,20,75,43,0,118,270,35,423
1149325,6,6,12,74,14,0,88,230,18,336
1149326,0,0,0,91,19,7,117,106,14,237
1149327,8,0,8,40,17,6,63,112,10,185
1149328,4,0,4,60,27,0,87,134,9,230
1149329,0,0,0,52,16,3,71,254,12,337
1149330,3,3,6,49,12,0,61,184,29,274
1149331,5,0,5,90,15,0,105,242,19,366
1149332,3,0,3,81,17,6,104,228,15,347
1149333,3,3,6,81,21,6,108,167,12,287
1149334,7,6,13,61,30,4,95,243,15,353
1149335,6,3,9,90,35,9,134,304,26,464
1149336,9,0,9,75,19,3,97,293,26,416
1149337,0,0,0,80,21,4,105,217,25,347
1149338,4,0,4,81,30,6,117,217,21,355
1149339,3,0,3,97,37,6,140,208,12,360
1149340,3,0,3,97,32,3,132,314,50,496
1149341,7,0,7,89,30,6,125,308,19,452
1149342,10,0,10,80,24,4,108,318,15,441
1149343,0,0,0,53,16,0,69,137,23,229
1149344,3,3,9,115,45,4,164,340,38,542
1149345,0,3,3,124,45,3,172,343,65,580
1149346,3,3,6,75,31,0,106,212,13,331
1149347,9,0,9,71,29,9,109,230,21,360
1149401,0,0,0,64,32,3,99,202,9,310
1149402,6,0,6,52,14,0,66,133,26,225
1149403,0,0,0,91,13,9,113,165,10,288
1149404,3,0,3,106,30,4,140,231,9,380
1149405,8,0,8,66,31,12,109,260,9,378
1149406,7,0,7,44,25,0,69,155,15,239
1149407,0,0,0,96,38,7,141,186,9,336
1149408,6,0,6,110,43,6,159,307,32,498
1149409,0,0,0,81,30,6,117,226,7,350
1149410,6,0,6,74,42,3,119,174,16,309
1149411,4,0,4,73,44,7,124,213,14,351
1149412,3,0,3,59,22,0,81,176,11,268
1149413,0,4,4,78,29,0,107,162,14,283
1149414,4,0,4,36,16,6,58,129,23,210
1149415,0,0,0,56,31,3,90,153,7,250
1149416,70,42,112,42,13,0,55,256,78,389
1149417,0,0,0,108,35,0,143,223,10,376
1149418,4,0,4,78,43,0,121,200,12,333
1149419,0,0,0,71,23,3,97,133,3,233
1149420,6,0,6,79,34,5,118,202,6,326
1149421,0,0,5,85,43,0,128,255,24,407
1149422,4,0,4,79,18,5,102,140,0,242
1149423,3,0,3,67,21,6,94,185,13,292
1149424,9,3,12,85,35,4,124,183,20,327
1149425,3,0,3,91,57,7,155,239,9,403
1149426,3,0,3,41,21,3,65,115,6,186
1149501,4,0,4,62,15,9,86,261,12,359
1149502,15,3,18,50,7,0,57,258,20,335
1149503,6,0,6,94,18,0,112,324,18,454
1149504,4,3,7,58,19,3,80,233,15,328
1149505,6,3,9,87,18,0,105,254,27,386
1149506,7,0,7,89,16,3,108,379,24,511
1149507,8,0,8,55,32,0,87,200,18,305
1149508,5,5,10,89,27,3,119,337,54,510
1149509,0,0,0,92,13,9,114,239,16,369
1149510,8,0,8,108,28,3,139,333,18,490
1149511,3,0,3,136,19,6,161,327,27,515
1149512,0,0,0,73,17,0,90,203,0,293
1149513,17,0,17,70,41,4,115,291,21,427
1149514,6,0,6,59,32,3,94,259,4,357
1149515,21,0,21,50,35,6,91,288,17,396
1149516,11,0,11,71,21,0,92,213,0,305
1149517,0,0,0,71,44,0,115,253,11,379
1149518,11,0,11,103,12,3,118,284,10,412
1149519,6,0,6,72,12,3,87,208,18,313
1149520,22,0,22,54,18,0,72,239,6,317
1149521,6,0,6,64,28,0,92,165,10,267
1149522,5,0,5,59,12,0,71,200,3,274
1149523,9,0,9,106,20,6,132,268,15,415
1149524,10,0,10,103,27,6,136,308,27,471
1149525,11,0,11,44,23,0,67,236,13,316
1149526,13,4,17,80,25,0,105,280,16,401
1149527,0,0,0,82,28,0,110,191,3,304
1149528,10,3,13,82,31,4,117,249,24,390
1149529,7,0,7,87,27,0,114,255,9,378
1149530,8,0,8,84,16,0,100,313,28,441
1149531,5,3,11,83,29,3,115,275,35,425
1149532,8,0,8,71,21,0,92,237,16,345
1149533,15,3,18,42,27,0,69,249,12,330
1149534,10,0,10,81,17,6,104,287,15,406
1149535,3,0,3,35,11,3,49,175,15,239
1149536,0,0,0,33,15,0,48,193,12,253
1149537,7,0,7,40,16,3,59,221,9,289
1149538,6,0,6,56,15,4,75,154,6,235
1149539,3,0,3,89,30,7,126,306,8,440
1149540,3,3,6,79,14,3,96,216,11,323
1149541,6,0,6,78,27,9,114,153,15,282
1149542,11,0,11,110,50,11,171,290,17,478
1149543,6,0,6,58,12,6,76,184,0,260
1149544,0,0,0,72,26,6,104,181,6,291
1149545,0,0,0,65,24,3,92,140,3,235
1149546,6,0,6,96,46,5,147,266,18,431
1149547,8,0,8,41,8,0,49,92,18,159
1149548,0,0,0,53,14,0,67,131,6,204
1149549,0,0,0,44,22,0,66,121,0,187
1149550,6,3,9,46,29,3,78,224,10,312
1149551,5,0,5,53,16,4,73,209,9,291
1149552,16,0,16,66,18,7,91,197,9,297
1149553,3,0,6,61,30,0,91,208,18,317
1149554,6,3,9,84,24,0,108,231,12,351
1149555,3,0,3,44,11,4,59,144,4,207
1149556,6,0,6,44,12,0,56,127,3,186
1149557,8,0,8,33,9,0,42,172,6,220
1149558,0,0,0,19,9,0,28,106,3,137
1149601,3,0,3,83,28,0,111,221,9,341
1149602,20,8,28,46,21,0,67,150,30,247
1149603,0,0,0,57,23,0,80,183,12,275
1149604,3,0,3,59,18,6,83,200,6,289
1149605,6,0,6,39,18,3,60,118,6,184
1149606,5,0,5,68,13,4,85,190,6,281
1149607,0,0,0,49,23,4,76,172,14,262
1149608,8,0,8,85,25,6,116,260,9,385
1149609,4,0,4,54,28,3,85,190,3,278
1149610,4,0,4,98,28,5,131,185,14,330
1149611,0,0,0,0,0,0,0,0,0,0
1149612,0,0,0,0,0,0,0,7,0,7
1149613,9,0,9,51,9,3,63,122,15,200
1149614,6,0,6,76,47,0,123,272,9,404
1149615,6,0,6,102,42,4,148,194,10,352
1149616,3,6,9,43,22,0,65,171,10,246
1149617,57,3,60,48,28,0,76,325,19,420
1149618,7,0,7,114,36,6,156,341,40,537
1149619,7,4,11,81,20,4,105,175,8,288
1149620,23,0,23,55,20,3,78,210,5,293
1149621,7,6,13,83,25,6,114,242,15,371
1149622,10,0,10,97,47,0,144,314,12,470
1149623,9,3,12,76,33,3,112,240,12,364
1149624,3,0,3,76,49,4,129,275,6,410
1149625,0,0,0,41,8,0,49,169,19,237
1149626,3,0,3,28,18,0,46,153,12,211
1149627,12,3,15,96,47,10,153,309,37,499
1149628,28,3,34,107,33,6,146,337,16,499
1149629,119,3,125,44,40,0,84,304,12,400
1149630,9,0,12,82,37,0,119,229,4,352
1149631,3,0,6,60,36,6,102,273,4,379
1149632,9,3,12,80,35,4,119,249,12,380
1149633,9,0,9,86,19,0,105,216,10,331
1149634,0,0,0,82,31,0,113,162,5,280
1149635,5,0,5,84,42,6,132,253,3,388
1149636,6,0,6,50,16,3,69,147,3,219
1149637,0,3,3,99,21,3,123,183,18,324
1149638,0,0,0,93,29,3,125,197,18,340
1149639,6,0,6,44,17,9,70,109,6,185
1149640,0,0,0,69,30,3,102,196,15,313
1149641,7,0,7,99,23,0,122,224,11,357
1149642,5,0,5,69,34,6,109,227,6,342
1149643,0,0,0,74,45,4,123,212,6,341
1149644,0,0,0,69,22,0,91,182,18,291
1149645,4,0,4,40,26,0,66,143,12,221
1149646,9,0,9,80,27,0,107,264,12,383
1149647,16,0,16,98,46,12,156,331,6,493
1149648,0,0,0,57,35,3,95,201,9,305
1149649,8,0,8,65,18,3,86,152,0,238
1149650,6,0,6,38,23,0,61,170,6,237
1149701,9,0,9,74,20,3,97,290,22,409
1149702,9,0,9,76,31,3,110,236,12,358
1149703,11,0,11,82,33,0,115,214,15,344
1149704,12,0,12,98,24,3,125,278,7,410
1149705,16,0,16,75,30,3,108,333,11,452
1149706,8,0,8,97,6,0,103,360,89,552
1149707,0,0,0,66,13,0,79,284,35,398
1149708,9,6,15,59,32,0,91,272,39,402
1149709,7,3,10,37,8,0,45,151,12,208
1149710,3,0,3,52,41,6,99,211,25,335
1149711,4,0,4,79,19,0,98,213,26,337
1149712,15,0,15,94,18,0,112,242,27,381
1149713,4,6,10,68,39,6,113,259,26,398
1149714,3,0,3,36,15,6,57,126,12,195
1149715,7,0,7,72,11,0,83,212,13,308
1149716,11,4,15,66,14,0,80,246,10,336
1149717,13,3,16,138,18,0,156,434,39,629
1149718,10,3,13,56,16,3,75,144,22,241
1149719,6,0,6,51,17,6,74,243,18,335
1149720,5,0,5,79,12,0,91,315,39,445
1149721,4,0,4,55,5,0,60,274,54,388
1149722,6,3,9,72,23,0,95,223,12,330
1149723,12,4,16,31,10,4,45,197,23,265
1149724,0,0,0,72,20,6,98,279,16,393
1149725,16,0,16,109,40,0,149,269,18,436
1149726,12,0,12,101,23,3,127,275,23,425
1149727,4,0,4,49,5,0,54,222,21,297
1149728,0,0,0,76,15,12,103,244,12,359
1149729,14,6,20,91,34,3,128,284,30,442
1149730,3,0,3,71,19,6,96,255,32,383
1149731,5,0,5,77,24,9,110,211,9,330
1149732,3,0,3,68,35,6,109,188,7,304
1149733,8,3,11,47,26,0,73,190,6,269
1149734,9,3,15,68,43,3,114,269,10,393
1149735,6,0,6,72,25,9,106,245,33,384
1149736,5,3,8,62,27,3,92,244,28,364
1149737,8,0,8,84,33,3,120,362,30,512
1149738,10,0,10,77,25,3,105,225,8,338
1149739,12,3,15,96,40,9,145,260,21,426
1149740,9,0,9,81,9,4,94,185,17,296
1149741,3,0,3,65,15,0,80,161,3,244
1149742,9,0,9,93,29,4,126,254,21,401
1149743,6,6,12,89,38,5,132,274,14,420
1149744,4,0,4,87,21,6,114,198,5,317
1149745,6,6,12,106,14,5,125,234,21,380
1149746,7,3,10,40,25,3,68,123,6,197
1149747,6,7,13,38,31,0,69,218,18,305
1149748,6,0,6,36,12,6,54,123,9,186
1149749,6,0,6,37,9,0,46,103,6,155
1149750,14,0,14,100,19,7,126,246,23,395
1149751,0,0,0,96,10,0,106,330,14,450
1149752,0,0,0,46,0,6,52,240,21,313
1149753,7,0,7,48,24,3,75,151,10,236
1149754,0,3,3,32,8,3,43,147,23,213
1149801,68,6,78,38,25,0,63,247,25,335
1149802,3,0,3,78,19,0,97,337,33,467
1149803,5,0,5,76,45,0,121,228,9,358
1149804,6,3,9,64,12,6,82,149,15,246
1149805,3,0,6,94,21,6,121,190,9,320
1149806,3,6,9,104,38,0,142,195,24,361
1149807,7,0,7,53,27,0,80,199,17,296
1149808,4,0,4,4,9,0,13,105,9,127
1149809,6,0,6,66,24,0,90,196,14,300
1149810,12,0,12,87,73,6,166,461,36,663
1149811,0,0,0,22,3,0,25,40,3,68
1149812,16,6,22,69,25,6,100,283,27,410
1149813,6,3,9,111,35,7,153,219,11,383
1149814,5,5,10,91,11,6,108,170,24,302
1149815,4,0,4,37,13,3,53,124,12,189
1149816,4,0,4,48,9,0,57,318,12,387
1149817,10,3,13,85,36,0,121,260,33,414
1149818,4,0,4,74,12,6,92,210,18,320
1149819,0,3,3,48,15,4,67,273,18,358
1149820,10,0,10,96,30,9,135,207,12,354
1149821,3,0,3,54,11,6,71,134,12,217
1149822,8,0,8,60,17,0,77,166,9,252
1149823,6,3,9,26,18,0,44,145,15,204
1149824,3,0,3,81,25,3,109,238,17,364
1149825,8,0,8,44,20,3,67,159,18,244
1149826,6,0,6,37,15,3,55,283,7,345
1149827,3,3,6,76,26,3,105,161,12,278
1149828,7,3,10,74,14,3,91,145,9,245
1149829,13,0,13,92,30,3,125,196,16,337
1149830,6,3,12,96,26,6,128,206,16,350
1149831,6,3,9,74,20,8,102,282,22,406
1149832,0,0,0,65,16,0,81,92,3,176
1149833,9,0,9,89,30,6,125,233,22,380
1149834,5,0,5,75,16,5,96,144,29,269
1149835,3,0,3,39,6,0,45,179,12,236
1149901,15,3,18,68,19,4,91,170,17,278
1149902,24,6,30,89,25,7,121,195,22,338
1149903,8,0,8,93,27,0,120,170,22,312
1149904,9,0,9,103,33,0,136,269,30,435
1149905,62,0,62,47,11,0,58,260,18,336
1149906,11,0,11,77,29,0,106,172,14,292
1149907,13,3,16,90,30,5,125,228,9,362
1149908,0,0,0,4,32,0,36,360,19,415
1149909,9,0,9,59,18,3,80,151,15,246
1149910,7,0,7,71,23,3,97,216,6,319
1149911,11,5,16,84,28,4,116,312,14,442
1149912,7,0,7,109,19,9,137,189,12,338
1149913,195,23,218,39,15,0,54,366,34,454
1149914,4,0,4,52,20,0,72,153,23,248
1149915,21,11,32,50,33,0,83,232,41,356
1149916,13,0,13,58,33,3,94,219,18,331
1149917,3,0,3,33,10,0,43,116,3,162
1149918,11,0,11,96,24,0,120,183,3,306
1149919,6,0,6,54,63,4,121,270,28,419
1149920,6,6,12,71,14,3,88,190,9,287
1149921,6,3,9,59,21,0,80,132,15,227
1149922,5,0,5,107,22,5,134,201,22,357
1149923,9,3,12,42,17,3,62,141,18,221
1149924,58,5,67,26,36,0,62,311,22,395
1150001,0,0,0,0,0,0,0,14,0,14
1150002,0,0,0,3,0,0,3,4,0,7
1150003,4,0,4,66,48,3,117,336,38,491
1150004,0,0,0,39,9,0,48,279,19,346
1150005,0,0,0,37,3,9,49,144,0,193
1150006,4,0,4,115,16,6,137,379,6,522
1150007,3,0,3,79,24,0,103,438,32,573
1150008,4,0,4,32,9,0,41,106,6,153
1150009,7,0,7,89,24,6,119,382,18,519
1150010,6,3,9,83,17,4,104,291,21,416
1150011,8,3,11,125,29,0,154,372,26,552
1150012,49,8,57,26,16,0,42,243,16,301
1150013,6,0,6,119,33,0,152,425,19,596
1150014,0,0,0,55,3,0,58,254,7,319
1150015,0,0,0,99,19,6,124,324,23,471
1150016,0,0,0,43,7,4,54,211,24,289
1150017,6,0,6,104,14,0,118,354,23,495
1150018,3,0,3,104,30,6,140,391,20,551
1150019,3,0,3,129,11,3,143,306,15,464
1150020,3,0,3,49,13,6,68,199,21,288
1150021,179,72,251,17,5,0,22,352,112,486
1150022,0,0,0,4,28,0,32,291,34,357
1150023,43,10,53,31,6,0,37,270,32,339
1150024,0,0,0,3,6,0,9,400,176,585
1150025,6,0,6,60,30,0,90,280,21,391
1150026,6,0,6,45,21,3,69,320,32,421
1150027,16,0,16,46,8,0,54,407,29,490
1150028,3,0,3,60,11,0,71,346,28,445
1150029,3,0,3,44,6,0,50,240,22,312
1150030,5,0,5,24,15,6,45,236,10,291
1150031,10,3,13,58,27,0,85,273,40,398
1150032,3,0,3,46,20,3,69,198,26,293
1150033,0,0,0,90,20,0,110,461,65,636
1150034,6,0,6,68,9,0,77,195,12,284
1150035,0,3,3,30,7,0,37,121,3,161
1150036,7,0,7,65,34,0,99,330,40,469
1150037,0,6,6,45,17,0,62,246,12,320
1150038,56,0,56,25,5,0,30,370,25,425
1150039,3,0,3,40,20,0,60,268,36,364
1150040,41,13,54,31,34,0,65,239,51,355
1150041,8,0,8,40,16,0,56,305,42,403
1150042,8,6,14,29,3,0,32,167,18,217
1150043,7,0,7,48,18,0,66,260,28,354
1150101,4,0,4,72,16,3,91,285,17,393
1150102,3,3,6,88,19,3,110,272,16,398
1150103,6,0,6,58,28,3,89,125,6,220
1150104,10,3,13,91,28,0,119,306,30,455
1150105,14,0,14,96,27,4,127,304,23,454
1150106,6,3,9,61,18,3,82,213,22,317
1150107,3,0,3,91,36,11,138,283,23,444
1150108,9,0,9,64,15,0,79,140,13,232
1150109,11,3,14,74,19,6,99,256,18,373
1150110,17,3,20,67,30,6,103,320,42,465
1150111,9,0,9,79,22,0,101,226,15,342
1150112,49,0,49,41,19,0,60,170,3,233
1150113,9,3,12,63,27,0,90,229,26,345
1150114,0,0,0,0,0,0,0,0,0,0
1150115,24,3,27,109,30,0,139,280,28,447
1150116,20,4,27,64,28,3,95,243,19,357
1150117,11,0,14,46,20,0,66,189,12,267
1150118,6,3,9,73,14,0,87,151,21,259
1150119,0,3,3,0,3,0,3,177,48,228
1150120,3,3,6,37,10,0,47,129,12,188
1150121,4,0,4,89,19,0,108,152,30,290
1150122,8,0,8,87,13,3,103,187,3,293
1150123,13,3,16,82,35,9,126,287,52,465
1150124,8,0,8,77,25,6,108,197,15,320
1150125,0,0,0,0,0,0,0,0,0,0
1150126,0,0,0,43,24,3,70,105,20,195
1150127,0,0,0,3,3,0,6,18,20,44
1150128,15,0,15,100,34,9,143,215,17,375
1150129,0,0,0,67,14,0,81,145,9,235
1150130,8,3,11,90,18,0,108,170,9,287
1150131,6,0,6,89,22,3,114,267,18,399
1150132,8,0,8,71,22,0,93,300,18,411
1150201,9,0,9,60,22,6,88,256,18,362
1150202,9,28,37,37,12,0,49,182,71,302
1150203,11,0,11,120,24,0,144,284,29,457
1150204,7,3,10,83,29,3,115,290,22,427
1150205,6,0,6,73,17,0,90,239,23,352
1150206,5,0,5,55,22,3,80,173,23,276
1150207,9,0,9,78,19,3,100,245,13,358
1150208,10,0,10,40,15,3,58,191,18,267
1150209,6,4,10,48,23,3,74,171,15,260
1150210,4,0,4,47,23,0,70,161,17,248
1150211,6,0,6,67,12,0,79,340,27,446
1150212,8,3,11,94,21,3,118,239,21,378
1150213,0,0,0,54,12,0,66,256,34,356
1150214,6,0,6,65,11,0,76,328,48,452
1150215,16,3,19,103,36,3,142,344,21,507
1150216,7,0,7,60,16,0,76,111,8,195
1150217,3,0,3,59,18,0,77,155,15,247
1150218,6,4,10,60,10,3,73,204,17,294
1150219,0,3,3,54,20,6,80,140,9,229
1150220,8,4,12,94,25,0,119,229,17,365
1150221,9,0,9,61,37,0,98,191,4,293
1150222,3,0,3,71,13,0,84,171,21,276
1150223,11,0,11,62,25,5,92,172,8,272
1150224,110,12,122,0,6,0,6,231,19,256
1150225,4,3,7,63,18,0,81,177,14,272
1150226,0,0,0,52,15,3,70,270,12,352
1150227,11,4,15,96,31,3,130,306,20,456
1150228,5,3,8,83,25,3,111,256,14,381
1150229,6,0,6,57,16,0,73,179,18,270
1150230,5,0,5,98,25,0,123,232,27,382
1150231,11,6,17,75,29,4,108,225,33,366
1150232,7,0,7,95,26,3,124,248,33,405
1150233,3,4,7,33,5,5,43,153,14,210
1150234,8,0,8,85,37,0,122,316,29,467
1150235,45,0,45,74,16,3,93,236,16,345
1150236,9,3,12,63,20,3,86,227,12,325
1150237,6,0,6,100,28,0,128,254,12,394
1150238,6,0,6,116,32,12,160,271,27,458
1150239,6,3,9,113,31,8,152,284,9,445
1150240,6,3,9,95,24,6,125,229,20,374
1150241,15,6,21,87,32,10,129,237,35,401
1150242,7,3,10,70,29,0,99,265,24,388
1150243,6,0,6,44,11,0,55,281,10,346
1150244,7,0,7,97,28,0,125,231,7,363
1150245,16,0,16,127,25,3,155,340,25,520
1150246,11,0,11,103,29,0,132,290,15,437
1150247,8,4,12,122,15,9,146,317,18,481
1150248,0,0,0,73,15,0,88,326,29,443
1150249,0,0,0,58,6,0,64,232,21,317
1150250,6,0,6,56,20,0,76,286,28,390
1150251,4,0,4,64,19,0,83,194,15,292
1150252,10,0,10,110,27,0,137,297,24,458
1150253,0,3,3,213,51,0,264,915,115,1294
1150254,26,0,26,97,15,11,123,232,9,364
1150255,3,0,3,53,28,6,87,173,15,275
1150256,5,4,9,96,34,0,130,240,23,393
1150257,8,0,8,92,30,4,126,295,18,439
1150301,0,0,0,26,7,0,33,47,9,89
1150302,0,0,0,37,12,9,58,218,25,301
1150303,10,0,10,72,20,3,95,229,24,348
1150304,3,0,3,75,20,0,95,229,18,342
1150305,11,3,14,59,11,0,70,193,21,284
1150306,6,0,6,105,13,6,124,242,19,385
1150307,6,0,6,98,20,7,125,375,31,531
1150308,6,0,6,87,19,0,106,243,26,375
1150309,7,0,11,95,39,4,138,291,21,450
1150310,3,3,6,51,18,0,69,299,31,399
1150311,7,3,10,83,23,0,106,253,9,368
1150312,14,0,14,78,26,0,104,276,27,407
1150313,6,0,6,32,10,0,42,173,6,221
1150314,3,3,6,100,18,4,122,455,51,628
1150315,3,0,3,97,3,0,100,333,46,479
1150316,8,0,8,60,22,0,82,161,6,249
1150317,22,19,41,30,6,0,36,141,38,215
1150318,4,0,4,56,5,0,61,174,11,246
1150319,3,0,3,81,18,0,99,430,38,567
1150320,6,0,6,86,19,6,111,235,21,367
1150321,0,0,0,39,10,0,49,72,0,121
1150322,4,3,7,67,10,0,77,175,9,261
1150323,3,3,6,86,23,0,109,287,9,405
1150324,11,3,14,88,15,0,103,360,35,498
1150325,3,0,3,42,3,3,48,113,0,161
1150326,5,0,5,52,13,0,65,327,22,414
1150327,7,0,7,84,18,0,102,272,12,386
1150328,0,0,0,108,23,3,134,249,32,415
1150329,0,0,0,0,0,0,0,0,0,0
1150330,0,0,0,42,12,0,54,306,37,397
1150331,0,3,3,37,12,3,52,177,34,263
1150332,0,0,0,175,45,0,220,954,97,1271
1150333,9,0,9,115,22,6,143,219,16,378
1150334,0,0,0,87,6,0,93,307,17,417
1150335,3,0,6,65,37,3,105,295,41,441
1150336,9,0,9,84,30,0,114,280,41,435
1150337,3,3,6,115,36,0,151,280,33,464
1150338,5,0,5,88,6,4,98,226,18,342
1150401,6,0,6,78,29,0,107,304,42,453
1150402,0,0,0,50,18,0,68,160,22,250
1150403,4,0,4,52,18,3,73,223,60,356
1150404,0,0,0,37,15,0,52,159,21,232
1150405,0,3,3,20,13,0,33,120,34,187
1150406,6,0,6,88,41,0,129,286,53,468
1150407,3,0,3,65,9,0,74,149,36,259
1150408,0,0,0,59,12,0,71,154,60,285
1150409,0,0,0,52,14,0,66,171,24,261
1150410,0,0,0,47,11,3,61,153,47,261
1150411,0,0,0,60,21,0,81,233,53,367
1150412,3,0,3,68,9,0,77,187,68,332
1150413,0,0,0,51,15,3,69,232,63,364
1150414,6,0,6,50,14,0,64,185,24,273
1150415,3,0,3,52,26,0,78,170,42,290
1150416,3,0,3,21,0,0,21,162,47,230
1150417,4,3,7,43,20,3,66,216,43,325
1150418,4,0,4,55,19,4,78,256,32,366
1150419,0,3,3,54,11,4,69,191,27,287
1150420,0,0,0,60,19,0,79,189,42,310
1150421,6,3,9,23,15,3,41,195,27,263
1150422,3,4,7,73,15,0,88,296,62,446
1150423,0,3,3,77,19,6,102,183,58,343
1150424,3,3,6,103,23,4,130,350,46,526
1150425,3,0,3,60,7,0,67,244,29,340
1150426,3,0,3,48,9,3,60,152,29,241
1150427,0,0,0,41,8,0,49,139,69,257
1150428,3,0,3,66,9,0,75,258,109,442
1150429,0,0,0,71,17,6,94,244,80,418
1150430,0,0,0,48,16,3,67,198,52,317
1150431,0,0,0,0,0,0,0,0,3,3
1150432,0,3,3,37,11,0,48,91,22,161
1150433,0,0,0,41,13,0,54,158,39,251
1150434,0,4,4,65,9,0,74,195,55,324
1150435,3,0,3,22,7,0,29,107,27,163
1150436,0,0,0,37,4,0,41,104,6,151
1150437,0,0,0,41,9,0,50,129,24,203
1150438,3,0,3,107,18,4,129,293,74,496
1150439,6,0,6,82,17,3,102,270,35,407
1150440,3,0,3,38,23,0,61,142,18,221
1150441,4,0,4,73,22,3,98,247,38,383
1150501,3,0,3,62,18,0,80,247,82,409
1150502,6,3,9,68,18,0,86,150,35,271
1150503,61,42,103,28,19,3,50,225,115,390
1150504,12,3,15,103,28,0,131,288,37,456
1150505,6,0,6,84,40,0,124,276,42,442
1150506,0,0,0,53,13,0,66,155,12,233
1150507,0,0,0,38,18,0,56,96,24,176
1150508,6,0,6,43,23,0,66,144,40,250
1150509,4,0,4,79,31,3,113,275,53,441
1150510,3,0,3,58,18,0,76,271,43,390
1150511,0,0,0,85,40,3,128,282,37,447
1150512,0,3,3,63,25,0,88,174,18,280
1150513,6,0,6,59,25,3,87,219,35,341
1150514,0,0,0,54,23,3,80,155,30,265
1150515,0,0,0,57,30,3,90,210,67,367
1150516,0,0,0,76,33,12,121,239,28,388
1150517,0,0,0,37,19,0,56,144,32,232
1150518,3,0,3,78,30,12,120,247,62,429
1150519,3,0,3,112,27,10,149,337,62,548
1150520,0,0,0,163,22,4,189,320,45,554
1150521,0,0,0,48,16,0,64,185,24,273
1150522,3,0,3,34,13,0,47,168,22,237
1150601,3,0,3,56,28,0,84,167,46,297
1150602,0,0,0,33,17,0,50,89,25,164
1150603,4,3,7,47,21,3,71,219,27,317
1150604,3,0,3,75,24,0,99,275,45,419
1150605,11,3,14,121,44,3,168,339,23,530
1150606,7,0,7,50,13,0,63,171,30,264
1150607,3,0,3,21,16,0,37,158,18,213
1150608,0,0,0,15,12,0,27,57,9,93
1150609,6,0,6,52,21,0,73,194,29,296
1150610,0,0,0,38,17,0,55,174,16,245
1150611,0,0,0,41,32,0,73,191,57,321
1150612,0,5,5,55,22,0,77,177,19,273
1150613,3,0,3,49,24,0,73,144,32,249
1150614,0,0,0,62,14,0,76,137,27,240
1150615,3,3,6,37,18,0,55,150,57,262
1150616,0,0,0,47,21,3,71,177,19,267
1150617,6,0,6,39,13,0,52,196,49,297
1150618,4,0,4,72,33,0,105,246,39,390
1150701,6,0,6,113,23,5,141,282,35,458
1150702,0,0,0,53,12,0,65,139,14,218
1150703,0,0,0,80,26,6,112,214,27,353
1150704,4,0,4,82,9,0,91,226,31,348
1150705,0,0,0,31,6,0,37,78,12,127
1150706,0,0,0,43,5,6,54,110,4,168
1150707,0,0,0,0,0,0,0,0,0,0
1150708,5,0,5,71,10,0,81,198,3,282
1150709,3,0,3,47,18,0,65,197,6,268
1150710,0,0,0,125,22,0,147,239,25,411
1150711,3,0,3,44,7,0,51,132,6,189
1150712,0,0,0,57,10,0,67,159,12,238
1150713,0,0,0,93,17,0,110,260,56,426
1150714,3,0,3,100,24,0,124,239,32,395
1150715,4,0,4,91,20,4,115,228,9,352
1150716,0,0,0,85,34,4,123,265,15,403
1150717,0,0,0,60,25,0,85,218,25,328
1150718,0,0,0,104,18,0,122,260,40,422
1150719,0,0,0,75,25,6,106,246,23,375
1150720,4,0,4,55,18,0,73,197,24,294
1150721,0,0,0,114,30,4,148,275,29,452
1150722,3,0,3,56,13,0,69,176,9,254
1150723,3,0,3,79,23,0,102,213,28,343
1150724,3,0,3,96,20,0,116,292,32,440
1150725,3,0,3,79,42,7,128,259,6,393
1150726,6,0,9,64,6,3,73,159,16,248
1150727,0,0,0,87,13,0,100,274,51,425
1150728,0,0,0,57,18,0,75,211,28,314
1150729,0,0,0,118,22,0,140,299,15,454
1150730,0,0,0,21,0,0,21,71,3,95
1150731,3,0,3,51,18,0,69,144,0,213
1150732,0,0,0,48,14,0,62,144,13,219
1150733,0,0,0,40,15,0,55,152,9,216
1150734,3,0,3,64,11,0,75,131,15,221
1150735,0,0,0,71,13,3,87,216,43,346
1150736,0,0,0,63,20,4,87,211,31,329
1150737,0,0,0,46,5,0,51,163,27,241
1150738,3,0,3,44,15,3,62,104,10,176
1150739,3,0,3,63,14,0,77,272,26,375
1150740,3,0,3,78,19,0,97,217,28,342
1150741,0,0,0,79,15,9,103,213,24,340
1150742,0,0,0,69,17,0,86,167,3,256
1150743,0,0,0,48,13,3,64,128,14,206
1150744,0,0,0,38,20,0,58,123,9,190
1150745,8,4,12,86,42,3,131,254,53,438
1150746,0,0,0,39,17,3,59,143,30,232
1150747,7,0,7,65,31,0,96,268,37,401
1150748,0,0,0,102,26,0,128,283,33,444
1150749,0,0,0,63,16,0,79,189,4,272
1150750,0,3,3,85,27,3,115,243,27,385
1150751,0,0,0,54,6,0,60,195,14,269
1150752,0,0,0,108,24,0,132,244,38,414
1150753,4,0,4,106,24,0,130,212,23,365
1150754,0,0,0,67,19,4,90,233,18,341
1150755,3,0,3,79,12,0,91,225,15,331
1150756,0,0,0,55,12,0,67,130,9,206
1150757,0,0,0,57,12,0,69,142,6,217
1150758,0,0,0,99,18,0,117,235,10,362
1150759,0,0,0,78,26,0,104,239,28,371
1150760,0,0,0,53,9,0,62,137,27,226
1150761,3,0,3,77,28,0,105,246,29,380
1150762,4,0,4,45,13,0,58,176,6,240
1150763,0,0,0,68,11,0,79,189,16,284
1150764,4,0,4,60,7,4,71,217,6,294
1150765,0,0,0,116,34,0,150,324,18,492
1150766,4,0,4,55,7,0,62,172,28,262
1150767,0,0,0,79,14,0,93,223,26,342
1150768,0,0,0,56,13,6,75,152,6,233
1150769,6,4,10,42,10,0,52,188,17,257
1150770,0,0,0,104,32,0,136,324,39,499
1150771,0,3,3,41,24,6,71,170,18,259
1150801,0,0,0,82,15,3,100,180,13,293
1150802,3,0,3,164,41,0,205,400,22,627
1150803,0,0,0,176,22,3,201,330,21,552
1150804,0,0,0,70,15,0,85,108,3,196
1150805,0,0,0,94,35,6,135,238,16,389
1150806,0,0,0,97,26,0,123,228,30,381
1150807,3,0,3,107,24,3,134,287,17,438
1150808,3,0,3,110,15,0,125,216,25,366
1150809,6,0,6,98,16,0,114,244,18,376
1150810,4,0,4,75,16,0,91,240,29,360
1150811,3,0,3,109,35,6,150,217,23,390
1150812,3,0,3,135,27,3,165,305,28,498
1150813,0,0,0,126,25,4,155,253,15,423
1150814,0,0,0,104,24,0,128,240,16,384
1150815,0,0,0,54,6,0,60,125,18,203
1150816,0,0,0,69,9,0,78,140,27,245
1150817,0,0,0,74,18,0,92,172,5,269
1150818,0,0,0,71,9,4,84,158,12,254
1150819,7,0,7,78,23,0,101,275,27,403
1150820,3,0,3,103,35,6,144,216,26,386
1150821,0,0,0,99,21,0,120,194,25,339
1150822,6,0,6,49,18,0,67,141,8,216
1150823,0,0,0,82,18,0,100,187,17,304
1150824,3,0,3,74,19,0,93,182,40,315
1150825,0,0,0,67,15,3,85,153,17,255
1150826,0,0,0,100,12,3,115,214,18,347
1150827,3,0,3,92,18,0,110,170,35,315
1150828,0,0,0,117,26,6,149,260,24,433
1150829,0,0,0,79,27,0,106,196,34,336
1150830,0,0,0,70,20,0,90,173,27,290
1150831,0,0,0,91,38,3,132,164,11,307
1150832,0,0,0,237,30,4,271,378,49,698
1150833,0,0,0,100,20,3,123,187,18,328
1150834,0,0,0,116,22,0,138,164,22,324
1150835,0,3,3,43,24,0,67,130,19,216
1150836,0,0,0,121,18,3,142,188,34,364
1150837,0,0,0,71,5,0,76,144,13,233
1150838,0,0,0,54,9,3,66,179,25,270
1150839,0,0,0,102,8,3,113,166,21,300
1150901,3,0,3,35,4,0,39,121,6,166
1150902,3,0,3,112,36,3,151,306,20,477
1150903,3,0,3,67,21,0,88,255,13,356
1150904,0,0,0,58,18,0,76,258,19,353
1150905,0,0,0,68,16,4,88,228,18,334
1150906,0,0,0,58,19,3,80,311,31,422
1150907,3,0,3,91,16,0,107,295,30,432
1150908,0,3,3,76,19,0,95,265,33,393
1150909,6,0,6,104,46,3,153,382,39,574
1150910,4,0,4,78,22,4,104,287,27,418
1150911,0,0,0,71,15,3,89,260,27,376
1150912,0,0,0,50,13,0,63,262,32,357
1150913,3,0,3,69,30,0,99,299,34,432
1150914,4,0,4,55,31,0,86,202,7,295
1150915,6,3,9,85,28,0,113,355,19,487
1150916,3,0,3,57,13,0,70,157,7,234
1150917,4,0,4,56,18,0,74,163,20,257
1150918,0,0,0,40,20,0,60,200,18,278
1150919,0,0,0,76,26,3,105,310,29,444
1150920,3,0,6,100,36,0,136,316,25,477
1150921,0,0,0,47,18,0,65,158,21,244
1150922,4,0,4,54,26,0,80,233,18,331
1150923,6,0,6,70,3,0,73,185,3,261
1150924,3,0,3,56,10,0,66,193,21,280
1150925,0,0,0,61,35,6,102,270,26,398
1150926,3,0,3,36,13,0,49,123,12,184
1150927,21,0,21,58,17,0,75,183,7,265
1150928,0,0,0,3,0,0,3,19,0,22
1150929,3,3,9,67,30,0,97,212,37,346
1150930,3,0,3,49,22,3,74,196,26,296
1150931,6,0,6,39,19,0,58,173,27,258
1150932,5,0,5,47,21,0,68,192,27,287
1150933,3,0,3,83,22,0,105,199,32,336
1150934,3,0,3,34,12,0,46,104,26,176
1150935,11,3,14,65,14,4,83,249,52,384
1150936,7,0,7,50,28,3,81,333,62,476
1151001,3,0,3,69,35,0,104,277,23,404
1151002,0,0,0,47,20,0,67,174,8,249
1151003,0,3,3,50,12,3,65,168,21,254
1151004,0,35,35,61,16,0,77,258,92,427
1151005,4,0,4,65,41,0,106,316,13,435
1151006,3,0,3,83,23,4,110,313,24,447
1151007,0,4,4,75,13,3,91,295,15,401
1151008,6,0,6,42,18,0,60,208,14,282
1151009,0,0,0,51,27,0,78,244,12,334
1151010,0,0,0,22,11,0,33,152,6,191
1151011,4,0,4,41,22,0,63,178,24,265
1151012,0,0,0,50,15,0,65,161,10,236
1151013,5,0,5,69,18,0,87,163,12,262
1151014,4,0,4,61,30,0,91,278,25,394
1151015,0,0,0,35,30,0,65,173,10,248
1151016,6,0,6,55,19,0,74,232,24,330
1151017,0,0,0,83,19,0,102,219,32,353
1151018,0,0,0,79,30,0,109,252,10,371
1151019,6,0,6,93,28,3,124,255,27,406
1151020,3,3,6,30,10,0,40,118,6,164
1151021,4,0,4,42,13,0,55,233,8,296
1151022,0,0,0,33,29,0,62,184,24,270
1151023,0,0,0,0,0,0,0,0,0,0
1151024,10,0,10,58,16,0,74,273,27,374
1151025,0,0,0,0,0,0,0,3,0,3
1151026,3,0,3,37,11,0,48,185,0,233
1151027,36,3,39,25,15,3,43,248,20,311
1151028,0,0,0,27,9,0,36,98,3,137
1151029,3,0,3,52,13,0,65,190,15,270
1151030,6,0,6,54,26,3,83,310,19,412
1151031,0,0,0,51,27,0,78,296,36,410
1151032,6,3,9,36,12,0,48,229,26,303
1151033,8,0,8,57,33,0,90,323,33,446
1151034,0,0,0,68,13,0,81,216,18,315
1151035,7,0,7,30,18,0,48,182,8,238
1151036,0,0,0,77,33,4,114,318,33,465
1151037,0,0,0,64,20,3,87,256,12,355
1151038,0,0,0,57,16,0,73,189,3,265
1151039,3,0,3,43,7,0,50,234,22,306
1151040,4,0,4,44,20,0,64,164,12,240
1151041,3,0,3,46,12,0,58,161,10,229
1151042,0,0,0,46,12,3,61,240,0,301
1151043,0,0,0,37,12,3,52,126,15,193
1151044,0,0,0,78,32,3,113,275,13,401
1151045,0,0,0,94,13,6,113,280,25,418
1151046,0,0,0,61,24,0,85,229,16,330
1151047,0,0,0,70,21,0,91,237,34,362
1151048,5,0,5,50,25,3,78,232,18,328
1151049,0,0,0,36,6,6,48,163,12,223
1151101,4,0,4,79,14,0,93,263,40,396
1151102,0,0,0,3,0,0,3,7,0,10
1151103,3,0,3,78,10,0,88,188,31,307
1151104,8,3,11,50,14,0,64,144,34,242
1151105,6,0,6,26,3,0,29,117,13,159
1151106,8,0,8,81,21,0,102,253,38,393
1151107,5,52,57,68,9,3,80,186,151,417
1151108,4,0,4,70,32,0,102,277,28,407
1151109,3,0,3,24,0,0,24,90,14,128
1151110,8,0,8,63,16,0,79,246,31,356
1151111,21,0,21,80,10,0,90,314,32,436
1151112,6,0,6,73,14,6,93,297,38,428
1151113,4,0,4,86,11,0,97,257,26,380
1151114,0,0,0,75,5,0,80,212,34,326
1151115,10,0,10,89,3,0,92,282,26,400
1151116,11,0,11,65,18,0,83,225,41,349
1151117,6,6,12,68,19,0,87,295,43,425
1151118,0,0,0,86,11,0,97,272,47,416
1151119,3,0,3,73,0,0,73,193,32,298
1151120,4,0,4,42,25,0,67,199,18,284
1151121,3,0,3,39,12,0,51,165,32,248
1151122,4,0,4,124,12,0,136,283,39,458
1151123,0,3,3,53,3,0,56,158,44,258
1151124,0,0,0,44,3,0,47,138,24,209
1151125,0,0,0,44,9,0,53,202,11,266
1151126,6,0,6,61,14,0,75,186,22,283
1151127,3,3,6,69,12,0,81,255,47,383
1151128,90,3,93,89,16,0,105,370,52,527
1151129,3,0,3,62,0,4,66,183,34,283
1151130,13,0,13,71,15,0,86,339,75,500
1151131,0,0,0,20,0,0,20,108,33,161
1151132,0,0,0,52,12,0,64,224,39,327
1151133,0,0,0,41,3,0,44,51,15,110
1151134,8,0,8,75,23,0,98,245,41,384
1151135,7,0,7,100,8,0,108,245,39,392
1151136,10,0,10,89,18,0,107,353,57,517
1151137,3,5,8,75,22,3,100,308,33,441
1151138,0,0,0,48,21,0,69,244,27,340
1151139,7,3,10,73,19,0,92,279,30,401
1151140,0,0,0,37,12,0,49,119,25,193
1151141,5,0,5,96,26,0,122,350,35,507
1151142,0,0,0,45,0,0,45,111,25,181
1151143,6,0,6,61,20,4,85,319,33,437
1151144,3,0,3,60,26,3,89,222,31,342
1151145,0,0,0,41,3,0,44,158,16,218
1151146,3,3,6,44,7,0,51,222,31,304
1151147,4,0,4,50,6,0,56,226,24,306
1151148,4,0,4,76,21,0,97,204,40,341
1151149,14,0,14,68,19,0,87,268,40,395
1151150,16,0,16,88,20,0,108,328,31,467
1151151,3,0,3,33,7,0,40,136,13,189
1151152,13,0,13,41,17,0,58,235,49,342
1151153,0,0,0,45,6,0,51,140,34,225
1151154,0,3,3,82,24,3,109,267,30,406
1151155,4,3,7,92,20,0,112,257,45,414
1151156,0,0,0,41,16,0,57,139,23,219
1151201,0,0,0,27,3,0,30,137,54,221
1151202,0,0,0,55,10,0,65,180,33,278
1151203,4,0,4,41,11,0,52,153,25,230
1151204,9,0,9,94,20,6,120,318,25,463
1151205,3,0,3,64,30,0,94,212,28,334
1151206,5,0,5,51,15,0,66,232,42,340
1151207,4,0,4,53,15,3,71,142,21,234
1151208,0,0,0,25,12,6,43,97,15,155
1151209,3,0,3,47,15,6,68,213,18,299
1151210,6,0,6,47,13,0,60,225,44,329
1151211,6,4,10,90,19,4,113,330,30,473
1151212,0,0,0,57,30,0,87,229,22,338
1151213,6,0,6,76,21,0,97,205,27,329
1151214,4,0,4,37,18,0,55,169,18,242
1151215,0,0,0,68,29,0,97,204,30,331
1151216,9,0,9,50,30,3,83,241,44,368
1151217,4,0,4,41,11,6,58,160,45,263
1151218,3,3,6,73,29,0,102,268,67,437
1151219,4,0,4,43,20,3,66,199,30,295
1151220,6,0,6,101,29,3,133,298,32,463
1151221,4,0,4,78,17,0,95,258,24,377
1151222,9,0,9,70,21,0,91,202,21,314
1151223,3,0,3,85,29,0,114,235,22,371
1151224,6,0,6,42,24,0,66,190,9,265
1151225,3,0,3,51,16,0,67,205,21,293
1151226,0,3,3,73,12,0,85,223,22,330
1151227,3,6,9,68,17,0,85,214,35,334
1151228,10,0,10,84,13,0,97,225,22,344
1151229,11,3,14,71,30,0,101,303,46,450
1151230,4,0,4,70,23,3,96,241,26,363
1151231,7,3,10,64,23,0,87,227,33,347
1151232,9,0,9,73,26,4,103,265,35,403
1151233,0,0,0,58,19,3,80,249,60,389
1151234,6,5,11,65,30,0,95,225,31,351
1151235,8,0,8,58,34,0,92,303,27,422
1151236,6,3,9,38,10,4,52,190,25,267
1151237,3,3,6,67,15,3,85,174,35,294
1151301,4,0,4,72,7,0,79,223,33,335
1151302,0,0,0,33,15,0,48,132,14,194
1151303,0,0,0,25,10,0,35,107,3,145
1151304,5,0,5,39,12,3,54,242,30,326
1151305,3,0,3,41,10,0,51,131,15,197
1151306,3,0,3,59,22,0,81,257,27,365
1151307,3,0,3,61,14,0,75,242,17,334
1151308,10,0,10,83,33,3,119,318,38,475
1151309,7,0,7,75,15,3,93,295,21,409
1151310,3,0,3,77,29,0,106,188,32,326
1151311,6,0,6,74,12,0,86,275,31,392
1151312,3,0,3,53,4,0,57,188,17,262
1151313,0,0,0,70,7,3,80,208,17,305
1151314,3,0,6,76,34,0,110,239,27,376
1151315,3,0,3,70,11,0,81,245,24,350
1151316,0,0,0,105,5,0,110,220,34,364
1151317,0,0,0,31,6,0,37,139,8,184
1151318,3,0,3,73,24,0,97,222,24,343
1151319,3,3,6,54,21,0,75,190,30,295
1151320,6,0,6,82,18,0,100,273,27,400
1151321,3,0,3,42,27,3,72,134,11,217
1151322,3,3,6,79,15,0,94,265,43,402
1151323,6,0,6,59,20,0,79,229,18,326
1151324,51,0,51,42,12,0,54,293,32,379
1151325,8,6,14,50,12,0,62,186,30,278
1151326,3,0,3,80,33,0,113,275,36,424
1151327,0,0,0,33,6,0,39,161,9,209
1151328,7,0,7,47,16,6,69,179,22,270
1151329,0,0,0,30,9,0,39,124,15,178
1151330,3,0,3,39,6,0,45,144,13,202
1151331,6,3,9,68,18,0,86,263,40,389
1151332,3,3,6,64,10,0,74,216,52,342
1151333,6,0,6,42,12,0,54,192,17,263
1151334,4,3,7,66,23,6,95,191,25,311
1151335,7,4,11,89,38,4,131,320,36,487
1151336,3,0,3,76,11,0,87,281,28,396
1151337,6,6,12,75,25,0,100,303,46,449
1151338,6,0,6,80,19,0,99,289,38,426
1151339,0,3,3,63,20,0,83,208,55,346
1151340,6,28,34,41,14,0,55,176,72,303
1151341,6,0,6,48,21,0,69,202,14,285
1151342,11,0,11,129,27,0,156,410,40,606
1151343,6,0,6,66,21,0,87,245,33,365
1151344,12,0,12,63,23,0,86,254,26,366
1151345,4,0,4,58,13,0,71,210,17,298
1151346,0,0,0,26,15,0,41,119,6,166
1151347,3,0,3,25,18,0,43,144,27,214
1151348,10,0,10,39,20,0,59,139,11,209
1151401,6,0,6,43,15,0,58,133,14,205
1151402,3,0,3,58,23,3,84,250,10,344
1151403,3,3,6,84,41,0,125,221,22,368
1151404,0,0,0,36,5,0,41,136,9,186
1151405,0,0,0,81,24,0,105,302,13,420
1151406,0,0,0,82,10,0,92,266,17,375
1151407,5,0,5,93,35,0,128,369,24,521
1151408,0,0,0,51,24,3,78,220,12,310
1151409,3,0,3,43,12,3,58,165,6,229
1151410,5,0,5,81,29,0,110,266,24,400
1151411,3,0,6,34,12,4,50,149,30,229
1151412,0,0,0,70,14,7,91,285,27,403
1151413,5,0,5,67,22,0,89,252,24,365
1151414,3,0,3,70,27,0,97,311,26,434
1151415,0,3,3,48,20,0,68,230,24,322
1151416,4,0,4,77,29,0,106,252,30,388
1151417,0,0,0,111,26,0,137,296,24,457
1151418,4,0,4,55,24,3,82,289,6,377
1151419,3,0,3,47,9,3,59,200,23,282
1151420,3,0,3,70,22,3,95,244,4,343
1151421,3,0,3,44,24,3,71,223,34,328
1151422,0,0,0,52,15,3,70,233,12,315
1151501,0,0,0,37,21,3,61,200,3,264
1151502,3,0,3,57,12,0,69,217,7,293
1151503,0,0,0,46,9,0,55,136,4,195
1151504,7,0,7,61,10,3,74,334,37,445
1151505,0,0,0,48,4,0,52,197,16,265
1151506,0,0,0,33,0,0,33,180,25,238
1151507,0,0,0,51,9,0,60,210,26,296
1151508,0,0,0,25,6,0,31,113,19,163
1151509,9,0,9,76,15,0,91,298,36,425
1151510,3,0,3,45,7,0,52,129,25,206
1151511,0,0,0,48,15,0,63,162,20,245
1151512,0,0,0,87,12,0,99,369,63,531
1151513,4,0,4,21,9,3,33,142,12,187
1151514,4,0,4,35,10,0,45,190,16,251
1151515,6,0,6,60,33,3,96,270,20,386
1151516,3,14,17,72,16,0,88,155,87,330
1151517,3,0,3,96,13,0,109,330,28,467
1151518,0,0,0,42,0,0,42,136,15,193
1151519,3,0,3,47,7,3,57,170,18,245
1151520,3,0,3,57,9,4,70,296,16,382
1151521,3,7,10,46,21,0,67,165,14,246
1151522,7,0,7,43,21,0,64,192,6,262
1151523,6,3,9,60,16,0,76,228,12,316
1151524,3,0,3,35,3,3,41,177,27,245
1151525,0,0,0,45,3,7,55,172,7,234
1151526,4,0,4,58,9,0,67,181,21,269
1151527,0,0,0,54,3,0,57,209,3,269
1151528,6,0,6,55,12,0,67,227,18,312
1151529,0,0,0,80,12,3,95,191,12,298
1151530,0,0,0,42,0,0,42,138,21,201
1151531,3,0,3,69,9,0,78,260,37,375
1151532,3,0,3,79,9,3,91,252,21,364
1151533,3,3,6,54,19,0,73,273,14,360
1151534,7,3,13,95,34,0,129,373,58,560
1151535,4,0,4,41,3,0,44,202,24,270
1151536,11,0,11,48,21,6,75,203,15,293
1151537,3,3,6,39,19,0,58,158,25,241
1151538,10,5,15,56,18,0,74,201,39,314
1151539,4,0,4,36,12,0,48,156,0,204
1151540,3,3,6,26,7,0,33,169,25,227
1151541,5,0,5,88,26,0,114,299,26,439
1151542,4,0,4,42,9,0,51,184,23,258
1151543,3,3,6,65,17,0,82,261,19,362
1151544,5,0,5,68,32,0,100,276,26,402
1151601,6,0,6,54,16,0,70,232,6,308
1151602,3,0,3,75,21,0,96,202,19,317
1151603,0,0,0,79,24,6,109,345,44,498
1151604,0,0,0,53,26,0,79,245,29,353
1151605,8,0,8,83,43,0,126,288,24,438
1151606,3,3,6,40,21,0,61,191,28,280
1151607,0,0,0,73,28,0,101,270,29,400
1151608,6,0,6,73,36,0,109,295,12,416
1151609,7,0,7,50,17,3,70,215,37,322
1151610,6,3,9,49,14,0,63,294,21,378
1151611,3,0,3,65,14,0,79,263,20,362
1151612,4,0,4,67,18,0,85,287,33,405
1151613,3,0,3,59,24,0,83,257,25,365
1151614,8,3,11,94,17,0,111,312,48,471
1151615,6,0,6,66,17,0,83,284,22,389
1151616,15,0,15,45,27,0,72,237,17,326
1151617,6,0,6,41,4,0,45,181,16,242
1151618,3,0,3,54,32,0,86,243,30,359
1151619,0,0,0,89,37,7,133,266,30,429
1151620,3,0,3,50,20,0,70,246,17,333
1151621,0,0,0,91,25,0,116,291,38,445
1151622,3,0,3,88,16,0,104,244,29,377
1151623,0,0,0,71,12,6,89,253,39,381
1151624,5,0,5,55,25,3,83,305,11,399
1151625,0,0,0,83,24,0,107,307,43,457
1151626,3,6,9,69,23,0,92,307,48,447
1151627,3,0,3,73,27,0,100,295,33,428
1151628,3,0,6,58,29,0,87,221,19,327
1151629,0,0,0,46,9,0,55,154,10,219
1151630,6,0,6,29,20,0,49,217,38,304
1151631,3,0,3,58,18,0,76,274,23,373
1151632,4,0,4,32,9,0,41,179,18,238
1151633,9,0,9,59,26,0,85,240,12,337
1151634,8,0,8,62,23,6,91,259,32,382
1151635,6,0,6,67,24,0,91,317,37,445
1151636,3,0,3,31,4,0,35,104,15,154
1151637,3,0,3,54,12,0,66,169,16,251
1151638,0,0,0,60,18,3,81,232,31,344
1151701,0,0,0,44,26,0,70,189,12,271
1151702,0,0,0,59,21,0,80,209,21,310
1151703,0,0,0,39,19,0,58,158,3,219
1151704,3,0,3,81,19,0,100,323,23,446
1151705,4,0,4,72,28,0,100,262,22,384
1151706,0,0,0,46,11,0,57,189,9,255
1151707,5,0,5,42,18,0,60,164,15,239
1151708,0,0,0,56,21,6,83,205,40,328
1151709,0,0,0,71,25,0,96,288,22,406
1151710,0,0,0,52,22,0,74,210,12,296
1151711,4,0,4,69,30,0,99,286,21,406
1151712,10,0,10,86,46,4,136,382,27,545
1151713,3,0,3,48,7,0,55,233,12,300
1151714,6,0,6,36,15,0,51,225,16,292
1151715,0,0,0,46,31,0,77,231,21,329
1151716,0,0,0,0,0,0,0,0,0,0
1151717,0,0,0,62,39,6,107,281,13,401
1151718,6,0,6,33,21,0,54,165,7,226
1151719,0,0,0,44,13,3,60,147,18,225
1151720,0,0,0,38,12,0,50,120,12,182
1151721,0,0,0,42,20,3,65,126,3,194
1151801,0,0,0,71,31,0,102,178,42,322
1151802,8,0,8,49,29,3,81,278,81,440
1151803,3,0,3,64,15,0,79,211,21,311
1151804,0,0,0,42,24,6,72,154,20,246
1151805,4,0,4,41,46,3,90,275,19,384
1151806,0,0,0,36,27,0,63,207,6,276
1151807,3,0,3,42,20,0,62,170,9,241
1151808,18,16,34,34,25,0,59,176,52,287
1151809,7,0,7,26,25,0,51,90,24,165
1151810,5,0,5,38,12,0,50,148,24,222
1151811,7,0,7,66,33,3,102,229,36,367
1151812,6,0,6,47,18,3,68,179,30,277
1151901,6,0,6,49,28,0,77,299,23,399
1151902,3,0,3,55,35,0,90,280,22,392
1151903,4,0,4,48,29,0,77,212,16,305
1151904,3,0,3,93,30,3,126,287,22,435
1151905,6,0,6,84,37,3,124,359,37,520
1151906,0,0,0,59,33,3,95,270,25,390
1151907,0,0,0,40,24,3,67,189,13,269
1151908,3,0,3,26,15,0,41,108,12,161
1151909,6,0,6,58,34,0,92,268,26,386
1151910,0,0,0,34,20,3,57,183,12,252
1151911,0,0,0,24,11,0,35,170,16,221
1151912,0,0,0,97,29,6,132,320,47,499
1151913,6,0,6,51,15,3,69,166,38,273
1151914,7,0,7,85,18,0,103,296,50,449
1151915,40,6,46,41,11,6,58,316,58,432
1151916,4,0,4,37,7,0,44,175,23,242
1151917,3,0,3,51,20,0,71,219,10,300
1151918,6,3,9,59,19,3,81,210,31,322
1151919,10,6,16,101,29,3,133,425,57,615
1151920,9,0,9,102,38,3,143,337,38,518
1151921,0,0,0,50,26,0,76,212,27,315
1151922,0,0,0,35,6,0,41,138,3,182
1151923,3,0,3,91,56,0,147,322,26,495
1151924,3,0,3,42,12,0,54,169,9,232
1151925,3,0,3,88,35,0,123,365,34,522
1151926,9,0,9,44,23,0,67,211,15,293
1151927,0,5,5,38,12,3,53,157,23,233
1151928,6,0,6,89,23,5,117,242,15,374
1151929,3,0,3,61,13,0,74,228,25,327
1151930,10,5,15,80,20,0,100,249,30,379
1151931,6,0,6,35,4,0,39,127,24,190
1151932,3,0,3,59,20,3,82,166,30,278
1151933,6,0,6,90,31,4,125,252,39,416
1151934,4,3,7,70,28,0,98,208,22,328
1151935,3,0,3,35,20,0,55,142,19,216
1151936,0,0,0,40,29,3,72,196,23,291
1151937,0,3,3,70,22,0,92,244,53,389
1151938,6,6,12,76,39,3,118,313,27,458
1151939,7,0,7,72,27,0,99,278,46,423
1151940,0,0,0,3,0,0,3,6,0,9
1152001,3,3,6,56,24,0,80,274,15,369
1152002,5,0,5,85,36,0,121,267,37,425
1152003,0,0,0,44,24,0,68,215,16,299
1152004,3,0,3,75,24,3,102,294,22,418
1152005,3,0,3,45,17,4,66,174,9,249
1152006,4,0,4,39,12,3,54,154,9,217
1152007,4,0,4,31,26,0,57,176,6,239
1152008,9,0,9,44,27,3,74,203,14,291
1152009,52,0,52,50,19,0,69,395,21,485
1152010,4,0,4,49,18,0,67,267,27,361
1152011,0,0,0,54,25,0,79,248,34,361
1152012,0,0,0,42,21,0,63,179,6,248
1152013,5,0,5,24,12,0,36,171,15,222
1152014,0,0,0,53,19,0,72,181,9,262
1152015,4,0,4,38,22,0,60,193,19,272
1152016,0,0,0,55,20,0,75,183,15,273
1152017,4,0,4,61,35,3,99,319,23,441
1152018,0,0,0,44,34,0,78,193,15,286
1152019,7,0,7,43,21,3,67,287,15,369
1152020,3,0,3,79,42,0,121,300,12,433
1152021,3,3,6,76,28,0,104,307,43,454
1152022,6,0,9,72,35,0,107,284,20,411
1152023,6,4,10,48,24,0,72,216,10,298
1152024,3,0,3,93,34,3,130,355,30,515
1152025,4,0,4,43,15,0,58,228,17,303
1152026,0,0,0,30,7,0,37,167,10,214
1152101,0,0,0,0,0,0,0,22,0,22
1152201,0,0,0,94,14,9,117,242,32,391
1152202,7,0,7,75,23,0,98,239,53,390
1152203,0,0,0,0,0,0,0,0,0,0
1152204,0,0,0,114,31,0,145,231,32,408
1152205,0,0,0,0,3,0,3,0,0,3
1152206,6,3,9,96,22,0,118,250,38,406
1152207,6,0,6,79,17,0,96,202,13,311
1152208,0,0,0,60,38,3,101,228,26,355
1152209,5,0,5,44,14,3,61,168,25,254
1152210,0,0,0,86,38,0,124,269,27,420
1152211,3,0,3,149,21,0,170,298,19,487
1152212,0,0,0,75,23,0,98,148,14,260
1152213,0,0,0,45,12,0,57,151,17,225
1152214,7,0,7,57,12,6,75,231,31,337
1152215,4,0,4,58,24,0,82,251,16,349
1152216,3,0,3,50,10,0,60,190,40,290
1152217,4,0,4,41,25,0,66,186,29,281
1152218,3,3,6,63,23,0,86,230,40,356
1152219,39,7,49,65,25,3,93,326,98,517
1152220,0,0,0,64,20,0,84,103,56,243
1152221,0,0,0,42,14,6,62,93,18,173
1152222,0,0,0,67,16,0,83,205,18,306
1152223,8,0,8,68,18,4,90,268,37,395
1152224,6,0,6,77,19,4,100,177,69,346
1152225,0,3,3,117,21,0,138,228,44,410
1152226,0,0,0,127,22,3,152,295,36,483
1152227,0,0,0,58,12,0,70,175,18,263
1152228,0,0,0,76,12,10,98,194,16,308
1152229,4,0,4,59,14,0,73,163,23,259
1152230,0,0,0,83,25,6,114,228,36,378
1152231,0,0,0,55,6,0,61,97,23,181
1152232,0,0,0,75,19,0,94,136,15,245
1152233,0,0,0,119,35,0,154,286,24,464
1152234,3,3,6,55,9,0,64,175,67,306
1152235,3,6,9,24,6,3,33,136,21,190
1152236,6,0,6,39,17,0,56,260,50,366
1152301,0,0,0,0,0,0,0,0,0,0
1152302,4,0,4,63,38,0,101,197,24,322
1152303,3,0,3,166,51,9,226,395,18,639
1152304,6,0,6,85,47,6,138,306,38,482
1152305,0,0,0,74,34,3,111,187,13,311
1152306,0,0,0,87,21,3,111,207,34,352
1152307,0,0,0,0,0,0,0,0,0,0
1152308,0,0,0,52,0,0,52,59,9,120
1152309,0,0,0,0,0,0,0,0,0,0
1152310,6,3,9,44,44,3,91,233,27,351
1152311,9,0,9,107,45,3,155,264,50,469
1152312,6,3,9,75,48,3,126,209,35,370
1152313,3,0,3,45,44,0,89,158,12,259
1152314,6,3,9,65,45,5,115,224,15,354
1152315,3,0,3,37,26,0,63,173,7,243
1152316,7,3,10,82,62,4,148,280,41,469
1152317,0,6,6,39,36,0,75,149,32,256
1152318,0,0,0,77,19,0,96,237,12,345
1152319,6,0,6,65,47,3,115,270,14,399
1152320,3,0,3,62,27,0,89,248,19,356
1152321,4,0,4,89,51,9,149,326,9,484
1152322,7,0,7,63,40,0,103,174,22,299
1152323,0,0,0,35,22,0,57,190,27,274
1152324,0,0,0,57,15,3,75,169,35,279
1152325,0,0,0,0,0,0,0,0,0,0
1152326,4,0,4,71,31,0,102,292,19,413
1152327,3,3,6,84,14,0,98,220,42,360
1152328,4,3,7,55,21,0,76,214,21,311
1152329,3,3,6,89,26,0,115,311,23,449
1152330,4,0,4,33,21,0,54,123,19,196
1152331,3,0,3,66,30,0,96,223,31,350
1152332,0,0,0,74,23,0,97,149,7,253
1152333,0,0,0,0,0,0,0,0,0,0
1152334,6,0,6,39,26,0,65,222,24,311
1152335,51,0,51,34,13,0,47,278,18,343
1152336,6,0,6,82,31,0,113,225,18,356
1152337,0,0,0,35,12,6,53,134,19,206
1152338,3,0,3,56,23,0,79,166,19,264
1152339,0,0,0,49,13,0,62,182,15,259
1152340,3,0,3,59,21,0,80,149,17,246
1152341,4,0,4,16,9,0,25,56,9,90
1152342,0,0,0,0,0,0,0,3,0,3
1152343,0,0,0,103,17,6,126,279,11,416
1152344,3,0,3,56,25,0,81,189,10,280
1152401,0,0,0,58,21,0,79,162,3,244
1152402,0,0,0,76,18,5,99,136,3,238
1152403,0,0,0,37,15,3,55,97,6,158
1152404,0,0,0,108,33,6,147,218,16,381
1152405,0,0,0,88,12,12,112,223,5,340
1152406,0,0,0,93,7,7,107,144,9,260
1152407,4,0,4,87,20,3,110,164,29,303
1152408,0,0,0,88,8,3,99,142,5,246
1152409,0,0,0,75,16,0,91,183,21,295
1152410,0,0,0,59,23,0,82,126,12,220
1152411,0,0,0,81,11,3,95,111,11,217
1152412,4,0,4,126,20,17,163,259,19,441
1152413,3,0,3,133,34,4,171,231,6,408
1152414,0,3,3,76,15,0,91,109,6,206
1152415,0,0,0,84,16,3,103,121,10,234
1152416,0,0,0,62,9,3,74,173,3,250
1152417,0,0,0,101,14,7,122,151,14,287
1152418,6,0,6,147,18,10,175,243,12,430
1152419,0,0,0,120,19,7,146,236,16,398
1152420,0,0,0,61,7,3,71,131,9,211
1152421,0,0,0,114,22,6,142,237,18,397
1152422,3,0,3,52,11,0,63,212,42,317
1152423,0,0,0,121,9,10,140,239,3,382
1152424,0,0,0,100,9,4,113,121,7,241
1152425,0,0,0,110,7,10,127,209,18,354
1152426,0,0,0,96,16,8,120,132,35,287
1152427,3,0,3,129,29,0,158,265,46,469
1152428,0,0,0,78,31,10,119,176,8,303
1152429,0,0,0,72,29,0,101,200,18,319
1152430,6,0,6,75,31,9,115,205,24,344
1152431,0,0,0,0,0,0,0,0,0,0
1152432,0,0,0,67,3,6,76,106,9,191
1152433,0,0,0,56,12,6,74,136,9,219
1152434,0,0,0,4,13,4,21,346,19,386
1152435,0,0,0,116,36,6,158,287,22,467
1152436,0,0,0,55,25,0,80,138,3,221
1152437,0,0,0,10,0,0,10,100,0,110
1152438,0,0,0,101,27,3,131,382,4,517
1152439,0,0,0,58,7,6,71,124,15,210
1152440,3,6,9,163,31,14,208,295,27,530
1152441,0,0,0,81,12,0,93,162,18,273
1152442,0,0,0,0,0,0,0,0,0,0
1152443,0,0,0,83,13,0,96,123,8,227
1152444,0,0,0,69,13,0,82,136,4,222
1152445,3,0,3,104,19,9,132,147,9,288
1152446,0,0,0,44,23,6,73,104,9,186
1152447,3,0,3,76,21,5,102,216,7,325
1152448,8,0,8,99,27,3,129,250,6,385
1152449,140,10,150,35,18,0,53,441,40,534
1152450,0,0,0,63,10,6,79,139,3,221
1152501,0,0,0,52,16,0,68,158,21,247
1152502,0,0,0,43,6,3,52,129,17,198
1152503,7,3,10,37,12,0,49,246,69,364
1152504,0,3,3,107,10,0,117,244,35,396
1152505,3,0,3,64,0,0,64,164,26,254
1152506,0,0,0,78,8,0,86,255,87,428
1152507,6,3,12,76,25,0,101,293,22,416
1152508,4,0,4,61,9,3,73,207,22,302
1152509,8,0,8,74,25,3,102,336,54,492
1152510,6,3,9,56,23,0,79,341,69,489
1152511,6,0,6,51,7,0,58,209,50,317
1152512,3,3,6,76,40,0,116,212,15,343
1152513,0,4,4,93,7,0,100,228,94,422
1152514,0,0,0,70,12,0,82,244,65,391
1152515,0,0,0,62,6,0,68,197,43,308
1152516,3,0,3,88,12,0,100,225,79,404
1152517,3,0,3,80,7,0,87,252,48,387
1152518,7,0,7,153,25,0,178,552,136,866
1152519,0,0,0,47,0,0,47,166,21,234
1152520,0,0,0,74,6,3,83,229,99,411
1152521,6,0,6,78,27,0,105,257,26,388
1152522,30,4,34,75,34,3,112,316,45,473
1152523,0,0,0,69,30,0,99,238,33,370
1152524,0,0,0,67,19,3,89,211,32,332
1152525,6,0,6,85,18,0,103,243,33,379
1152526,4,3,7,78,15,0,93,255,26,374
1152527,0,0,0,38,18,3,59,149,46,254
1152528,0,0,0,84,26,0,110,284,76,470
1152529,0,4,4,55,27,6,88,258,62,408
1152530,9,0,9,66,17,3,86,273,78,437
1152531,0,0,0,77,12,0,89,271,44,404
1152532,3,0,3,38,13,0,51,160,15,226
1152533,6,0,6,60,16,0,76,214,32,322
1152534,0,0,0,52,6,0,58,142,37,237
1152535,3,0,3,66,18,0,84,240,84,408
1152536,8,0,8,62,17,6,85,259,51,395
1152537,6,0,6,55,17,6,78,190,39,307
1152538,8,0,8,41,18,0,59,179,26,264
1152539,7,0,7,70,20,0,90,307,22,419
1152540,14,51,65,29,5,0,34,161,129,324
1152541,4,3,7,81,22,0,103,253,36,392
1152542,0,0,0,0,0,0,0,5,0,5
1152543,0,0,0,44,11,0,55,141,50,246
1152544,3,3,6,59,3,0,62,182,70,314
1152545,3,0,3,53,7,3,63,182,27,272
1152546,6,3,9,93,9,3,105,365,59,529
1152547,7,3,10,75,27,0,102,241,50,393
1152548,0,0,0,72,27,0,99,236,25,360
1152549,0,0,0,84,16,3,103,284,84,471
1152550,0,0,0,0,0,0,0,4,0,4
1152551,3,0,3,29,3,4,36,129,35,200
1152552,4,0,4,33,7,0,40,144,34,218
1152553,0,0,0,143,16,0,159,250,79,488
1152554,0,0,0,87,10,0,97,284,75,456
1152555,0,0,0,93,10,3,106,313,30,449
1152556,7,0,7,64,9,0,73,317,83,473
1152557,0,0,0,49,9,3,61,117,11,189
1152558,3,0,3,94,7,0,101,255,42,398
1152559,3,3,6,77,3,0,80,169,139,388
1152560,0,0,0,69,7,0,76,205,54,335
1152561,0,0,0,0,0,0,0,0,0,0
1152562,0,0,0,72,18,0,90,237,99,426
1152563,0,0,0,95,15,0,110,217,75,402
1152564,4,0,4,78,6,3,87,222,45,354
1152601,0,0,0,112,21,0,133,212,15,360
1152602,0,0,0,64,24,0,88,153,12,253
1152603,4,0,4,68,18,3,89,245,65,399
1152604,6,0,6,34,16,0,50,147,24,221
1152605,3,0,3,63,26,0,89,175,34,298
1152606,0,0,0,45,4,0,49,113,26,188
1152607,0,0,0,108,19,0,127,141,21,289
1152608,0,0,0,49,6,0,55,105,9,169
1152609,0,0,0,65,25,3,93,127,15,235
1152610,0,0,0,152,19,0,171,241,19,431
1152611,0,0,0,78,10,3,91,169,22,282
1152612,4,3,7,78,20,0,98,267,35,400
1152613,0,0,0,67,28,6,101,207,38,346
1152614,0,0,0,102,23,3,128,171,12,311
1152615,3,0,3,85,14,0,99,184,4,287
1152616,3,0,3,108,41,0,149,204,25,378
1152617,0,0,0,53,6,0,59,67,6,132
1152618,3,0,3,105,23,6,134,255,9,398
1152619,3,0,3,81,27,9,117,157,6,280
1152620,0,0,0,8,6,0,14,44,11,69
1152621,0,0,0,0,0,0,0,9,3,12
1152622,0,0,0,49,14,0,63,224,46,333
1152623,3,0,3,42,3,0,45,151,16,212
1152624,0,0,0,48,21,0,69,201,43,313
1152625,0,0,0,62,19,0,81,265,53,399
1152626,6,3,9,92,27,0,119,325,64,508
1152627,0,0,0,68,15,0,83,193,30,306
1152628,6,0,6,78,3,0,81,209,24,314
1152629,0,3,3,67,11,0,78,248,30,356
1152630,0,0,0,66,13,0,79,190,27,296
1152631,0,0,0,55,30,3,88,208,24,320
1152632,0,0,0,81,24,3,108,227,21,356
1152633,6,0,6,129,34,0,163,329,18,510
1152634,0,0,0,74,23,3,100,245,25,370
1152635,3,0,3,31,15,0,46,142,22,210
1152636,6,0,6,64,15,0,79,237,24,340
1152637,4,0,4,49,18,6,73,194,40,307
1152638,0,0,0,63,23,3,89,247,31,367
1152639,3,3,6,45,12,0,57,186,27,270
1152640,11,0,11,76,12,3,91,196,17,304
1152641,0,0,0,149,31,6,186,272,25,483
1152642,0,0,0,50,26,3,79,213,20,312
1152643,0,0,0,23,16,0,39,92,7,138
1152644,0,0,0,83,26,0,109,236,15,360
1152645,0,0,0,52,18,0,70,98,17,185
1152646,4,0,4,184,28,11,223,261,41,525
1152647,0,0,0,103,26,0,129,199,33,361
1152648,10,0,10,48,38,6,92,221,26,339
1152649,0,0,0,75,11,0,86,134,6,226
1152650,0,0,0,161,34,4,199,268,21,488
1152651,0,0,0,53,9,6,68,139,8,215
1152652,0,0,0,111,23,0,134,190,14,338
1152653,0,0,0,179,38,3,220,311,41,572
1152654,0,0,0,87,27,3,117,234,26,377
1152655,0,0,0,187,28,6,221,302,35,558
1152656,0,0,0,92,22,4,118,215,3,336
1152657,4,0,4,95,15,0,110,197,21,328
1152658,77,14,91,82,31,0,113,321,42,476
1152659,0,0,0,70,22,0,92,127,9,228
1152701,6,3,9,55,23,0,78,112,15,205
1152702,13,3,19,82,32,0,114,200,26,340
1152703,13,0,13,95,22,3,120,209,6,335
1152704,3,0,3,53,22,0,75,205,26,306
1152705,3,0,3,65,25,0,90,115,15,220
1152706,3,3,6,86,48,3,137,404,68,609
1152707,3,0,3,91,21,3,115,333,54,502
1152708,17,0,17,95,30,0,125,222,34,381
1152709,11,6,17,58,17,3,78,171,13,262
1152710,28,0,28,47,32,0,79,254,33,366
1152711,15,6,21,71,36,4,111,274,45,430
1152712,8,0,8,97,20,4,121,166,19,306
1152713,8,3,11,53,26,0,79,148,18,245
1152714,3,3,6,79,31,9,119,159,18,296
1152715,0,0,0,0,0,0,0,0,0,0
1152716,4,0,8,144,39,5,188,209,11,408
1152717,0,0,0,0,0,0,0,9,0,9
1152718,0,3,3,48,22,0,70,182,37,289
1152719,9,3,12,43,26,8,77,181,15,273
1152720,11,6,17,67,29,3,99,204,34,337
1152721,3,3,6,60,21,0,81,119,15,215
1152722,13,0,13,85,33,3,121,253,24,398
1152723,4,0,4,38,24,0,62,140,0,202
1152724,6,0,6,62,12,3,77,127,6,210
1152725,6,3,9,90,33,3,126,297,22,445
1152726,6,0,6,73,23,7,103,163,12,278
1152727,10,0,10,89,29,3,121,162,15,298
1152728,6,0,6,79,33,0,112,151,7,270
1152729,6,0,6,89,36,0,125,205,13,343
1152730,15,0,15,80,21,3,104,227,11,342
1152731,13,0,13,82,28,7,117,174,6,297
1152732,3,3,6,57,28,3,88,205,13,306
1152733,6,0,6,114,50,5,169,278,15,462
1152734,4,0,4,66,47,9,122,228,16,366
1152735,3,0,3,69,36,6,111,219,19,349
1152736,3,0,3,95,21,8,124,201,17,342
1152737,9,3,12,76,15,0,91,217,18,326
1152738,13,0,16,81,41,6,128,197,11,336
1152739,6,0,9,62,24,0,86,140,3,229
1152740,4,3,7,85,24,4,113,179,24,316
1152741,15,0,15,74,28,0,102,216,10,328
1152742,8,3,11,103,45,6,154,205,24,383
1152743,6,4,10,48,41,0,89,226,15,330
1152744,0,0,0,81,29,0,110,186,18,314
1152745,3,0,3,51,43,0,94,191,4,289
1152746,4,3,7,68,26,0,94,198,10,302
1152747,8,0,8,80,46,4,130,214,21,365
1152748,4,0,4,63,20,0,83,200,15,298
1152749,11,6,17,90,46,9,145,245,24,414
1152750,8,3,11,56,21,6,83,196,15,294
1152751,21,6,27,45,38,0,83,195,9,287
1152752,16,6,22,57,41,9,107,244,26,377
1152753,8,0,8,81,37,0,118,265,37,420
1152754,4,0,4,66,24,3,93,272,14,379
1152755,18,6,24,45,25,0,70,209,19,298
1152756,18,6,24,107,16,3,126,260,19,405
1152757,9,3,12,63,23,0,86,368,51,505
1152758,42,6,48,73,31,3,107,247,16,370
1152759,8,0,8,91,29,3,123,202,18,343
1152760,5,3,8,103,22,0,125,222,21,368
1152761,0,0,0,38,18,4,60,93,21,174
1152762,9,3,12,67,41,8,116,201,24,341
1152763,0,0,0,14,13,0,27,170,14,211
1152764,16,8,24,79,30,3,112,246,61,419
1152801,4,0,4,57,21,0,78,169,14,261
1152802,6,0,6,27,28,0,55,100,6,161
1152803,3,5,8,52,28,14,94,150,19,263
1152804,8,3,14,68,48,12,128,211,30,369
1152805,10,0,10,101,41,10,152,232,33,417
1152806,0,0,0,0,0,0,0,0,0,0
1152807,6,0,6,49,15,3,67,198,30,295
1152808,3,0,3,35,26,0,61,178,22,261
1152809,6,0,6,33,27,6,66,100,15,181
1152810,9,3,12,47,25,3,75,148,9,232
1152811,7,0,7,33,35,0,68,158,0,226
1152812,3,0,3,35,48,0,83,134,9,226
1152813,5,3,8,41,38,3,82,179,12,273
1152814,0,0,0,0,0,0,0,0,0,0
1152815,0,0,0,0,0,0,0,0,0,0
1152816,0,0,0,0,0,0,0,0,0,0
1152817,3,0,3,61,16,6,83,149,0,232
1152818,0,0,0,34,17,0,51,142,6,199
1152819,0,0,0,64,27,6,97,210,21,328
1152820,4,0,7,27,24,3,54,146,8,208
1152821,10,3,13,136,35,6,177,296,35,508
1152822,19,3,22,63,51,6,120,344,42,506
1152823,11,3,14,37,48,0,85,261,33,379
1152824,4,12,16,51,30,3,84,311,75,470
1152825,10,7,17,42,24,0,66,228,22,316
1152826,4,0,4,30,38,0,68,276,18,362
1152827,7,0,7,96,26,3,125,192,10,327
1152828,4,4,8,52,33,7,92,143,4,239
1152829,6,0,6,71,30,6,107,165,12,284
1152830,13,0,13,55,40,3,98,141,26,265
1152831,21,0,21,61,22,0,83,196,15,294
1152832,6,0,6,28,25,0,53,134,18,205
1152833,7,3,10,61,38,0,99,245,21,365
1152834,3,0,3,75,17,6,98,168,12,278
1152835,3,0,3,15,20,3,38,105,6,149
1152836,0,0,0,28,15,6,49,134,9,192
1152837,8,3,11,42,30,0,72,156,10,238
1152838,3,0,3,42,31,3,76,161,8,245
1152839,9,4,13,50,32,0,82,283,28,393
1152840,43,11,54,38,40,0,78,310,21,409
1152841,10,0,10,32,31,0,63,171,6,240
1152842,3,3,6,57,44,8,109,284,44,437
1152843,12,0,15,45,31,3,79,212,24,315
1152844,7,3,10,82,22,0,104,185,12,301
1152845,3,0,3,66,23,0,89,150,4,243
1152846,3,0,3,98,34,8,140,249,22,411
1152847,0,0,0,76,11,0,87,139,18,244
1152848,0,0,0,54,26,7,87,134,9,230
1152849,0,0,0,0,0,0,0,0,0,0
1152850,7,3,10,74,41,3,118,229,24,371
1152851,10,6,16,60,35,0,95,229,12,336
1152852,5,4,9,36,39,0,75,227,29,331
1152853,7,0,7,63,32,0,95,299,34,428
1152854,0,0,0,65,29,3,97,340,48,485
1152855,0,0,0,37,17,3,57,209,38,304
1152856,8,0,8,78,49,0,127,548,52,727
1152857,6,3,9,106,30,10,146,255,34,435
1152858,6,0,6,60,18,0,78,164,15,257
1152859,8,0,12,124,37,8,169,236,22,427
1152860,7,3,10,44,14,6,64,196,27,287
1152861,0,0,0,0,0,0,0,0,0,0
1152862,0,0,0,0,0,0,0,0,0,0
1152863,0,0,0,71,36,9,116,150,16,282
1152864,10,0,10,96,30,5,131,226,18,375
1152865,6,3,9,48,12,4,64,121,16,201
1152866,8,0,8,53,32,6,91,166,12,269
1152867,6,0,6,72,18,3,93,139,9,241
1152868,21,0,21,81,32,9,122,232,9,363
1152869,8,0,8,96,33,10,139,275,30,444
1152870,0,0,0,53,20,0,73,237,8,318
1152871,13,4,17,35,35,0,70,295,35,400
1152872,20,4,27,37,46,3,86,267,31,384
1152873,0,6,6,56,16,3,75,118,18,211
1152874,34,3,37,57,46,0,103,359,24,486
1152875,6,0,6,51,29,0,80,175,26,281
1152876,8,6,14,65,28,0,93,178,23,294
1152877,13,0,13,101,36,0,137,221,23,381
1152878,7,0,7,64,26,6,96,194,27,317
1152879,4,0,4,41,15,0,56,171,20,247
1152880,0,5,5,34,18,3,55,227,31,313
1152881,12,0,12,78,35,0,113,338,63,514
1152882,3,3,6,51,18,3,72,263,18,353
1152883,0,3,3,15,10,0,25,114,30,169
1152884,3,0,3,47,16,3,66,262,19,347
1152901,4,0,4,60,40,0,100,154,18,272
1152902,0,0,0,88,22,3,113,203,10,326
1152903,0,0,0,100,29,5,134,202,13,349
1152904,4,0,4,102,50,4,156,243,18,417
1152905,5,3,8,50,33,4,87,235,20,342
1152906,6,0,6,79,32,5,116,220,11,347
1152907,0,0,0,52,31,8,91,159,12,262
1152908,0,0,0,126,37,9,172,344,14,530
1152909,0,3,3,68,21,9,98,157,12,267
1152910,4,0,4,72,25,6,103,143,9,255
1152911,4,0,4,85,46,4,135,175,11,321
1152912,4,0,4,104,43,0,147,288,9,444
1152913,6,3,9,32,39,3,74,174,9,257
1152914,3,0,3,75,31,0,106,189,15,310
1152915,8,0,8,35,11,4,50,185,4,239
1152916,10,0,10,78,28,6,112,136,12,260
1152917,6,3,9,77,31,0,108,209,29,346
1152918,6,4,10,57,36,0,93,231,14,338
1152919,8,0,8,82,35,0,117,280,9,406
1152920,3,3,6,46,18,0,64,192,24,280
1152921,11,4,15,54,19,0,73,293,32,398
1152922,5,3,8,74,27,0,101,220,19,340
1152923,9,6,15,67,15,0,82,189,15,286
1152924,7,0,7,67,19,3,89,191,7,287
1152925,8,3,11,76,25,0,101,263,21,385
1152926,3,3,6,74,44,3,121,259,21,401
1152927,4,0,4,74,41,0,115,230,13,358
1152928,3,3,6,81,14,3,98,187,31,316
1152929,13,0,13,80,50,0,130,214,17,361
1152930,0,0,0,65,37,7,109,233,8,350
1152931,0,3,3,102,36,4,142,201,19,362
1152932,5,0,5,98,45,6,149,249,11,409
1152933,33,3,36,48,25,6,79,175,15,269
1152934,0,5,5,120,41,6,167,186,20,373
1152935,5,0,5,85,38,9,132,249,6,387
1152936,8,0,8,74,31,6,111,192,26,329
1152937,5,3,8,101,22,4,127,148,12,287
1152938,3,0,6,93,36,3,132,195,21,348
1152939,0,0,0,61,30,0,91,128,0,219
1152940,4,0,4,112,35,0,147,262,18,427
1153001,17,0,17,69,41,6,116,245,13,374
1153002,22,5,27,63,33,0,96,207,25,328
1153003,7,4,11,79,29,6,114,241,27,382
1153004,11,57,68,54,20,0,74,146,81,301
1153005,3,3,6,45,23,0,68,192,27,287
1153006,14,6,20,72,31,3,106,278,25,409
1153007,8,3,11,57,35,6,98,204,9,311
1153008,8,4,12,115,36,0,151,278,11,440
1153009,3,0,3,56,18,3,77,130,0,207
1153010,8,0,8,79,49,6,134,279,10,423
1153011,3,0,3,79,32,6,117,229,12,358
1153012,9,4,13,56,37,0,93,320,50,463
1153013,6,0,6,41,19,3,63,148,24,235
1153014,8,0,11,68,23,0,91,269,35,395
1153015,8,0,8,70,23,3,96,124,10,230
1153016,6,3,9,91,13,0,104,231,14,349
1153017,9,0,9,43,30,9,82,138,14,234
1153018,3,0,3,75,34,0,109,208,18,335
1153019,33,3,36,66,42,0,108,227,19,354
1153020,4,0,4,31,12,0,43,59,3,105
1153021,13,0,13,60,26,3,89,164,37,290
1153022,12,3,15,85,26,0,111,259,20,390
1153023,4,0,4,85,34,8,127,249,37,413
1153024,8,0,8,81,24,3,108,202,18,328
1153025,10,3,13,63,36,0,99,221,18,338
1153026,89,3,92,47,11,0,58,296,71,425
1153027,9,0,9,65,35,0,100,231,42,373
1153028,6,5,11,83,33,4,120,278,11,409
1153029,8,0,8,100,22,6,128,316,30,474
1153030,6,0,6,35,12,0,47,156,13,216
1153031,4,4,8,108,22,3,133,280,68,481
1153032,14,4,18,68,45,0,113,292,41,446
1153033,8,0,8,51,14,6,71,160,17,248
1153034,3,4,7,84,30,0,114,275,30,419
1153035,8,0,8,60,12,0,72,207,17,296
1153036,27,3,30,114,50,7,171,282,39,492
1153037,3,0,3,84,36,7,127,270,23,420
1153038,7,0,7,79,34,3,116,391,29,536
1153039,53,7,63,79,56,5,140,348,44,532
1153040,0,3,3,75,19,3,97,228,46,371
1153101,0,0,0,0,0,0,0,0,0,0
1153102,0,0,0,0,0,0,0,0,0,0
1153103,0,0,0,78,36,3,117,163,25,305
1153104,3,0,3,31,18,3,52,104,3,159
1153105,8,3,11,91,43,3,137,350,35,522
1153106,3,0,3,52,36,0,88,196,33,317
1153107,12,0,12,61,34,3,98,179,25,302
1153108,6,3,9,55,19,0,74,152,18,244
1153109,11,4,15,48,52,0,100,238,48,386
1153110,9,0,9,76,49,6,131,333,24,488
1153111,14,0,14,55,29,3,87,220,33,340
1153112,125,25,150,26,13,3,42,309,51,402
1153113,3,4,7,75,54,3,132,297,17,446
1153114,0,0,0,102,13,0,115,194,17,326
1153115,10,3,13,107,44,3,154,296,24,474
1153116,6,3,9,73,41,0,114,310,9,433
1153117,8,0,8,96,46,6,148,267,21,436
1153118,6,3,9,63,31,0,94,253,27,374
1153119,3,0,3,36,20,0,56,175,9,240
1153120,0,3,3,64,33,0,97,224,12,333
1153121,7,4,14,88,27,0,115,237,9,361
1153122,10,0,10,58,55,4,117,298,28,443
1153123,144,18,162,43,60,0,103,525,57,685
1153124,9,0,9,54,28,3,85,201,21,307
1153125,6,0,6,65,26,0,91,196,18,305
1153126,7,3,10,73,25,3,101,193,24,318
1153127,11,0,11,75,38,3,116,179,15,310
1153128,9,0,9,53,22,3,78,144,15,237
1153129,4,3,7,54,25,0,79,135,16,230
1153130,7,0,7,75,27,3,105,223,15,343
1153131,3,6,9,70,36,6,112,202,26,340
1153132,3,3,6,42,33,0,75,149,9,233
1153133,52,0,52,38,37,3,78,246,3,327
1153134,23,5,28,75,46,4,125,223,20,368
1153135,4,0,4,72,40,3,115,206,17,338
1153136,10,0,10,82,41,0,123,296,79,498
1153137,10,0,10,52,45,0,97,308,30,435
1153201,3,0,3,66,18,0,84,205,6,295
1153202,9,3,12,107,30,14,151,288,21,460
1153203,0,0,0,80,31,6,117,149,9,275
1153204,7,0,7,87,30,3,120,190,19,329
1153205,3,3,6,97,34,12,143,175,30,348
1153206,5,0,5,69,19,0,88,162,15,265
1153207,6,0,6,96,31,9,136,168,9,313
1153208,0,0,0,0,0,0,0,4,0,4
1153209,3,0,3,82,38,3,123,186,6,315
1153210,0,0,0,3,0,0,3,0,0,3
1153211,0,0,0,29,23,3,55,99,9,163
1153212,3,0,3,43,28,8,79,100,0,179
1153213,4,0,4,45,25,3,73,114,16,203
1153214,11,6,17,95,38,0,133,289,40,462
1153215,0,0,0,42,13,0,55,92,10,157
1153216,6,0,6,71,27,8,106,170,11,287
1153217,3,0,3,71,34,6,111,141,6,258
1153218,9,0,9,87,26,6,119,224,12,355
1153219,3,0,3,72,26,0,98,126,7,231
1153220,0,0,0,101,52,0,153,243,9,405
1153221,3,0,3,116,35,6,157,230,22,409
1153222,8,0,11,53,15,4,72,104,15,191
1153223,0,0,0,75,33,3,111,238,19,368
1153224,0,0,0,69,19,6,94,186,38,318
1153225,6,0,6,132,72,3,207,267,22,496
1153226,0,0,0,101,54,5,160,238,3,401
1153227,3,0,3,43,15,0,58,152,6,216
1153228,0,3,3,83,27,6,116,233,15,364
1153229,0,0,0,0,0,0,0,0,0,0
1153230,0,0,0,76,40,3,119,155,9,283
1153231,0,0,0,86,43,9,138,197,24,359
1153232,0,0,0,90,37,3,130,229,3,362
1153233,0,0,0,0,0,0,0,0,0,0
1153234,3,0,3,131,56,5,192,235,12,439
1153235,11,3,14,74,51,3,128,255,18,401
1153236,13,3,16,114,28,11,153,262,23,438
1153237,3,0,3,49,19,3,71,120,0,191
1153238,0,0,0,99,41,0,140,258,15,413
1153239,3,0,3,114,48,6,168,292,21,481
1153240,0,0,0,91,15,6,112,176,12,300
1153241,0,0,0,66,37,0,103,194,16,313
1153242,0,0,0,96,17,6,119,217,0,336
1153243,0,0,0,153,44,11,208,231,12,451
1153244,10,0,10,97,30,0,127,206,0,333
1153245,4,0,4,76,64,10,150,191,4,345
1153246,3,0,3,110,42,12,164,185,8,357
1153247,0,0,0,144,50,6,200,222,15,437
1153248,3,0,3,71,21,14,106,236,12,354
1153249,0,0,0,120,41,6,167,306,18,491
1153250,4,0,4,85,34,3,122,254,7,383
1153251,0,3,3,82,27,7,116,211,21,348
1153252,5,0,5,110,39,4,153,300,25,478
1153253,3,0,3,99,35,6,140,153,12,305
1153254,0,0,0,63,28,0,91,150,18,259
1153255,0,0,0,104,29,4,137,163,13,313
1153256,6,0,6,48,26,6,80,119,9,208
1153257,6,0,6,81,56,6,143,252,15,410
1153258,0,0,0,89,28,4,121,153,3,277
1153259,3,0,3,85,33,4,122,180,3,305
1153260,8,0,8,63,11,3,77,133,6,216
1153261,3,0,3,115,41,5,161,198,21,380
1153262,6,0,6,89,39,9,137,277,12,426
1153263,0,0,0,99,45,0,144,230,6,380
1153264,3,0,3,90,46,3,139,166,12,317
1153265,0,0,0,48,50,0,98,238,3,339
1153266,0,0,0,126,59,6,191,293,7,491
1153267,0,0,0,75,29,9,113,117,12,242
1153268,6,3,9,61,29,3,93,200,6,299
1153301,4,0,4,57,12,6,75,114,3,192
1153302,3,0,3,60,43,3,106,171,12,289
1153303,0,0,0,92,30,6,128,232,6,366
1153304,0,0,0,4,0,0,4,5,0,9
1153305,3,0,3,87,49,6,142,214,14,370
1153306,172,11,183,67,28,3,98,427,31,556
1153307,6,0,6,34,21,3,58,99,11,168
1153308,10,0,10,107,52,9,168,265,17,450
1153309,3,0,3,107,53,0,160,264,19,443
1153310,0,0,0,36,19,0,55,155,16,226
1153311,0,0,0,44,21,3,68,148,15,231
1153312,0,0,0,74,25,6,105,157,17,279
1153313,0,0,0,55,12,4,71,102,12,185
1153314,0,0,0,79,47,3,129,195,12,336
1153315,6,0,6,66,26,0,92,166,26,284
1153316,3,0,3,68,44,0,112,175,6,293
1153317,0,0,0,57,18,0,75,125,15,215
1153318,9,3,12,53,25,6,84,174,9,267
1153401,3,0,3,50,24,4,78,203,3,284
1153402,0,0,0,0,0,0,0,0,0,0
1153403,0,0,0,69,24,0,93,178,3,274
1153404,6,0,6,72,27,6,105,240,6,351
1153405,0,0,0,58,18,0,76,234,18,328
1153406,0,0,0,75,20,0,95,282,27,404
1153407,0,0,0,40,27,3,70,138,22,230
1153408,4,0,4,72,33,6,111,332,28,471
1153409,0,0,0,75,44,6,125,281,18,424
1153410,6,0,6,34,17,4,55,112,6,173
1153411,0,0,0,50,13,3,66,146,5,217
1153412,6,6,12,39,38,3,80,252,27,359
1153413,0,0,0,34,20,3,57,140,12,209
1153414,4,0,4,75,45,3,123,327,12,462
1153415,3,3,6,68,25,0,93,210,9,312
1153416,6,0,6,67,32,6,105,250,15,370
1153417,0,0,0,3,0,0,3,0,0,3
1153418,76,0,76,39,13,0,52,248,6,306
1153419,0,0,0,80,22,6,108,238,8,354
1153420,3,0,3,59,23,0,82,300,24,406
1153421,0,0,0,0,0,0,0,0,0,0
1153422,0,3,3,36,16,0,52,150,9,211
1153423,0,0,0,76,17,0,93,248,19,360
1153424,0,0,0,95,44,7,146,315,15,476
1153425,3,0,3,65,14,0,79,169,9,257
1153426,0,0,0,41,12,9,62,171,9,242
1153427,0,0,0,34,18,0,52,149,11,212
1153428,3,0,3,31,14,0,45,138,6,189
1153429,0,0,0,52,20,7,79,134,4,217
1153430,4,0,4,42,15,0,57,161,3,221
1153431,0,3,3,28,15,3,46,180,18,244
1153432,3,0,3,60,24,6,90,215,9,314
1153501,0,0,0,66,19,3,88,184,10,282
1153502,0,0,0,99,22,4,125,257,10,392
1153503,0,0,0,79,25,0,104,192,16,312
1153504,3,0,3,80,20,0,100,228,19,347
1153505,0,0,0,0,0,0,0,5,0,5
1153506,0,0,0,134,39,4,177,254,17,448
1153507,0,0,0,74,29,0,103,246,3,352
1153508,3,0,3,73,18,3,94,154,18,266
1153509,3,0,3,73,19,0,92,180,4,276
1153510,0,0,0,60,16,0,76,205,4,285
1153511,0,0,0,58,18,0,76,122,3,201
1153512,3,0,3,78,19,0,97,249,21,367
1153513,0,0,0,114,38,4,156,293,0,449
1153514,0,0,0,54,33,3,90,234,20,344
1153515,0,0,0,74,22,0,96,205,13,314
1153516,0,0,0,0,0,0,0,0,0,0
1153517,0,0,0,0,0,0,0,0,0,0
1153518,0,0,0,67,12,3,82,179,11,272
1153519,0,0,0,100,29,0,129,338,12,479
1153520,0,0,0,32,15,0,47,85,9,141
1153521,0,0,0,83,23,5,111,143,11,265
1153522,3,0,3,138,28,3,169,248,12,429
1153523,0,0,0,82,15,4,101,179,0,280
1153524,4,0,4,43,28,3,74,155,6,235
1153525,0,0,0,103,31,0,134,288,11,433
1153526,4,0,4,88,17,4,109,236,10,355
1153527,0,0,0,55,8,0,63,182,0,245
1153528,4,0,4,53,24,3,80,175,14,269
1153529,0,0,0,133,22,6,161,197,33,391
1153530,3,0,3,81,25,3,109,234,19,362
1153531,0,0,0,49,8,3,60,111,6,177
1153532,3,3,6,101,41,4,146,285,17,448
1153533,0,3,3,29,10,0,39,103,6,148
1153534,10,0,10,82,43,3,128,259,17,404
1153535,0,0,0,73,41,9,123,175,24,322
1153536,4,0,4,78,36,3,117,243,12,372
1153537,0,0,0,0,0,0,0,0,0,0
1153538,0,0,0,61,9,0,70,163,26,259
1153539,62,3,68,19,15,0,34,187,12,233
1153540,7,0,7,34,22,0,56,126,3,185
1153541,5,0,5,48,33,6,87,228,15,330
1153542,0,0,0,71,27,0,98,238,16,352
1153543,3,0,3,89,28,0,117,236,22,375
1153544,0,0,0,84,6,6,96,163,9,268
1153545,0,0,0,95,27,6,128,134,9,271
1153546,0,0,0,45,11,0,56,113,13,182
1153547,6,0,6,96,45,5,146,237,22,405
1153548,3,0,3,62,12,0,74,133,3,210
1153549,0,0,0,69,33,6,108,157,8,273
1153550,0,0,0,80,11,4,95,211,13,319
1153551,3,0,3,70,18,4,92,170,18,280
1153552,0,0,0,31,29,3,63,217,6,286
1153553,6,3,9,66,27,0,93,211,12,316
1153554,3,0,3,84,49,3,136,254,22,412
1153555,0,0,0,68,34,3,105,188,6,299
1153556,3,0,3,78,32,3,113,196,57,366
1153557,5,0,5,43,18,3,64,172,3,239
1153601,0,0,0,24,12,3,39,124,18,181
1153602,0,0,0,72,26,4,102,157,15,274
1153603,3,3,6,69,18,4,91,139,25,255
1153604,3,3,6,80,17,0,97,153,11,261
1153605,6,0,6,73,21,7,101,152,15,268
1153606,6,0,6,86,15,6,107,181,31,319
1153607,6,3,9,82,13,0,95,142,17,254
1153608,6,0,6,65,15,0,80,115,0,195
1153609,0,0,0,67,24,8,99,235,15,349
1153610,8,6,14,131,36,8,175,224,18,417
1153611,4,0,4,99,29,6,134,217,15,366
1153612,6,0,6,44,21,6,71,107,0,178
1153613,6,0,6,43,39,0,82,162,3,247
1153614,3,0,3,61,38,3,102,195,9,306
1153615,3,0,3,18,25,0,43,129,3,175
1153616,0,0,0,56,42,0,98,208,7,313
1153617,5,3,8,103,47,3,153,309,32,494
1153618,3,3,6,88,29,3,120,324,65,509
1153619,5,5,10,76,28,6,110,158,5,273
1153620,6,6,12,169,11,6,186,213,16,415
1153621,10,3,13,79,42,6,127,253,24,404
1153622,17,6,23,152,22,3,177,228,33,438
1153623,3,3,6,55,33,3,91,181,15,287
1153624,12,0,12,104,35,14,153,250,13,416
1153625,0,0,0,81,36,4,121,261,16,398
1153626,0,0,0,71,22,7,100,199,13,312
1153627,7,0,7,51,21,3,75,135,17,227
1153628,3,0,3,69,39,0,108,145,24,277
1153629,0,0,0,59,20,0,79,160,4,243
1153630,0,0,0,66,30,4,100,178,15,293
1153631,3,0,3,114,30,3,147,296,18,461
1153632,6,3,9,71,38,9,118,179,12,309
1153633,3,0,3,102,29,3,134,213,9,356
1153634,0,0,0,82,18,9,109,238,12,359
1153635,6,4,10,43,22,9,74,144,13,231
1153636,0,0,0,72,13,0,85,152,10,247
1153637,5,0,5,104,28,0,132,220,15,367
1153638,3,0,3,128,31,6,165,207,9,381
1153639,0,0,0,68,45,6,119,210,5,334
1153640,3,0,3,86,27,3,116,174,15,305
1153641,3,0,3,85,25,3,113,181,14,308
1153642,5,3,8,100,42,18,160,223,15,398
1153643,75,8,83,110,24,3,137,381,37,555
1153644,12,3,15,118,34,0,152,268,31,451
1153645,6,0,6,88,59,6,153,221,12,386
1153646,3,0,3,61,37,3,101,204,21,326
1153647,0,0,0,90,34,6,130,262,21,413
1153648,3,0,3,54,23,6,83,199,0,282
1153649,6,3,9,75,63,6,144,225,27,396
1153701,0,0,0,3,3,0,6,12,0,18
1153801,3,0,3,80,30,3,113,170,16,299
1153802,4,0,4,67,28,0,95,106,7,208
1153803,0,0,0,92,33,7,132,212,12,356
1153804,0,0,0,56,11,0,67,150,8,225
1153805,0,0,0,0,0,0,0,4,0,4
1153806,34,5,39,67,26,0,93,192,8,293
1153807,0,0,0,0,0,0,0,3,0,3
1153808,0,0,0,71,44,4,119,157,9,285
1153809,4,0,4,55,16,0,71,273,31,375
1153810,11,0,11,69,23,6,98,159,6,263
1153811,0,0,0,0,0,0,0,0,0,0
1153812,9,0,9,55,28,6,89,169,17,275
1153813,5,3,8,59,31,0,90,229,39,358
1153814,10,5,15,57,21,0,78,156,21,255
1153815,11,3,14,80,46,0,126,203,21,350
1153816,10,26,36,45,12,0,57,156,65,278
1153817,6,0,6,81,23,0,104,301,25,430
1153818,0,0,0,0,7,0,7,6,0,13
1153819,0,0,0,0,0,0,0,0,0,0
1153820,0,0,0,35,22,3,60,164,23,247
1153821,7,4,11,68,22,5,95,188,20,303
1153822,0,0,0,46,29,0,75,152,15,242
1153823,0,0,0,92,40,4,136,209,9,354
1153824,0,0,0,0,0,0,0,0,0,0
1153825,33,15,48,32,11,3,46,257,23,326
1153826,3,0,3,65,24,3,92,291,19,402
1153827,9,3,12,48,27,0,75,207,18,300
1153828,9,3,12,55,30,4,89,238,25,352
1153829,6,0,6,48,16,6,70,152,24,246
1153830,4,0,4,60,19,3,82,143,9,234
1153831,3,0,3,108,49,6,163,240,16,419
1153832,13,6,19,92,32,12,136,255,33,424
1153833,11,7,18,52,21,0,73,224,30,327
1153834,0,0,0,53,24,3,80,188,12,280
1153835,81,60,141,51,19,0,70,260,102,432
1153836,46,4,50,108,19,10,137,308,31,476
1153837,14,5,19,97,32,0,129,399,29,557
1153838,8,0,8,82,45,3,130,231,6,367
1153839,0,0,0,67,33,0,100,126,9,235
1153840,8,4,12,48,14,0,62,81,16,159
1153841,6,3,9,71,25,9,105,235,31,371
1153842,6,0,6,46,14,0,60,125,6,191
1153843,7,0,7,98,41,3,142,376,83,601
1153844,7,0,7,67,30,3,100,303,29,432
1153845,9,3,12,80,31,0,111,324,90,525
1153846,0,0,0,68,23,3,94,248,25,367
1153847,10,0,10,121,48,7,176,309,32,517
1153848,7,0,7,61,34,6,101,178,30,309
1153849,12,4,16,67,22,4,93,164,13,270
1153850,0,0,0,78,15,3,96,254,20,370
1153851,19,3,22,40,9,0,49,147,30,226
1153852,0,0,0,47,25,0,72,211,37,320
1153853,0,0,0,114,26,0,140,403,31,574
1949999,69,53,122,1113,550,44,1707,7209,2820,11736
1979991,0,0,0,0,0,0,0,0,0,0
1979992,0,0,0,0,0,0,0,0,0,0
1979993,0,0,0,6,0,0,6,89,15,110
2100101,11,6,17,68,44,3,115,222,18,355
2100102,6,0,6,28,6,3,37,162,9,208
2100103,3,0,3,131,29,9,169,296,23,488
2100104,3,0,3,204,36,23,263,294,15,572
2100105,4,0,4,42,19,0,61,158,25,244
2100106,7,0,7,118,54,9,181,272,28,481
2100107,12,0,12,45,22,0,67,222,37,326
2100108,10,0,10,88,34,0,122,200,25,347
2100109,9,3,16,81,33,4,118,267,26,411
2100110,3,0,3,118,36,6,160,222,12,394
2100111,0,0,0,91,25,0,116,164,6,286
2100112,3,0,3,76,33,6,115,248,21,384
2100113,0,0,0,82,28,9,119,140,15,274
2100114,10,3,13,85,31,4,120,237,22,379
2100115,0,0,0,119,27,9,155,189,12,356
2100116,0,0,0,277,58,9,344,425,39,808
2100117,0,0,0,0,0,4,4,35,6,45
2100201,6,3,9,116,28,9,153,244,15,412
2100202,7,0,7,58,21,3,82,180,21,283
2100203,4,0,4,72,31,0,103,234,13,350
2100204,7,0,7,49,28,3,80,161,26,267
2100205,20,3,23,69,49,7,125,292,47,464
2100206,4,0,4,48,26,3,77,305,9,391
2100207,6,0,6,66,36,0,102,202,7,311
2100208,12,3,15,66,43,6,115,305,37,457
2100209,0,0,0,0,0,0,0,0,0,0
2100210,0,0,0,0,0,0,0,0,0,0
2100211,8,3,17,76,45,4,125,253,21,399
2100212,6,5,11,47,24,0,71,158,36,265
2100213,36,0,36,63,18,3,84,287,11,382
2100214,5,6,11,57,37,0,94,229,27,350
2100215,10,3,13,97,30,0,127,271,21,419
2100216,5,0,5,51,31,6,88,244,3,335
2100217,4,0,4,46,20,3,69,182,24,275
2100218,5,0,5,66,21,8,95,171,18,284
2100219,0,3,3,10,18,3,31,127,15,173
2100220,3,0,3,51,17,0,68,129,18,215
2100221,4,0,4,44,6,0,50,134,43,227
2100222,11,3,14,87,40,3,130,218,26,374
2100223,72,4,76,74,35,0,109,348,25,482
2100224,12,4,16,61,28,6,95,260,19,374
2100225,17,5,22,28,10,0,38,145,31,214
2100226,4,0,4,24,12,0,36,148,21,205
2100227,6,0,6,57,18,4,79,171,17,267
2100228,14,8,22,36,19,0,55,143,28,226
2100229,7,3,10,40,30,0,70,196,21,287
2100230,7,0,7,51,22,0,73,201,24,298
2100231,4,4,8,65,25,5,95,206,24,325
2100232,6,5,11,41,24,6,71,176,18,265
2100233,4,0,4,60,32,0,92,180,9,281
2100234,0,3,3,16,3,0,19,121,16,156
2100301,0,0,0,27,19,3,49,99,9,157
2100302,6,3,9,57,17,3,77,192,34,303
2100303,6,0,6,38,19,3,60,180,16,256
2100304,3,6,9,48,28,4,80,186,36,302
2100305,15,0,15,76,33,13,122,314,48,484
2100306,6,0,6,37,18,0,55,133,6,194
2100307,6,0,6,42,8,6,56,185,20,261
2100308,3,6,9,64,22,7,93,215,25,333
2100309,6,0,6,107,32,7,146,235,31,412
2100310,16,3,19,70,25,3,98,269,26,393
2100311,0,0,0,91,26,5,122,207,28,357
2100312,0,0,0,109,43,6,158,269,30,457
2100313,0,0,0,116,27,0,143,214,21,378
2100314,4,0,4,69,45,0,114,259,15,388
2100315,0,0,0,97,48,0,145,273,25,443
2100316,68,14,82,56,38,6,100,401,31,532
2100317,9,0,9,68,35,18,121,199,16,336
2100318,6,3,9,106,30,6,142,241,34,417
2100319,44,0,44,58,23,6,87,231,24,342
2100320,9,0,9,57,23,3,83,220,17,320
2100321,4,3,7,64,26,4,94,224,23,341
2100322,10,3,13,110,30,4,144,324,34,502
2100323,3,0,3,75,6,6,87,148,15,250
2100324,0,0,0,75,29,4,108,148,25,281
2100325,0,0,0,59,29,0,88,146,41,275
2100326,3,0,3,155,38,9,202,266,23,491
2100327,3,0,3,150,35,10,195,294,16,505
2100328,6,3,9,77,47,3,127,280,35,442
2100329,8,4,12,106,50,6,162,350,27,539
2100330,4,0,4,85,52,6,143,310,42,495
2100331,6,0,6,71,36,6,113,284,25,422
2100332,6,0,6,92,20,10,122,225,18,365
2100333,4,0,4,111,56,9,176,345,32,553
2100334,14,4,18,73,36,6,115,238,33,386
2100335,17,9,26,73,20,6,99,320,42,461
2100336,0,0,0,0,0,0,0,0,0,0
2100337,0,0,0,79,33,0,112,205,12,329
2100338,0,0,0,28,9,3,40,101,7,148
2100339,6,3,9,35,16,3,54,123,31,208
2100340,6,0,6,77,36,3,116,266,32,414
2100341,3,0,3,38,16,0,54,174,11,239
2100342,4,0,4,78,35,6,119,286,15,420
2100343,0,4,4,46,29,0,75,152,17,244
2100344,58,10,68,17,29,3,49,309,28,386
2100345,3,0,3,96,18,5,119,107,19,245
2100346,0,3,3,70,14,6,90,144,15,249
2100347,3,0,3,76,26,0,102,179,20,301
2100348,0,0,0,38,22,0,60,140,18,218
2100349,10,3,13,69,26,0,95,270,32,397
2100350,0,0,0,42,27,0,69,175,22,266
2100351,7,41,48,50,27,0,77,176,106,359
2100401,4,0,4,104,27,6,137,241,30,408
2100402,36,15,51,50,45,6,101,334,72,507
2100403,3,6,9,197,60,17,274,412,38,724
2100404,6,3,9,60,28,6,94,204,19,317
2100405,3,3,6,124,36,4,164,277,45,486
2100406,5,0,5,49,30,0,79,135,9,223
2100407,9,0,9,73,32,13,118,256,27,401
2100408,12,3,15,72,39,0,111,273,34,418
2100409,3,0,3,51,37,9,97,237,29,363
2100410,6,3,9,42,27,0,69,225,36,330
2100411,10,0,10,85,24,3,112,212,28,352
2100412,6,0,6,100,44,9,153,313,51,517
2100413,0,0,0,0,0,0,0,3,0,3
2100414,0,0,0,45,29,0,74,118,15,207
2100415,0,4,4,36,20,7,63,175,22,260
2100416,26,0,26,82,40,3,125,257,14,396
2100417,12,6,18,68,44,6,118,243,32,393
2100418,0,0,0,33,13,3,49,166,15,230
2100419,0,0,0,114,37,6,157,307,12,476
2100420,8,3,11,74,28,12,114,345,32,491
2100421,3,4,7,54,37,0,91,285,36,412
2100422,6,0,6,78,31,6,115,244,24,383
2100423,3,0,3,38,24,0,62,130,17,209
2100424,6,0,6,65,41,6,112,265,34,411
2100425,11,3,14,75,43,3,121,301,44,466
2100426,7,0,7,68,36,12,116,202,14,332
2100427,5,0,5,56,30,3,89,180,40,309
2100428,8,7,15,40,29,0,69,243,35,347
2100429,6,3,9,51,13,3,67,210,6,283
2100430,13,0,13,71,27,3,101,274,32,407
2100431,0,0,0,65,32,0,97,230,24,351
2100432,13,10,23,53,31,0,84,278,36,398
2100433,6,0,6,59,33,0,92,169,41,302
2100434,3,3,9,62,32,10,104,297,53,454
2100435,24,8,32,38,15,3,56,199,50,305
2100436,6,0,6,103,28,6,137,266,30,433
2100437,7,7,14,50,20,0,70,221,42,333
2100438,8,6,14,76,32,9,117,367,63,547
2100439,10,0,10,92,42,0,134,293,51,478
2100440,5,0,5,64,42,3,109,183,10,302
2100441,8,5,13,106,57,9,172,282,43,497
2100442,4,0,4,54,19,4,77,203,25,305
2100443,0,0,0,3,6,0,9,39,4,52
2100444,3,0,3,41,17,7,65,195,12,272
2100445,8,3,11,83,45,3,131,327,39,497
2100446,7,3,10,49,21,4,74,151,25,250
2100447,5,0,5,62,24,7,93,232,18,343
2100448,6,0,6,52,33,0,85,157,31,273
2100449,22,24,46,17,15,3,35,133,83,251
2100450,0,0,0,166,47,14,227,329,22,578
2100451,5,0,5,90,27,6,123,190,13,326
2100501,3,0,3,70,25,4,99,138,20,257
2100502,9,3,12,131,49,3,183,317,29,529
2100503,6,0,6,143,65,10,218,354,24,596
2100504,0,4,4,88,40,5,133,229,20,382
2100505,0,0,0,4,17,3,24,270,24,318
2100506,0,0,0,108,39,0,147,277,9,433
2100507,4,0,4,67,24,7,98,181,6,285
2100508,0,3,3,55,34,0,89,205,24,318
2100509,0,7,7,31,29,0,60,134,12,206
2100510,3,0,3,57,12,0,69,163,32,264
2100511,0,0,0,57,13,0,70,146,6,222
2100512,0,0,0,47,24,0,71,139,4,214
2100513,6,0,6,60,32,0,92,152,28,272
2100514,0,0,0,25,9,0,34,100,6,140
2100515,0,0,0,65,35,0,100,180,16,296
2100516,0,0,0,62,38,3,103,167,10,280
2100517,6,0,6,61,21,4,86,164,3,253
2100601,4,0,4,61,21,0,82,183,35,300
2100602,0,0,0,70,30,12,112,212,30,354
2100603,0,0,0,69,26,0,95,173,14,282
2100604,0,0,3,85,32,0,117,135,15,267
2100605,0,0,0,123,48,13,184,232,15,431
2100606,4,0,4,66,33,4,103,179,6,288
2100607,3,0,3,37,24,8,69,134,11,214
2100608,0,0,0,35,18,3,56,85,3,144
2100609,25,6,31,130,57,10,197,509,50,756
2100610,3,0,3,52,37,0,89,264,21,374
2100611,3,0,3,49,33,6,88,213,25,326
2100612,0,3,3,106,39,0,145,208,25,378
2100613,0,3,3,46,16,3,65,134,35,234
2100614,0,3,6,14,6,4,24,66,12,102
2100701,0,0,0,84,39,12,135,173,26,334
2100702,0,0,0,62,27,3,92,174,0,266
2100703,0,0,0,61,15,3,79,148,38,265
2100704,0,0,0,97,31,9,137,188,13,338
2100705,5,0,5,94,29,3,126,185,11,322
2100706,3,0,3,106,41,0,147,227,18,392
2100707,0,4,4,103,28,0,131,218,36,385
2100708,0,0,0,78,22,4,104,182,10,296
2100709,0,0,0,67,21,5,93,156,12,261
2100801,0,0,0,39,13,0,52,123,42,217
2100802,0,0,0,33,24,3,60,98,12,170
2100803,0,0,0,88,34,6,128,283,37,448
2100804,3,0,3,62,16,3,81,158,37,276
2100805,3,0,3,44,9,3,56,187,31,274
2100806,0,0,0,65,24,9,98,199,35,332
2100807,11,5,16,39,35,3,77,216,23,316
2100808,0,3,3,0,0,0,0,0,3,3
2100809,21,3,24,71,25,3,99,310,35,444
2100810,4,0,4,77,33,9,119,248,33,400
2100811,3,0,3,44,8,0,52,122,8,182
2100812,7,4,11,42,22,7,71,179,24,274
2100813,4,3,7,37,29,0,66,166,20,252
2100814,0,0,0,0,0,0,0,0,0,0
2100815,6,0,6,49,17,9,75,169,39,283
2100816,0,3,3,50,27,4,81,144,24,249
2100817,0,0,0,51,22,3,76,103,15,194
2100818,0,0,0,99,15,3,117,187,13,317
2100819,0,0,0,333,87,22,442,660,30,1132
2100820,0,3,3,55,35,0,90,244,27,361
2100821,7,6,13,43,38,3,84,261,34,379
2100822,11,0,11,20,32,0,52,174,23,249
2100823,10,3,13,79,46,6,131,297,52,480
2100824,38,80,118,44,23,0,67,275,171,513
2100825,8,10,18,30,15,0,45,218,30,293
2100826,22,0,22,59,38,0,97,280,29,406
2100827,15,8,23,63,39,0,102,290,42,434
2100828,16,3,19,51,35,0,86,223,19,328
2100829,4,0,4,48,34,0,82,131,12,225
2100830,10,7,17,43,29,12,84,233,22,339
2100831,6,4,10,50,29,4,83,211,33,327
2100832,6,0,6,81,20,0,101,248,56,405
2100833,6,0,6,80,54,3,137,274,29,440
2100834,4,0,4,43,22,0,65,163,17,245
2100835,4,0,4,72,21,3,96,145,13,254
2100901,7,0,7,104,29,5,138,243,24,405
2100902,7,0,7,40,6,6,52,147,14,213
2100903,6,0,6,85,18,6,109,195,20,324
2100904,0,0,0,43,11,3,57,98,12,167
2100905,3,3,6,36,18,0,54,164,36,254
2100906,0,3,3,33,9,0,42,157,6,205
2100907,0,0,0,59,15,3,77,185,20,282
2100908,3,6,9,42,21,0,63,174,19,256
2100909,0,0,0,66,28,0,94,171,3,268
2100910,3,6,9,44,35,0,79,142,22,243
2100911,0,0,0,51,12,0,63,133,15,211
2100912,6,0,6,63,6,6,75,167,10,252
2100913,24,6,30,43,31,0,74,167,21,262
2100914,0,0,0,33,22,3,58,94,20,172
2100915,3,3,6,37,17,3,57,149,21,227
2100916,15,3,18,49,37,6,92,187,34,313
2100917,3,3,6,82,33,4,119,236,16,371
2101001,0,3,3,51,16,0,67,215,26,308
2101002,3,0,3,80,33,0,113,216,25,354
2101003,10,4,14,41,21,3,65,173,19,257
2101004,3,0,3,49,15,3,67,150,12,229
2101005,65,0,65,15,19,6,40,175,15,230
2101006,0,3,3,65,38,6,109,217,25,351
2101007,0,0,0,62,24,0,86,178,26,290
2101008,0,0,0,70,28,6,104,185,13,302
2101009,0,0,0,36,15,0,51,111,10,172
2101010,6,0,6,46,20,3,69,143,37,249
2101011,3,0,3,39,29,0,68,177,5,250
2101012,11,5,16,59,38,0,97,234,44,375
2101013,7,3,10,52,27,3,82,193,24,299
2101014,4,0,4,41,20,0,61,155,20,236
2101015,6,0,6,45,20,0,65,185,18,268
2101016,5,0,5,44,22,0,66,155,15,236
2101017,0,0,0,44,24,3,71,149,21,241
2101018,0,0,0,66,14,0,80,172,16,268
2101019,7,0,7,75,23,3,101,314,40,455
2101020,6,7,13,83,32,3,118,326,26,470
2101021,4,0,4,30,19,3,52,146,18,216
2101101,4,0,4,75,16,6,97,218,19,334
2101102,7,0,7,29,11,0,40,104,9,153
2101103,4,0,4,46,14,3,63,149,21,233
2101104,6,0,6,36,11,0,47,127,29,203
2101105,0,0,0,33,7,3,43,145,28,216
2101106,5,0,5,59,22,11,92,226,21,339
2101107,0,0,0,76,25,7,108,227,24,359
2101108,15,3,18,20,22,3,45,157,17,219
2101109,17,0,17,29,24,3,56,166,45,267
2101110,6,0,6,56,18,0,74,155,18,247
2101111,6,0,6,51,8,5,64,151,14,229
2101112,13,3,16,69,41,0,110,303,34,447
2101113,3,3,6,86,26,10,122,192,33,347
2101114,7,3,10,42,14,6,62,163,27,252
2101115,29,7,36,55,31,3,89,266,56,411
2101116,11,3,14,36,15,0,51,234,23,308
2101117,3,3,6,46,15,3,64,174,27,265
2101118,3,0,3,30,29,0,59,194,18,271
2101119,0,3,3,32,17,0,49,204,24,277
2101120,3,0,3,59,21,3,83,159,19,261
2101121,3,0,3,53,13,3,69,153,15,237
2101122,3,4,7,52,24,3,79,208,45,332
2101123,4,0,4,37,19,4,60,202,18,280
2101124,0,0,0,30,14,0,44,143,27,214
2101125,6,3,9,61,18,0,79,230,30,339
2101201,0,0,0,50,18,12,80,157,19,256
2101202,0,3,3,35,7,7,49,71,7,127
2101203,3,0,3,87,22,4,113,178,14,305
2101204,0,0,0,38,16,0,54,127,11,192
2101205,0,0,0,62,21,6,89,176,22,287
2101206,0,0,0,52,23,0,75,132,12,219
2101207,3,3,6,40,30,3,73,124,9,206
2101208,0,0,0,45,16,0,61,123,22,206
2101209,9,0,9,64,19,0,83,160,30,273
2101210,6,0,6,61,38,0,99,202,28,329
2101211,11,0,11,49,23,4,76,216,26,318
2101212,0,0,0,34,8,6,48,105,12,165
2101213,0,0,0,54,17,0,71,175,18,264
2101214,7,0,7,66,6,6,78,204,21,303
2101215,0,0,0,35,7,0,42,124,18,184
2101216,0,0,0,67,17,0,84,197,20,301
2101217,5,0,5,63,31,9,103,276,11,390
2101301,0,6,6,66,21,3,90,267,25,382
2101302,0,3,3,40,11,0,51,120,12,183
2101303,3,0,3,39,18,0,57,170,13,240
2101304,0,3,3,64,25,3,92,226,28,346
2101305,7,3,10,49,21,6,76,260,21,357
2101306,23,0,23,36,6,0,42,185,13,240
2101307,6,0,6,41,12,0,53,124,12,189
2101308,3,0,3,63,42,9,114,226,24,364
2101309,3,0,3,37,19,5,61,158,3,222
2101310,4,0,4,19,17,6,42,149,25,216
2101401,12,3,15,42,25,6,73,234,30,337
2101402,25,3,28,23,14,0,37,169,33,239
2101403,6,0,6,61,29,6,96,197,23,316
2101404,0,0,0,47,23,4,74,247,23,344
2101405,3,0,3,53,9,6,68,117,15,200
2101406,0,3,3,55,21,0,76,126,132,334
2101407,0,0,0,35,17,0,52,179,15,246
2101408,0,3,3,61,23,6,90,216,24,330
2101409,6,0,6,26,9,0,35,152,12,199
2101410,3,0,3,21,11,0,32,91,7,130
2101411,0,0,0,49,24,0,73,144,26,243
2101412,4,4,8,42,10,0,52,170,37,259
2101413,0,0,0,3,3,0,6,0,0,6
2101501,3,0,3,97,41,3,141,267,17,425
2101502,0,0,0,45,11,0,56,162,22,240
2101503,0,0,0,85,13,0,98,138,27,263
2101504,0,0,0,32,12,3,47,150,3,200
2101505,4,3,7,45,27,0,72,265,18,355
2101506,6,3,9,50,14,3,67,202,26,295
2101507,0,3,3,71,26,3,100,249,51,400
2101508,0,3,3,31,27,3,61,121,10,192
2101509,3,0,3,81,22,3,106,188,16,310
2101510,0,3,3,37,13,0,50,104,9,163
2101511,3,0,3,47,16,7,70,119,5,194
2101512,0,0,0,62,11,0,73,137,9,219
2101601,4,3,7,35,6,0,41,100,16,157
2101602,19,0,19,43,31,3,77,331,58,466
2101603,6,0,6,61,33,3,97,200,28,325
2101604,9,7,16,53,11,3,67,198,43,308
2101605,0,3,3,47,9,3,59,115,37,211
2101606,11,0,11,55,28,3,86,235,36,357
2101607,11,0,11,53,32,3,88,238,25,351
2101608,6,3,9,42,19,0,61,186,19,266
2101609,4,0,7,54,18,0,72,214,31,317
2101610,17,0,17,85,21,0,106,274,19,399
2101611,0,0,0,19,14,3,36,100,15,151
2101612,7,0,7,83,30,3,116,233,29,378
2101613,68,9,77,53,17,0,70,340,42,452
2101614,7,0,7,67,17,0,84,183,34,301
2101615,30,3,33,9,15,0,24,196,22,242
2101616,10,3,13,31,28,4,63,278,36,377
2101617,13,0,13,45,12,3,60,180,35,275
2101618,6,5,11,25,10,0,35,141,24,200
2101619,11,0,11,57,33,14,104,210,22,336
2101620,4,0,4,41,25,0,66,166,15,247
2101621,0,0,0,40,25,0,65,146,12,223
2101701,10,0,10,42,14,0,56,222,20,298
2101702,5,0,5,48,17,0,65,125,13,203
2101703,5,3,8,45,11,0,56,142,12,210
2101704,5,0,5,36,5,0,41,193,19,253
2101705,11,3,14,22,18,0,40,196,19,255
2101706,6,0,6,33,16,0,49,153,16,218
2101707,6,0,6,65,26,4,95,249,29,373
2101708,7,6,13,25,15,6,46,155,33,234
2101709,3,0,6,66,20,6,92,249,16,357
2101710,0,0,0,53,21,9,83,294,26,403
2101711,4,3,7,50,16,3,69,205,19,293
2101712,0,0,0,57,30,0,87,306,33,426
2101713,0,0,0,31,7,0,38,182,4,224
2101714,0,0,0,34,24,3,61,208,18,287
2101715,3,0,3,31,15,3,49,157,9,215
2101801,3,0,3,87,30,0,117,221,66,404
2101802,5,0,5,33,12,0,45,152,26,223
2101803,8,0,8,77,29,0,106,243,18,367
2101804,90,7,97,20,11,0,31,187,10,228
2101805,5,46,51,59,26,0,85,172,124,381
2101806,23,17,40,42,34,3,79,236,45,360
2101807,4,0,4,69,42,9,120,191,25,336
2101808,3,0,3,32,12,3,47,90,9,146
2101809,6,4,10,57,31,3,91,222,20,333
2101810,6,3,9,36,25,0,61,187,21,269
2101811,6,6,12,64,11,0,75,225,31,331
2101812,0,0,0,50,19,5,74,120,21,215
2101813,0,0,0,58,30,0,88,249,41,378
2101814,6,3,9,34,16,6,56,108,29,193
2101815,7,3,10,89,35,3,127,284,34,445
2101816,4,4,8,50,32,4,86,241,49,376
2101817,3,0,3,72,27,8,107,231,40,378
2101818,7,3,10,52,27,3,82,218,19,319
2101819,3,0,3,38,19,3,60,141,21,222
2101820,8,28,36,15,3,0,18,90,75,183
2101821,6,0,6,40,25,6,71,205,19,295
2101822,6,0,6,58,23,0,81,182,16,279
2101823,0,0,0,54,34,0,88,187,19,294
2101824,5,0,5,70,30,0,100,272,12,384
2101825,30,3,33,29,12,3,44,220,32,296
2101826,0,3,3,37,14,3,54,163,26,243
2101827,6,0,6,69,29,0,98,235,52,385
2101828,6,0,6,56,38,3,97,188,52,337
2101829,3,3,6,32,6,3,41,110,9,160
2101830,8,0,8,97,51,6,154,347,31,532
2101831,10,0,10,88,41,0,129,261,31,421
2101832,13,0,13,70,25,0,95,191,27,313
2101833,7,0,7,63,39,6,108,240,25,373
2101834,3,3,6,58,19,9,86,177,27,290
2101835,7,6,13,52,48,9,109,333,36,478
2101836,3,0,3,33,8,0,41,135,20,196
2101837,6,3,9,68,36,0,104,260,30,394
2101838,0,0,0,28,12,3,43,116,12,171
2101901,9,5,14,73,41,4,118,278,45,441
2101902,7,3,10,84,63,11,158,303,42,503
2101903,11,3,14,53,22,3,78,192,16,286
2101904,3,0,3,81,31,6,118,195,38,351
2101905,8,5,13,61,38,6,105,317,44,466
2101906,3,0,3,6,9,4,19,56,3,78
2101907,6,0,6,53,28,0,81,220,26,327
2101908,11,3,14,71,26,3,100,307,31,438
2101909,8,7,15,102,41,6,149,329,50,528
2101910,0,0,0,83,30,6,119,190,24,333
2101911,6,0,6,57,11,3,71,135,34,240
2101912,3,0,3,47,27,0,74,152,18,244
2101913,3,3,6,62,32,6,100,225,34,359
2101914,16,3,19,72,30,6,108,243,59,410
2101915,3,0,3,53,29,0,82,204,23,309
2101916,48,0,48,34,22,0,56,201,21,278
2101917,4,0,4,30,6,0,36,83,11,130
2101918,3,0,3,47,9,4,60,139,24,223
2101919,3,0,3,53,43,6,102,262,46,410
2101920,4,0,4,129,36,6,171,275,27,473
2101921,0,0,0,124,31,6,161,146,12,319
2101922,4,0,4,104,23,4,131,287,26,444
2101923,4,0,4,40,16,4,60,136,4,200
2101924,6,0,6,65,15,0,80,155,28,263
2102001,0,0,0,46,11,3,60,154,16,230
2102002,3,3,6,31,20,0,51,124,6,181
2102003,8,0,8,44,23,0,67,164,18,249
2102004,12,6,18,40,22,3,65,210,28,303
2102005,5,6,11,66,26,3,95,297,32,424
2102006,27,3,30,65,17,0,82,225,21,328
2102007,4,0,4,33,9,3,45,161,0,206
2102008,0,0,0,32,16,0,48,107,0,155
2102009,0,0,0,59,28,4,91,177,10,278
2102010,8,3,11,48,32,3,83,233,18,334
2102011,12,3,15,100,50,6,156,279,33,468
2102012,6,0,6,53,21,0,74,164,12,250
2102013,10,3,13,43,25,0,68,165,25,258
2102014,0,0,0,39,16,0,55,117,27,199
2102015,12,5,17,54,19,0,73,213,13,299
2102016,9,4,13,35,27,0,62,139,16,217
2102017,3,26,29,37,17,0,54,118,62,234
2102018,16,3,19,65,39,9,113,302,30,445
2102019,9,3,12,89,41,3,133,301,35,469
2102020,0,3,6,28,22,3,53,146,15,214
2102021,9,0,9,89,36,3,128,216,15,359
2102022,5,0,5,43,25,0,68,132,0,200
2102023,10,3,13,28,9,3,40,138,27,205
2102024,7,3,10,43,27,3,73,229,18,320
2102025,15,0,15,78,38,10,126,338,24,488
2102026,19,7,26,49,44,3,96,281,37,414
2102027,34,10,44,18,4,0,22,154,22,198
2102028,9,6,15,73,27,5,105,208,27,340
2102029,14,3,17,54,29,0,83,281,20,384
2102030,6,8,14,86,15,4,105,199,50,354
2102031,9,0,9,79,32,0,111,320,31,462
2102032,11,3,14,58,26,0,84,214,19,317
2102033,27,3,30,68,28,4,100,280,20,400
2102034,6,0,6,61,24,4,89,241,15,345
2102035,5,0,5,56,18,3,77,231,3,311
2102036,3,3,6,48,26,0,74,187,21,282
2102037,0,0,0,0,0,0,0,0,0,0
2102038,68,7,75,16,14,3,33,200,29,262
2102039,0,0,0,0,0,0,0,13,6,19
2102101,6,3,9,47,33,6,86,156,24,266
2102102,40,6,46,72,33,3,108,259,21,388
2102103,11,3,14,56,22,0,78,176,30,284
2102104,19,3,22,68,46,11,125,300,34,459
2102105,6,0,6,52,20,0,72,266,23,361
2102106,3,3,6,35,18,4,57,107,15,179
2102107,3,0,3,81,32,0,113,242,12,367
2102108,0,0,0,19,54,3,76,311,17,404
2102109,4,0,4,64,30,9,103,216,16,335
2102110,3,0,3,88,35,0,123,219,25,367
2102111,52,12,64,53,34,6,93,281,31,405
2102112,6,0,6,47,14,6,67,143,3,213
2102113,3,3,6,45,39,0,84,135,9,228
2102114,5,0,5,61,20,3,84,199,3,286
2102115,4,0,4,60,31,3,94,267,30,391
2102116,6,0,6,48,22,0,70,130,25,225
2102117,3,3,6,71,12,8,91,158,13,262
2102118,3,4,7,79,31,9,119,258,22,399
2102119,4,3,7,60,37,3,100,306,41,447
2102120,4,0,4,57,16,4,77,183,9,269
2102121,5,0,5,30,19,0,49,175,28,252
2102122,0,0,0,38,22,3,63,80,3,146
2102123,0,0,0,0,0,0,0,0,0,0
2102124,0,0,0,0,0,0,0,0,0,0
2102125,3,0,3,60,29,0,89,187,15,291
2102126,4,0,4,82,28,4,114,185,25,324
2102127,0,0,0,0,0,0,0,0,0,0
2102201,3,0,3,61,28,6,95,242,28,365
2102202,14,7,21,67,30,6,103,324,40,467
2102203,49,6,55,30,9,0,39,174,16,229
2102204,13,3,16,33,20,4,57,234,23,314
2102205,3,0,3,76,26,0,102,195,15,312
2102206,6,6,12,71,33,0,104,179,15,298
2102207,0,0,0,62,25,9,96,207,18,321
2102208,3,0,3,59,29,4,92,260,20,372
2102209,4,0,4,73,43,4,120,255,14,389
2102210,0,0,0,80,30,0,110,201,28,339
2102211,12,3,15,84,26,5,115,236,26,377
2102212,3,0,3,54,39,6,99,207,24,330
2102213,8,3,11,20,12,0,32,124,18,174
2102214,4,0,4,51,10,5,66,171,19,256
2102215,6,3,9,40,14,0,54,165,12,231
2102216,26,8,34,83,42,9,134,365,31,530
2102217,10,0,10,47,39,0,86,282,46,414
2102218,13,5,18,92,34,4,130,262,15,407
2102219,8,5,13,59,35,0,94,177,14,285
2102220,0,3,3,22,6,0,28,119,33,180
2102221,35,0,35,28,20,4,52,266,31,349
2102222,0,0,0,138,45,13,196,205,9,410
2102223,6,0,6,75,33,0,108,274,26,408
2102224,4,0,4,84,35,6,125,214,22,361
2102225,28,3,31,97,42,0,139,329,31,499
2102226,0,0,0,52,19,0,71,168,12,251
2102227,0,4,4,90,31,12,133,272,35,440
2102228,8,3,11,84,38,7,129,266,54,449
2102229,0,0,0,98,24,10,132,237,24,393
2102230,15,6,21,42,13,0,55,210,30,295
2102231,11,3,14,46,34,3,83,224,37,344
2102232,8,0,8,58,53,3,114,268,24,406
2102233,0,0,0,57,15,3,75,145,6,226
2102234,0,0,0,43,21,6,70,117,14,201
2102235,4,4,8,70,35,0,105,234,16,355
2102236,14,4,18,97,44,12,153,347,41,541
2102237,0,0,0,104,28,6,138,259,17,414
2102238,4,3,7,60,34,4,98,231,16,345
2102239,6,3,9,66,31,4,101,207,19,327
2102240,0,3,3,31,15,0,46,104,15,165
2102241,11,52,63,83,36,12,131,240,133,504
2102242,4,0,4,48,10,4,62,131,13,206
2102243,15,0,15,34,28,0,62,179,18,259
2102244,4,0,4,56,19,4,79,158,13,250
2102301,0,3,3,88,40,0,128,245,16,389
2102302,0,0,0,127,27,0,154,227,6,387
2102303,0,0,0,210,35,12,257,257,21,535
2102304,3,3,6,190,36,8,234,246,24,504
2102305,0,0,0,141,34,5,180,235,13,428
2102306,0,0,0,53,29,0,82,191,19,292
2102307,0,0,0,70,36,10,116,190,4,310
2102308,0,0,0,116,34,10,160,227,26,413
2102401,3,0,3,43,12,0,55,92,7,154
2102402,0,0,0,49,16,0,65,177,9,251
2102403,0,0,0,32,11,0,43,103,0,146
2102404,0,0,0,195,75,16,286,380,25,691
2102405,3,0,3,120,35,14,169,207,20,396
2102406,3,0,3,188,39,17,244,268,8,520
2102407,3,0,3,133,32,13,178,174,22,374
2102408,3,0,3,165,28,9,202,206,9,417
2102409,0,0,0,178,26,3,207,207,9,423
2102410,0,0,0,132,32,9,173,228,23,424
2102411,0,0,0,55,26,0,81,175,12,268
2102412,0,4,4,96,30,6,132,256,19,407
2102413,0,0,0,52,22,3,77,167,6,250
2102414,0,0,0,59,19,0,78,177,6,261
2102415,0,0,0,31,11,10,52,113,9,174
2102501,9,3,12,90,36,3,129,238,33,400
2102502,4,0,4,76,37,6,119,206,15,340
2102503,0,0,0,104,39,8,151,209,10,370
2102504,9,0,9,47,19,0,66,125,12,203
2102505,14,5,19,52,27,6,85,219,38,342
2102506,3,3,6,47,19,3,69,210,17,296
2102507,0,0,0,0,0,0,0,5,0,5
2102508,0,4,4,277,50,14,341,549,54,944
2102509,3,0,3,75,42,0,117,216,23,356
2102510,0,0,0,54,46,4,104,194,17,315
2102511,0,4,4,46,28,3,77,164,25,266
2102512,0,0,0,50,25,0,75,148,10,233
2102513,3,0,3,140,37,4,181,318,29,528
2102514,4,0,4,72,32,0,104,223,11,338
2102515,0,0,0,33,7,4,44,129,13,186
2102516,3,0,3,62,26,0,88,122,12,222
2102517,3,0,3,101,32,3,136,196,29,361
2102518,0,0,0,120,37,15,172,235,23,430
2102519,0,0,0,71,25,3,99,177,18,294
2102520,10,3,13,63,30,9,102,275,26,403
2102601,3,0,3,68,11,3,82,158,10,250
2102602,0,0,0,59,23,6,88,112,10,210
2102603,0,0,0,89,35,13,137,212,22,371
2102604,3,3,6,69,29,0,98,173,30,301
2102605,3,0,3,63,24,0,87,151,9,247
2102606,3,0,3,40,18,0,58,69,3,130
2102607,0,0,0,63,35,0,98,202,27,327
2102608,3,0,3,68,10,0,78,180,15,273
2102609,3,0,3,42,22,0,64,137,19,220
2102610,3,0,3,51,21,0,72,150,9,231
2102611,3,0,3,100,36,0,136,196,18,350
2102612,0,3,3,79,31,3,113,182,26,321
2102613,0,0,0,116,28,5,149,210,11,370
2102614,0,3,3,41,14,5,60,115,6,181
2102615,0,0,0,52,15,0,67,139,25,231
2102616,6,0,6,43,31,10,84,149,12,245
2102617,0,0,0,13,12,6,31,64,3,98
2102618,3,0,3,67,19,0,86,150,15,251
2102619,0,0,0,61,21,3,85,135,9,229
2102701,9,3,12,63,12,3,78,200,18,296
2102702,4,3,7,43,15,4,62,217,16,295
2102703,0,0,0,0,0,0,0,0,400,400
2102704,5,7,12,40,21,9,70,196,24,290
2102705,5,6,11,47,21,3,71,197,44,312
2102706,7,0,7,60,34,12,106,208,36,350
2102707,3,0,3,34,14,4,52,138,15,205
2102708,10,0,10,103,24,13,140,315,30,485
2102709,0,0,0,41,19,7,67,167,6,240
2102710,3,3,6,52,24,0,76,152,9,237
2102711,3,3,6,44,21,6,71,165,16,252
2102712,0,0,0,53,22,6,81,186,12,279
2102713,12,0,12,75,27,3,105,195,23,323
2102714,5,3,8,49,18,6,73,157,27,257
2102715,16,6,22,67,28,16,111,238,25,374
2102716,14,3,17,20,30,3,53,155,18,226
2102717,12,3,15,51,29,3,83,200,30,313
2102718,3,93,96,34,26,3,63,160,164,387
2102719,16,4,20,48,24,4,76,241,34,351
2102720,9,3,12,34,26,7,67,187,18,272
2102721,7,0,7,95,40,9,144,222,33,399
2102722,7,3,10,30,21,3,54,146,28,228
2102723,7,0,7,34,13,3,50,151,18,219
2102724,3,3,6,35,8,0,43,115,9,167
2102725,11,3,14,73,18,6,97,172,19,288
2102726,9,3,12,67,29,3,99,255,19,373
2102727,11,0,11,58,20,4,82,211,21,314
2102801,0,0,4,47,13,3,63,106,17,186
2102802,9,3,12,64,40,9,113,285,41,439
2102803,0,0,0,51,23,0,74,193,21,288
2102804,3,0,3,33,11,3,47,149,21,217
2102805,4,0,4,48,28,0,76,190,7,273
2102806,4,0,4,36,18,0,54,153,15,222
2102807,3,0,3,39,20,3,62,183,7,252
2102808,4,0,4,58,39,0,97,219,19,335
2102809,0,0,0,16,12,6,34,81,65,180
2102810,18,28,46,38,32,4,74,274,57,405
2102811,0,0,0,40,22,3,65,156,21,242
2102812,0,0,0,28,5,0,33,107,16,156
2102813,3,0,3,42,28,3,73,168,16,257
2102814,3,0,3,65,25,6,96,140,24,260
2102815,3,0,3,81,20,7,108,235,31,374
2102816,0,0,0,60,26,3,89,181,27,297
2102817,0,0,0,25,16,0,41,137,24,202
2102818,10,0,10,50,21,6,77,191,12,280
2102819,0,0,0,50,20,0,70,115,0,185
2102820,3,6,9,76,30,3,109,218,25,352
2102821,5,0,5,22,19,6,47,156,3,206
2102822,3,0,3,37,9,3,49,126,15,190
2102823,0,0,0,38,15,3,56,208,9,273
2102824,0,0,0,66,35,4,105,198,16,319
2102825,4,0,4,21,16,0,37,78,10,125
2102826,10,0,10,53,24,4,81,241,24,346
2102901,11,3,17,38,21,0,59,288,74,421
2102902,3,0,3,12,18,9,39,169,26,234
2102903,3,0,3,39,15,0,54,118,9,181
2102904,0,3,3,32,15,0,47,172,24,243
2102905,3,0,3,33,11,0,44,149,27,220
2102906,0,0,0,39,16,0,55,148,26,229
2102907,3,0,3,55,34,3,92,263,32,387
2102908,7,0,7,27,31,3,61,227,28,316
2102909,3,3,6,24,18,0,42,178,33,253
2102910,36,7,43,24,12,0,36,242,40,318
2102911,3,0,3,52,33,4,89,161,16,266
2102912,3,0,3,43,16,3,62,169,32,263
2102913,0,3,6,25,12,0,37,93,15,145
2103001,3,3,6,53,24,0,77,226,23,326
2103002,0,0,0,64,17,6,87,184,15,286
2103003,3,3,6,84,28,3,115,234,27,376
2103004,0,0,0,78,19,6,103,242,19,364
2103005,3,0,3,52,17,6,75,141,10,226
2103006,0,0,0,49,18,0,67,161,11,239
2103007,0,0,0,45,28,3,76,210,9,295
2103008,4,0,4,25,10,3,38,108,14,160
2103009,3,0,3,60,26,3,89,172,24,285
2103010,0,3,3,52,24,6,82,158,33,273
2103011,3,0,6,35,21,3,59,173,12,244
2103012,9,3,12,62,38,9,109,258,22,389
2103013,9,3,12,57,42,9,108,262,37,407
2103014,5,0,5,16,17,3,36,151,18,205
2103015,10,0,10,31,31,0,62,250,14,326
2103016,14,0,14,71,27,4,102,201,31,334
2103017,5,0,5,87,29,6,122,326,35,483
2103018,47,4,51,61,35,3,99,309,33,441
2103019,40,0,40,79,22,11,112,325,26,463
2103020,22,0,22,107,51,10,168,331,27,526
2103021,7,0,7,71,29,6,106,225,15,346
2103022,0,0,0,0,0,0,0,6,0,6
2103023,0,0,0,68,9,5,82,124,21,227
2103101,6,0,6,96,18,16,130,229,23,382
2103102,6,6,12,133,31,10,174,301,21,496
2103103,0,0,0,84,17,4,105,166,9,280
2103104,4,0,4,93,20,6,119,257,13,389
2103105,3,0,3,103,18,10,131,253,32,416
2103106,0,0,0,57,27,3,87,124,11,222
2103107,0,0,0,89,48,3,140,277,10,427
2103108,0,0,0,59,18,7,84,129,27,240
2103109,3,0,3,40,13,0,53,107,9,169
2103110,0,0,0,52,16,3,71,131,9,211
2103111,0,0,0,83,26,6,115,169,3,287
2103112,4,0,4,46,18,9,73,125,6,204
2103113,6,0,6,84,38,8,130,169,12,311
2103114,7,0,7,48,19,0,67,111,29,207
2103115,12,0,12,72,20,0,92,259,43,394
2103116,50,0,50,73,17,6,96,259,53,408
2103201,4,0,4,100,29,9,138,237,3,378
2103202,6,3,9,50,26,0,76,183,41,300
2103203,3,0,3,52,7,0,59,131,12,202
2103204,6,0,6,54,19,0,73,146,21,240
2103205,3,0,3,61,20,6,87,165,21,273
2103206,4,0,4,66,34,3,103,210,21,334
2103207,3,0,3,67,34,3,104,245,20,369
2103208,0,0,0,47,10,0,57,147,15,219
2103209,5,0,5,49,23,8,80,164,12,256
2103210,3,0,3,28,11,3,42,102,12,156
2103211,3,0,3,44,26,6,76,158,9,243
2103212,4,0,4,19,9,0,28,81,8,117
2103213,12,3,15,30,24,0,54,177,37,268
2103301,29,6,35,35,21,0,56,277,48,381
2103302,6,0,6,49,22,3,74,194,36,304
2103303,0,0,0,33,20,0,53,115,6,174
2103304,9,0,9,29,23,3,55,196,16,267
2103305,0,3,3,56,21,12,89,122,25,236
2103306,8,0,8,56,25,3,84,192,21,297
2103307,3,3,6,39,28,0,67,215,16,298
2103308,4,4,8,31,18,0,49,206,21,276
2103309,4,0,4,28,7,0,35,182,23,240
2103310,4,0,4,18,9,0,27,166,24,217
2103311,0,0,0,17,0,0,17,81,19,117
2103312,0,0,0,53,27,3,83,156,15,254
2103313,6,0,6,76,22,0,98,211,12,321
2103314,10,6,16,42,12,6,60,212,40,312
2103315,41,4,45,37,15,3,55,249,18,322
2103316,0,0,4,69,26,0,95,159,19,273
2103317,10,0,10,85,33,4,122,212,28,362
2103318,11,3,14,38,32,0,70,213,35,318
2103319,4,0,4,18,8,6,32,133,9,174
2103320,17,4,21,28,6,3,37,107,22,166
2103321,8,3,11,35,18,0,53,171,32,256
2103322,10,3,13,34,14,0,48,171,15,234
2103401,0,0,0,145,30,3,178,154,12,344
2103402,3,0,3,120,24,15,159,145,11,315
2103403,3,0,3,67,25,3,95,208,9,312
2103404,3,0,3,126,23,3,152,181,12,345
2103405,4,0,4,41,12,3,56,129,10,195
2103406,56,0,56,163,48,4,215,439,19,673
2103407,6,0,6,102,30,3,135,254,15,404
2103408,3,3,6,37,17,0,54,140,16,210
2103409,0,0,0,121,20,3,144,190,14,348
2103410,3,0,3,18,14,0,32,87,0,119
2103411,0,0,0,58,16,3,77,165,12,254
2103501,0,0,0,63,8,12,83,116,8,207
2103502,0,0,0,69,22,0,91,163,21,275
2103503,3,0,3,98,23,12,133,253,23,409
2103504,0,0,0,49,3,6,58,141,0,199
2103505,3,0,3,75,25,13,113,218,24,355
2103506,4,0,4,90,29,10,129,222,16,367
2103507,0,0,0,61,27,4,92,104,16,212
2103508,3,0,3,33,26,0,59,138,0,197
2103509,0,0,0,81,32,4,117,169,7,293
2103510,0,0,0,57,38,6,101,166,27,294
2103511,3,0,3,55,21,6,82,158,12,252
2103512,4,0,4,94,31,3,128,309,29,466
2103513,6,3,9,69,26,0,95,230,19,344
2103514,0,0,0,101,30,3,134,202,15,351
2103515,0,0,0,60,26,0,86,106,15,207
2103516,3,0,3,75,25,3,103,227,23,353
2103601,33,3,36,28,10,0,38,189,21,248
2103602,3,0,3,102,29,7,138,301,15,454
2103603,0,0,0,59,28,0,87,178,12,277
2103604,8,3,11,72,23,0,95,181,22,298
2103605,0,0,0,42,21,3,66,141,24,231
2103606,0,0,0,35,9,0,44,105,6,155
2103607,5,0,5,70,41,0,111,233,18,362
2103608,3,0,3,48,18,3,69,125,6,200
2103609,3,0,3,50,16,0,66,135,18,219
2103610,0,0,0,82,10,6,98,152,3,253
2103611,5,0,5,73,20,3,96,170,18,284
2103612,0,0,0,62,31,0,93,137,0,230
2103613,0,4,4,47,12,0,59,160,28,247
2103614,0,0,0,99,21,9,129,90,9,228
2103615,6,0,6,77,30,6,113,229,16,358
2103616,11,7,18,74,38,0,112,292,64,468
2103701,6,0,6,60,47,3,110,263,18,391
2103702,13,0,13,74,34,3,111,338,35,484
2103703,0,0,0,56,22,3,81,191,15,287
2103704,4,3,7,75,24,3,102,196,23,321
2103705,7,3,10,70,28,9,107,252,45,404
2103706,5,0,5,32,21,3,56,221,19,296
2103707,14,6,20,91,21,3,115,268,32,415
2103708,0,0,0,0,0,0,0,0,0,0
2103709,9,4,13,77,37,6,120,281,41,442
2103710,69,5,74,31,20,0,51,255,8,314
2103711,37,0,37,98,21,0,119,354,24,497
2103712,13,0,13,71,28,3,102,264,18,384
2103713,0,0,0,48,18,3,69,181,21,271
2103714,9,0,9,42,27,0,69,178,7,254
2103715,17,3,20,82,37,0,119,252,18,389
2103716,11,0,11,79,23,8,110,261,21,392
2103717,3,6,9,82,42,7,131,281,31,443
2103718,6,6,12,52,23,3,78,192,21,291
2103719,4,0,4,37,27,9,73,181,10,264
2103720,14,3,17,48,36,3,87,233,30,350
2103721,3,3,6,61,25,0,86,210,18,314
2103722,8,0,8,71,34,6,111,281,17,409
2103723,23,0,23,72,32,7,111,304,24,439
2103724,14,3,17,78,21,6,105,305,51,461
2103725,9,0,9,50,18,3,71,157,15,243
2103726,18,9,27,63,22,7,92,295,18,405
2103727,26,6,35,72,40,6,118,379,49,546
2103728,25,30,55,31,37,4,72,169,56,297
2103729,15,6,21,74,40,7,121,303,39,463
2103730,39,16,55,63,23,3,89,250,39,378
2103731,8,3,11,97,30,0,127,236,29,392
2103732,3,0,3,35,6,0,41,109,18,168
2103801,0,0,0,51,25,0,76,242,48,366
2103802,0,0,0,42,5,0,47,141,9,197
2103803,9,0,9,30,26,3,59,175,12,246
2103804,0,0,0,65,23,0,88,159,32,279
2103805,0,0,0,32,18,0,50,147,19,216
2103806,8,3,11,44,21,0,65,175,34,274
2103807,0,0,0,38,24,4,66,123,24,213
2103808,3,6,9,41,17,3,61,176,39,276
2103809,8,0,8,36,17,4,57,195,30,282
2103810,3,0,3,81,45,10,136,293,30,459
2103811,0,3,3,55,38,3,96,237,45,378
2103812,0,0,0,44,17,5,66,150,24,240
2103813,0,0,0,137,24,9,170,232,40,442
2103814,5,0,5,43,21,6,70,143,8,221
2103815,0,0,0,56,11,0,67,122,10,199
2103816,3,0,3,41,29,0,70,205,13,288
2103817,0,0,0,69,3,5,77,179,20,276
2103818,0,0,0,55,31,0,86,173,40,299
2103819,3,0,3,51,14,7,72,151,17,240
2103820,3,3,6,78,24,0,102,178,24,304
2103821,5,0,5,46,21,3,70,150,15,235
2103822,0,0,0,68,15,9,92,163,22,277
2103823,9,3,12,64,23,12,99,201,34,334
2103824,0,0,0,42,25,0,67,104,12,183
2103825,3,3,6,61,33,3,97,225,42,364
2103826,6,0,6,82,22,0,104,208,44,356
2103827,7,4,11,48,21,6,75,167,19,261
2103828,0,0,0,56,13,0,69,122,23,214
2103829,11,0,11,99,23,9,131,265,59,455
2103830,8,3,11,48,19,0,67,184,29,280
2103831,4,0,4,64,20,6,90,171,44,305
2103832,6,3,9,58,24,0,82,223,36,341
2103833,4,0,4,27,15,3,45,172,54,271
2103834,3,0,3,37,26,0,63,142,31,236
2103835,0,0,0,19,10,0,29,123,30,182
2103836,0,0,0,49,20,0,69,190,34,293
2103837,0,0,0,36,18,0,54,140,21,215
2103838,8,0,8,53,20,6,79,198,29,306
2103839,26,0,26,37,8,3,48,230,12,290
2103840,3,0,3,41,22,0,63,185,15,263
2103841,6,3,9,27,13,0,40,158,17,215
2103842,6,0,6,72,26,3,101,274,46,421
2103843,10,3,13,54,15,3,72,145,31,248
2103844,6,3,9,60,10,0,70,224,31,325
2103845,8,0,8,38,18,3,59,170,15,244
2103846,0,0,0,12,3,3,18,46,3,67
2103847,5,0,5,51,10,4,65,194,28,287
2103848,12,0,12,53,24,0,77,251,34,362
2103849,6,3,9,68,19,0,87,234,58,379
2103850,5,0,5,47,22,0,69,170,41,280
2103851,4,0,4,41,18,3,62,124,30,216
2103852,0,0,0,31,6,0,37,100,8,145
2103853,0,0,0,0,0,0,0,3,0,3
2103854,0,0,0,31,9,3,43,125,9,177
2103855,6,0,6,78,23,0,101,221,16,338
2103856,0,0,0,133,42,6,181,266,12,459
2103857,6,0,6,88,25,4,117,224,18,359
2103858,0,0,0,32,15,0,47,101,11,159
2103859,18,0,18,74,31,0,105,268,35,408
2103860,3,3,6,49,18,0,67,167,35,269
2103861,6,3,9,65,20,0,85,188,40,313
2103862,0,0,0,4,0,0,4,7,0,11
2103863,0,0,0,0,3,0,3,0,0,3
2103864,6,0,6,39,28,3,70,202,26,298
2103865,0,0,0,74,15,3,92,176,15,283
2103866,4,3,7,31,12,0,43,172,22,237
2103867,0,0,0,51,18,6,75,111,4,190
2103868,0,0,0,63,27,0,90,152,30,272
2103869,0,0,0,30,34,0,64,326,20,410
2103870,0,0,0,50,16,6,72,163,9,244
2103871,0,0,0,31,28,4,63,149,15,227
2103872,0,0,0,52,26,3,81,130,14,225
2103873,11,3,14,53,24,5,82,203,15,300
2103874,0,0,0,61,23,0,84,153,14,251
2103875,0,0,0,74,21,0,95,191,13,299
2103876,0,4,4,24,13,0,37,111,28,176
2103901,10,0,10,39,16,3,58,306,27,391
2103902,3,3,6,36,22,6,64,245,55,364
2103903,12,0,12,58,40,0,98,280,18,396
2103904,0,0,0,45,33,0,78,191,3,272
2103905,0,7,7,51,21,4,76,201,31,308
2103906,3,0,3,51,17,0,68,157,30,255
2103907,8,8,16,80,43,6,129,264,32,425
2103908,6,3,9,76,15,3,94,218,19,331
2103909,10,0,10,48,21,3,72,162,18,252
2103910,21,7,28,30,30,0,60,318,101,479
2103911,61,0,61,29,21,6,56,274,12,342
2103912,15,0,15,47,24,0,71,295,34,400
2103913,4,6,10,35,24,0,59,209,21,289
2103914,6,0,6,75,30,6,111,281,28,420
2103915,8,4,12,75,37,9,121,307,48,476
2103916,8,7,15,44,21,0,65,190,36,291
2103917,10,0,10,79,13,0,92,168,12,272
2103918,6,3,9,65,34,0,99,181,24,304
2103919,4,0,4,114,22,3,139,302,24,465
2103920,9,0,9,72,25,4,101,215,25,341
2103921,0,0,0,34,13,0,47,143,5,195
2103922,8,0,8,74,34,7,115,231,6,352
2103923,4,5,9,88,32,7,127,223,23,373
2103924,6,0,6,69,22,0,91,204,21,316
2103925,11,4,15,58,23,4,85,255,38,378
2103926,0,0,0,0,0,0,0,0,0,0
2103927,13,3,16,47,19,0,66,251,18,335
2103928,5,3,8,71,42,12,125,273,26,424
2103929,9,0,9,49,21,3,73,196,30,299
2103930,11,3,14,42,35,3,80,218,46,344
2103931,0,0,0,0,0,0,0,0,0,0
2103932,4,0,4,25,9,6,40,137,20,197
2104001,6,0,6,71,34,3,108,237,28,373
2104002,13,3,16,108,28,0,136,302,13,451
2104003,4,3,7,69,18,6,93,202,16,311
2104004,20,3,23,94,35,8,137,309,21,467
2104005,4,3,7,53,9,0,62,129,15,206
2104006,11,0,11,43,24,3,70,166,18,254
2104007,7,3,10,66,17,6,89,179,25,293
2104008,3,3,6,91,17,11,119,205,24,348
2104009,6,0,6,55,23,4,82,189,18,289
2104010,4,0,4,51,30,9,90,170,17,277
2104011,3,0,3,54,7,6,67,183,29,279
2104012,6,3,9,73,24,9,106,229,27,362
2104013,5,4,9,56,13,0,69,149,25,243
2104014,6,3,9,80,31,7,118,218,16,352
2104015,8,0,8,56,33,10,99,253,31,383
2104016,4,7,11,74,20,6,100,219,31,350
2104017,7,3,10,58,34,3,95,197,10,302
2104018,10,0,10,55,32,0,87,313,22,422
2104019,6,0,6,41,15,3,59,160,12,231
2104020,0,0,0,44,12,0,56,111,21,188
2104021,6,0,6,46,12,3,61,172,18,251
2104022,10,0,10,66,21,0,87,203,19,309
2104023,6,0,6,56,17,5,78,177,27,282
2104024,0,6,6,76,27,0,103,183,19,305
2104025,10,3,13,103,35,6,144,237,18,399
2104026,11,3,14,50,28,0,78,251,30,359
2104027,8,0,8,40,15,0,55,157,27,239
2104028,4,3,7,30,21,0,51,129,14,194
2104029,5,0,5,42,13,3,58,237,35,330
2104030,4,0,4,26,9,3,38,145,18,201
2104031,6,0,6,73,57,4,134,314,34,482
2104032,0,0,0,19,22,12,53,128,28,209
2104033,10,3,13,34,18,3,55,195,21,271
2104034,10,6,16,89,34,6,129,271,32,432
2104035,3,6,9,59,31,0,90,262,18,370
2104036,0,0,0,70,23,6,99,190,21,310
2104037,4,0,4,35,14,0,49,90,8,147
2104038,8,6,14,74,25,3,102,278,36,416
2104039,10,3,13,71,28,0,99,225,38,362
2104040,13,7,20,50,15,3,68,207,20,295
2104041,12,10,22,110,32,8,150,323,43,516
2104042,17,6,26,60,29,11,100,241,28,369
2104043,6,0,6,44,44,4,92,220,19,331
2104044,12,6,18,46,48,0,94,202,30,326
2104045,11,3,14,33,45,3,81,185,18,284
2104046,7,3,10,61,17,0,78,161,26,265
2104047,46,3,49,42,19,4,65,243,23,331
2104048,6,0,6,27,20,0,47,120,31,198
2104049,0,4,4,50,19,3,72,120,10,202
2104050,6,3,9,56,25,3,84,139,14,237
2104101,8,3,11,82,25,4,111,245,29,385
2104102,7,0,7,69,30,0,99,217,12,328
2104103,10,0,10,89,50,0,139,304,19,462
2104104,0,0,0,64,43,0,107,184,8,299
2104105,8,0,8,90,43,7,140,280,24,444
2104106,60,9,69,73,29,0,102,373,56,531
2104107,59,5,64,126,47,6,179,378,25,582
2104108,7,0,7,63,34,8,105,244,20,369
2104109,9,5,14,64,26,0,90,245,24,359
2104110,6,6,12,51,22,4,77,182,33,292
2104111,6,3,9,45,48,6,99,280,22,401
2104112,8,0,8,66,35,3,104,225,22,351
2104113,0,0,0,94,35,8,137,214,18,369
2104114,3,0,3,203,57,9,269,433,29,731
2104115,0,0,0,53,22,3,78,211,9,298
2104116,93,4,100,76,31,6,113,337,20,470
2104117,0,3,3,22,11,0,33,60,7,100
2104118,0,0,0,82,39,3,124,221,9,354
2104119,0,0,0,154,45,6,205,281,15,501
2104120,89,23,112,45,30,3,78,350,51,479
2104121,62,3,65,87,28,6,121,276,30,427
2104122,0,0,0,54,23,0,77,208,27,312
2104123,11,0,11,61,22,6,89,203,25,317
2104124,0,0,0,42,36,4,82,204,18,304
2104125,0,0,0,65,35,6,106,224,6,336
2104126,4,0,4,38,35,0,73,174,14,261
2104127,0,0,0,235,51,9,295,407,25,727
2104128,0,0,0,108,32,3,143,187,9,339
2104129,4,0,4,84,51,3,138,192,6,336
2104130,12,0,15,42,27,0,69,195,3,267
2104131,3,0,3,71,31,3,105,173,3,281
2104132,0,0,0,108,18,4,130,164,10,304
2104133,0,0,0,70,42,3,115,126,9,250
2104134,3,0,3,63,33,6,102,232,12,346
2104135,4,4,8,56,39,4,99,217,23,339
2104136,0,0,0,48,22,3,73,176,0,249
2104137,3,3,6,56,30,3,89,210,19,318
2104138,0,0,0,171,41,13,225,234,19,478
2104139,3,0,3,32,40,0,72,135,15,222
2104140,0,0,0,30,22,5,57,121,7,185
2104141,61,3,67,52,34,3,89,310,25,424
2104142,73,8,81,113,32,0,145,400,36,581
2104143,3,0,3,24,16,9,49,127,15,191
2104201,8,0,8,102,34,12,148,289,12,449
2104202,5,0,5,77,58,4,139,318,18,475
2104203,6,0,6,40,22,5,67,221,13,301
2104204,3,0,3,38,28,0,66,146,24,236
2104205,4,0,4,79,22,0,101,153,9,263
2104206,3,0,3,71,55,0,126,329,21,476
2104207,0,0,0,176,34,15,225,225,5,455
2104208,15,9,24,60,28,6,94,341,24,459
2104209,11,0,11,95,49,6,150,230,35,415
2104210,8,4,12,55,27,0,82,190,19,291
2104211,0,3,3,80,35,15,130,291,10,431
2104212,10,3,13,57,29,0,86,179,16,281
2104213,3,3,6,51,32,4,87,227,12,326
2104214,0,0,0,227,74,5,306,621,71,998
2104215,6,0,6,86,60,3,149,271,11,431
2104216,8,0,8,81,59,6,146,313,16,475
2104217,3,0,3,61,38,3,102,246,22,370
2104218,15,6,21,83,66,6,155,329,24,508
2104219,17,0,17,62,30,4,96,217,27,340
2104220,3,5,8,72,16,9,97,224,11,332
2104221,0,0,0,66,10,8,84,150,15,249
2104222,7,0,7,93,35,0,128,297,20,445
2104223,9,0,9,90,46,6,142,277,17,436
2104224,0,0,0,85,31,6,122,200,21,343
2104225,0,3,3,39,6,0,45,149,3,197
2104226,0,0,0,6,13,0,19,273,24,316
2104227,0,0,0,45,15,0,60,124,13,197
2104228,12,0,12,81,37,7,125,249,20,394
2104229,7,6,13,81,46,0,127,260,15,402
2104230,0,0,0,95,27,6,128,264,13,405
2104231,3,0,3,104,41,8,153,238,12,403
2104232,62,0,62,58,29,3,90,302,14,406
2104233,20,3,23,48,40,4,92,239,21,352
2104234,3,0,3,65,29,0,94,173,0,267
2104235,13,3,16,50,23,0,73,262,38,373
2104236,15,0,15,36,24,3,63,178,8,249
2104237,8,4,12,93,56,0,149,287,28,464
2104238,5,0,5,74,29,6,109,224,18,351
2104239,6,0,6,43,36,0,79,203,9,291
2104240,4,3,7,40,29,3,72,166,23,261
2104241,0,0,0,12,4,0,16,116,6,138
2104242,4,0,4,48,27,0,75,116,0,191
2104243,0,0,0,108,33,7,148,235,20,403
2104244,0,0,0,0,0,0,0,0,0,0
2104301,0,0,0,91,25,9,125,232,22,379
2104302,0,0,0,45,17,6,68,135,15,218
2104303,3,0,3,50,25,0,75,128,17,220
2104304,3,0,3,47,21,6,74,192,15,281
2104305,0,0,0,55,34,3,92,217,15,324
2104306,4,0,4,45,19,0,64,111,18,193
2104307,0,0,0,90,42,6,138,269,26,433
2104308,0,0,0,12,3,0,15,21,680,716
2104309,0,0,0,21,9,0,30,30,0,60
2104310,0,5,5,55,28,0,83,237,15,335
2104311,0,0,0,30,15,6,51,163,16,230
2104312,0,3,3,52,19,3,74,108,18,200
2104313,5,0,5,82,32,0,114,204,12,330
2104314,3,0,3,57,18,5,80,131,9,220
2104315,21,9,30,0,4,0,4,101,28,133
2104316,0,0,0,55,18,0,73,146,15,234
2104317,4,0,4,39,21,0,60,162,17,239
2104318,3,0,3,107,51,18,176,227,22,425
2104319,3,3,6,110,40,6,156,283,39,478
2104320,3,0,3,77,49,6,132,244,16,392
2104321,6,0,6,91,45,0,136,255,21,412
2104322,0,0,0,63,26,3,92,152,23,267
2104323,0,4,7,81,56,0,137,292,49,478
2104324,0,0,0,68,26,0,94,138,3,235
2104325,0,0,0,3,0,0,3,18,3,24
2104326,0,0,0,65,33,6,104,159,3,266
2104327,5,0,5,72,38,6,116,191,14,321
2104328,6,0,6,293,52,19,364,550,33,947
2104329,3,0,3,98,15,7,120,138,9,267
2104330,0,0,0,96,27,12,135,155,5,295
2104331,4,0,4,145,22,8,175,213,21,409
2104332,3,3,6,163,33,4,200,277,20,497
2104333,18,0,18,39,16,6,61,187,27,275
2104334,0,3,3,88,44,3,135,198,6,339
2104335,0,0,0,76,15,0,91,168,27,286
2104336,59,4,63,133,38,16,187,401,14,602
2104337,6,0,6,82,26,8,116,206,16,338
2104401,0,0,0,67,26,6,99,159,7,265
2104402,27,8,35,64,29,6,99,233,17,349
2104403,0,6,6,56,21,0,77,94,6,177
2104404,11,0,11,73,40,9,122,213,12,347
2104405,0,0,0,73,37,0,110,226,33,369
2104406,3,3,6,140,34,3,177,219,18,414
2104407,3,0,3,92,42,3,137,217,27,381
2104408,44,0,44,39,18,0,57,198,19,274
2104409,4,0,4,91,35,8,134,230,27,391
2104410,6,3,9,78,35,0,113,270,19,402
2104411,0,0,0,98,27,3,128,142,22,292
2104412,8,0,8,74,43,0,117,263,21,401
2104413,4,0,4,71,40,0,111,279,14,404
2104414,14,0,14,82,32,3,117,287,18,422
2104415,8,0,8,19,17,0,36,213,24,273
2104416,7,0,7,72,23,0,95,127,6,228
2104417,0,0,0,172,23,6,201,299,27,527
2104418,8,3,11,65,29,0,94,199,17,310
2104419,7,0,7,146,46,9,201,382,9,592
2104420,0,0,0,41,25,3,69,94,15,178
2104421,5,0,5,41,27,3,71,184,12,267
2104422,0,0,0,70,29,9,108,168,11,287
2104423,7,0,7,93,19,0,112,184,26,322
2104424,6,0,6,36,18,0,54,115,6,175
2104501,7,9,16,59,25,9,93,275,36,404
2104502,8,0,8,64,13,4,81,198,14,293
2104503,0,0,0,46,47,3,96,197,45,338
2104504,73,13,89,32,34,0,66,398,50,514
2104505,3,3,6,92,47,0,139,258,13,410
2104506,3,0,3,111,37,0,148,244,15,407
2104507,3,0,3,64,19,0,83,213,28,324
2104508,0,0,0,90,42,8,140,284,24,448
2104509,36,0,36,50,16,7,73,230,5,308
2104510,3,0,3,41,16,0,57,136,18,211
2104511,4,0,4,49,29,3,81,213,25,319
2104512,3,0,3,34,30,6,70,231,13,314
2104513,6,3,9,70,32,0,102,205,24,331
2104514,3,0,3,97,28,0,125,219,39,383
2104515,0,3,3,42,25,0,67,178,26,271
2104516,4,0,4,86,24,6,116,237,53,406
2104517,3,0,3,148,33,8,189,248,15,452
2104518,4,0,4,60,15,3,78,137,6,221
2104519,9,0,9,62,50,0,112,300,28,440
2104520,17,0,17,61,15,0,76,273,36,385
2104521,5,0,5,40,24,6,70,182,25,277
2104522,6,0,6,40,28,3,71,209,18,298
2104523,8,3,11,48,26,3,77,218,18,313
2104524,6,0,6,52,33,7,92,243,34,369
2104525,23,32,55,64,27,6,97,270,66,433
2104526,0,0,0,51,23,3,77,191,24,292
2104527,6,6,12,59,24,5,88,206,29,323
2104528,6,0,6,85,40,3,128,244,37,409
2104529,0,0,0,0,0,0,0,0,0,0
2104530,55,8,63,33,31,0,64,326,27,417
2104531,16,0,16,57,33,0,90,253,22,365
2104532,0,7,7,44,27,0,71,213,21,305
2104533,9,0,9,54,39,6,99,244,29,372
2104534,3,0,3,55,32,3,90,251,30,371
2104535,9,3,12,61,29,0,90,231,44,365
2104601,9,0,9,101,33,4,138,309,12,459
2104602,15,0,15,101,38,9,148,264,19,431
2104603,7,0,7,51,24,0,75,159,24,258
2104604,4,0,4,33,6,3,42,100,3,145
2104605,18,0,18,35,18,0,53,123,5,181
2104606,6,3,9,97,30,3,130,329,25,484
2104607,10,0,10,63,20,10,93,187,16,296
2104608,4,3,7,48,29,15,92,192,18,302
2104609,7,0,7,69,27,3,99,161,10,270
2104610,3,0,3,79,32,4,115,195,15,325
2104611,0,0,0,84,44,0,128,271,36,435
2104612,7,6,13,75,36,6,117,261,25,403
2104613,6,3,9,87,25,3,115,214,21,350
2104614,4,3,10,70,32,6,108,216,18,342
2104615,8,3,11,101,38,8,147,256,16,419
2104616,6,4,10,44,16,0,60,114,13,187
2104617,7,0,7,80,36,5,121,339,32,492
2104618,6,3,9,31,20,0,51,146,26,223
2104619,3,0,3,28,18,0,46,93,12,151
2104620,7,3,10,90,26,0,116,156,21,293
2104621,7,0,7,69,29,6,104,183,9,296
2104622,0,3,3,41,12,0,53,118,7,178
2104623,7,0,7,72,20,3,95,239,28,362
2104624,4,0,4,65,28,6,99,185,11,295
2104625,6,0,6,45,14,0,59,124,15,198
2104701,0,0,0,0,0,0,0,0,0,0
2104702,0,0,0,0,0,0,0,9,0,9
2104703,7,0,7,49,33,10,92,164,19,275
2104704,14,0,14,71,31,0,102,276,57,435
2104705,7,0,7,32,14,3,49,167,38,254
2104706,11,0,11,53,47,0,100,271,17,388
2104707,6,0,6,46,39,0,85,186,19,290
2104708,0,0,0,51,28,0,79,166,11,256
2104709,4,0,4,60,35,0,95,198,25,318
2104710,10,0,10,67,40,6,113,196,33,342
2104711,11,3,14,54,44,3,101,330,38,469
2104712,5,0,5,57,23,0,80,225,14,319
2104713,0,0,0,57,25,0,82,193,15,290
2104714,0,0,0,24,19,0,43,147,9,199
2104715,0,0,0,150,40,3,193,269,33,495
2104716,4,0,4,105,51,3,159,359,21,539
2104717,0,0,0,0,0,0,0,0,0,0
2104718,13,3,16,57,53,3,113,261,23,397
2104719,7,3,13,39,21,6,66,157,40,263
2104720,5,3,8,45,24,0,69,195,31,295
2104721,16,3,19,42,26,6,74,294,59,427
2104722,12,0,12,25,15,3,43,171,18,232
2104723,135,6,141,14,0,0,14,387,33,434
2104724,6,0,6,92,26,10,128,262,37,427
2104725,63,9,72,11,7,0,18,195,27,240
2104726,10,0,10,29,16,0,45,171,25,241
2104727,0,0,0,0,0,0,0,15,0,15
2104728,0,0,0,99,18,3,120,247,21,388
2104729,11,5,16,83,54,9,146,327,50,523
2104730,6,3,9,90,27,3,120,209,18,347
2104731,9,0,9,60,30,6,96,253,21,370
2104732,0,0,0,0,0,0,0,0,0,0
2104733,0,0,0,46,21,0,67,110,9,186
2104734,6,0,6,21,22,6,49,123,35,207
2104735,3,0,3,46,49,3,98,281,38,417
2104736,0,0,0,14,15,0,29,62,18,109
2104737,3,0,3,32,28,3,63,182,9,254
2104738,5,0,5,71,69,18,158,307,30,495
2104739,3,0,3,49,32,6,87,167,16,270
2104740,3,0,3,37,29,3,69,230,36,335
2104801,22,9,31,55,36,6,97,311,35,443
2104802,68,3,71,30,15,3,48,250,12,310
2104803,6,0,6,78,35,9,122,265,80,467
2104804,3,3,6,66,26,0,92,154,12,258
2104805,14,3,17,68,36,6,110,236,41,387
2104806,0,0,0,34,14,3,51,124,13,188
2104807,4,0,4,41,19,0,60,122,0,182
2104808,4,0,4,60,28,3,91,178,21,290
2104809,7,0,7,32,13,3,48,122,9,179
2104810,0,0,0,71,6,4,81,157,22,260
2104811,7,0,7,71,32,3,106,204,9,319
2104812,0,0,0,63,21,6,90,140,3,233
2104813,16,11,27,123,47,12,182,409,48,639
2104814,3,0,3,55,17,7,79,152,7,238
2104815,0,0,0,25,19,6,50,142,12,204
2104816,6,0,6,100,31,7,138,298,18,454
2104817,12,6,18,91,41,0,132,381,39,552
2104818,3,3,6,26,15,0,41,144,26,211
2104819,7,0,7,63,26,3,92,222,31,345
2104820,3,0,3,66,18,3,87,219,25,331
2104821,6,0,6,56,32,6,94,225,18,337
2104822,3,0,3,27,27,4,58,117,9,184
2104823,0,0,0,136,46,8,190,324,29,543
2104824,3,6,9,36,14,3,53,152,15,220
2104825,3,3,6,56,29,0,85,218,17,320
2104826,10,3,13,36,27,4,67,213,17,297
2104827,3,3,6,43,13,4,60,168,24,252
2104828,6,0,6,76,27,3,106,229,9,344
2104829,6,0,6,63,29,6,98,186,0,284
2104830,3,0,3,32,9,3,44,101,11,156
2104831,3,0,3,24,17,6,47,104,6,157
2104901,6,6,12,52,28,13,93,163,34,290
2104902,5,5,10,49,34,6,89,222,60,371
2104903,10,0,10,62,27,6,95,192,19,306
2104904,15,3,18,101,40,8,149,266,28,443
2104905,43,3,46,85,42,0,127,390,48,565
2104906,19,7,26,47,24,3,74,274,25,373
2104907,3,0,3,64,28,3,95,144,34,273
2104908,30,15,45,66,43,6,115,334,87,536
2104909,9,3,12,49,31,0,80,240,18,338
2104910,6,4,10,55,27,0,82,223,36,341
2104911,3,0,3,48,19,5,72,173,28,273
2105001,3,0,3,44,21,3,68,119,14,201
2105002,0,0,0,56,17,4,77,159,15,251
2105003,10,0,10,63,23,3,89,198,15,302
2105004,4,0,4,87,29,9,125,197,15,337
2105005,4,6,10,87,35,8,130,249,18,397
2105006,12,6,18,48,48,0,96,271,35,402
2105007,6,0,6,29,17,3,49,125,25,199
2105008,19,4,23,47,28,3,78,220,27,325
2105009,12,0,12,58,32,0,90,275,40,405
2105010,13,9,22,51,25,6,82,176,21,279
2105011,20,6,26,61,13,4,78,252,27,357
2105012,6,6,12,59,34,3,96,217,24,337
2105013,6,3,9,67,32,6,105,180,6,291
2105014,6,0,6,72,19,9,100,181,12,293
2105015,6,0,6,69,26,0,95,159,13,267
2105016,3,0,3,88,22,9,119,180,8,307
2105017,0,0,0,60,21,3,84,168,16,268
2105018,6,0,6,65,27,3,95,218,20,333
2105019,8,0,8,66,25,3,94,198,23,315
2105020,4,6,10,85,32,3,120,279,24,423
2105021,5,4,9,62,46,4,112,167,25,304
2105022,3,3,6,93,39,8,140,265,18,423
2105023,3,6,9,66,31,5,102,221,15,338
2105024,3,0,3,59,20,5,84,189,0,273
2105025,4,0,4,37,17,3,57,165,9,231
2105026,0,8,8,86,20,12,118,233,31,382
2105027,68,0,68,242,68,18,328,563,45,936
2105028,4,0,4,58,15,7,80,148,7,235
2105029,4,0,4,86,36,11,133,248,21,402
2105030,3,0,3,50,22,6,78,151,12,241
2105031,4,6,10,78,30,3,111,200,75,386
2105032,10,3,13,133,33,10,176,211,18,405
2105033,10,4,14,38,20,6,64,181,15,260
2105034,12,8,20,32,34,3,69,162,65,296
2105035,4,0,4,122,30,10,162,211,18,391
2105036,3,0,3,109,22,12,143,242,10,395
2105037,0,4,4,21,13,9,43,98,7,148
2105038,3,0,3,195,34,22,251,298,9,558
2105039,52,18,70,73,26,5,104,300,47,451
2105040,3,0,3,119,20,7,146,222,12,380
2105041,0,0,0,37,9,0,46,115,3,164
2105042,3,0,3,48,39,3,90,255,39,384
2105043,3,0,3,25,12,3,40,87,3,130
2105044,0,0,0,48,22,0,70,119,6,195
2105101,10,4,14,56,42,0,98,309,44,451
2105102,12,0,12,24,17,5,46,206,34,286
2105103,4,6,10,27,16,0,43,147,22,212
2105104,6,6,12,68,37,9,114,373,44,531
2105105,3,3,6,29,23,3,55,134,18,207
2105106,16,0,16,30,22,0,52,227,20,299
2105107,47,5,52,37,35,0,72,231,17,320
2105108,6,0,6,45,8,3,56,163,18,237
2105109,6,7,13,81,28,4,113,255,22,390
2105110,5,6,11,55,27,3,85,253,47,385
2105111,9,0,9,34,34,3,71,206,9,286
2105112,8,0,11,67,39,5,111,378,28,517
2105113,6,3,9,38,16,0,54,155,25,234
2105114,6,4,10,25,22,0,47,206,24,277
2105115,13,3,16,62,24,3,89,263,39,391
2105116,8,0,8,54,35,0,89,264,15,368
2105117,9,0,9,24,19,0,43,160,14,217
2105201,18,6,24,21,20,3,44,201,34,279
2105202,19,0,19,44,48,3,95,231,38,364
2105203,4,0,4,59,32,6,97,140,3,240
2105204,13,4,17,62,69,6,137,284,32,453
2105205,48,3,51,47,42,3,92,304,35,431
2105206,13,5,18,76,21,4,101,208,18,327
2105207,0,3,3,74,43,4,121,300,33,454
2105208,12,3,15,37,12,6,55,176,15,246
2105209,8,3,11,39,15,0,54,156,18,228
2105210,10,9,19,29,29,3,61,210,18,289
2105211,0,0,0,28,19,3,50,100,7,157
2105301,3,0,3,115,19,10,144,166,6,316
2105302,3,0,3,149,31,10,190,156,21,367
2105303,3,0,3,128,43,12,183,221,18,422
2105304,0,0,0,27,12,3,42,75,13,130
2105305,0,0,0,118,20,12,150,217,26,393
2105306,4,0,4,91,39,4,134,236,24,394
2105307,7,0,7,62,38,3,103,260,10,373
2105308,3,3,6,67,17,3,87,152,12,251
2105309,0,0,0,73,15,6,94,201,7,302
2105310,0,0,0,139,23,7,169,255,37,461
2105311,5,0,9,80,23,9,112,217,21,350
2105312,8,4,12,45,22,0,67,238,18,323
2105313,6,4,10,44,23,0,67,180,26,273
2105314,54,3,57,117,45,7,169,335,26,530
2105315,14,0,17,76,58,0,134,305,36,475
2105316,3,3,6,234,38,18,290,259,25,574
2105317,0,0,0,189,39,9,237,275,49,561
2105318,4,0,4,52,28,3,83,243,9,335
2105319,0,0,0,113,22,10,145,178,17,340
2105320,4,0,4,75,18,0,93,172,12,277
2105321,8,0,8,74,31,0,105,116,15,236
2105322,3,0,3,56,17,9,82,179,12,273
2105323,6,0,6,76,34,3,113,234,12,359
2105324,7,0,7,78,28,0,106,181,12,299
2105325,3,0,3,77,26,0,103,158,12,273
2105326,0,0,0,142,31,10,183,195,15,393
2105327,7,0,7,43,50,0,93,223,27,343
2105328,0,0,0,32,21,3,56,86,0,142
2105329,0,0,0,107,36,4,147,160,14,321
2105330,3,0,3,123,18,7,148,181,17,346
2105331,0,0,0,30,6,0,36,75,19,130
2105332,6,0,6,51,32,6,89,174,18,281
2105333,0,0,0,90,36,3,129,213,26,368
2105334,9,0,9,77,20,4,101,203,25,329
2105401,6,3,9,30,28,0,58,119,13,190
2105402,0,3,3,28,15,6,49,148,24,221
2105403,6,6,12,48,5,0,53,207,33,293
2105404,4,0,4,39,17,0,56,171,6,233
2105405,0,0,0,0,3,0,3,3,0,6
2105406,6,0,6,74,32,4,110,300,46,456
2105407,0,0,0,30,16,8,54,150,17,221
2105408,0,0,0,41,18,0,59,205,13,277
2105409,8,0,8,44,14,0,58,215,28,301
2105410,3,0,3,37,37,3,77,206,20,303
2105411,10,3,13,44,27,3,74,194,20,288
2105412,3,3,6,58,12,6,76,165,21,262
2105413,6,3,9,32,17,0,49,143,28,220
2105414,39,3,42,39,24,0,63,203,24,290
2105415,8,3,11,60,22,3,85,189,24,298
2105416,6,7,13,42,22,3,67,191,25,283
2105417,4,0,4,62,27,0,89,284,30,403
2105418,25,3,28,20,0,0,20,194,21,235
2105419,7,3,10,60,18,0,78,282,39,399
2105501,10,10,20,48,32,0,80,243,40,363
2105502,20,5,25,36,16,0,52,186,21,259
2105503,3,0,3,26,16,0,42,117,21,180
2105504,9,0,9,32,20,3,55,162,7,224
2105505,3,0,3,45,14,5,64,103,10,177
2105506,40,8,48,48,8,9,65,303,30,398
2105507,10,0,10,44,18,0,62,145,18,225
2105508,7,4,11,53,25,3,81,228,28,337
2105509,34,6,40,37,15,0,52,197,41,290
2105510,7,0,7,29,12,3,44,109,7,160
2105511,8,5,13,40,15,0,55,224,33,312
2105512,3,0,3,42,23,9,74,262,15,351
2105513,0,0,0,35,29,0,64,168,13,245
2105514,0,3,3,59,36,0,95,234,24,353
2105515,3,0,3,40,18,0,58,214,21,293
2105516,7,3,10,46,21,0,67,201,12,280
2105517,4,4,8,27,11,0,38,121,4,163
2105518,3,0,3,18,18,0,36,114,17,167
2105519,0,0,0,36,19,6,61,180,20,261
2105601,0,0,0,98,27,3,128,230,29,387
2105602,3,0,3,48,21,0,69,165,10,244
2105603,0,0,0,40,15,0,55,116,21,192
2105604,0,0,0,40,19,0,59,112,21,192
2105605,4,0,4,119,34,4,157,331,39,527
2105606,0,0,0,49,10,0,59,159,38,256
2105607,12,0,12,37,30,0,67,189,28,284
2105608,6,6,12,80,27,0,107,209,33,349
2105609,3,0,3,116,30,9,155,294,33,482
2105610,4,0,4,65,22,0,87,189,7,283
2105611,0,0,0,29,17,0,46,115,34,195
2105612,3,0,3,32,18,0,50,77,24,151
2105613,33,6,39,140,34,4,178,343,30,551
2105614,4,0,4,106,26,3,135,216,26,377
2105615,0,0,0,104,39,7,150,262,28,440
2105616,0,0,0,71,22,3,96,247,16,359
2105617,11,3,14,115,30,3,148,305,39,492
2105618,0,0,0,50,9,0,59,130,19,208
2105619,34,0,34,66,29,6,101,237,18,356
2105620,0,0,0,110,31,4,145,270,35,450
2105621,0,0,0,55,12,7,74,159,18,251
2105622,4,0,4,28,20,0,48,116,13,177
2105623,0,0,0,49,6,6,61,86,10,157
2105624,4,3,7,32,19,0,51,210,18,279
2105625,9,0,9,50,20,9,79,213,39,331
2105626,0,0,0,71,18,0,89,133,12,234
2105627,0,0,0,43,24,0,67,108,4,179
2105628,9,0,9,76,31,6,113,192,29,334
2105629,0,0,0,38,12,0,50,86,4,140
2105630,0,0,0,87,23,3,113,242,24,379
2105631,4,0,4,48,10,0,58,108,7,173
2105701,3,3,6,36,18,0,54,264,24,342
2105702,3,0,3,39,30,0,69,174,16,259
2105703,3,3,9,76,34,4,114,284,35,433
2105704,3,0,9,77,31,0,108,326,34,468
2105705,7,0,7,95,43,7,145,401,32,578
2105706,3,0,3,19,10,0,29,67,6,102
2105707,0,0,0,56,16,0,72,161,11,244
2105708,0,0,0,24,6,3,33,202,6,241
2105709,0,0,0,0,0,0,0,0,0,0
2105710,0,3,3,34,12,7,53,125,9,187
2105711,3,0,3,47,20,0,67,151,24,242
2105712,11,0,11,47,18,0,65,137,6,208
2105713,35,6,41,101,25,3,129,383,30,542
2105714,12,6,18,98,42,6,146,358,33,537
2105715,0,0,0,44,0,0,44,116,19,179
2105716,4,0,4,55,24,3,82,284,23,389
2105717,0,0,0,59,4,0,63,205,52,320
2105718,3,3,6,36,24,0,60,146,21,227
2105719,33,5,38,98,53,6,157,342,43,542
2105720,0,0,0,18,4,6,28,143,37,208
2105721,0,0,0,24,10,0,34,125,6,165
2105722,7,0,7,48,20,9,77,146,17,240
2105801,0,3,3,26,6,5,37,128,21,186
2105802,0,0,0,32,18,4,54,144,30,228
2105803,3,3,6,23,18,0,41,120,18,179
2105804,6,0,6,27,9,3,39,194,11,244
2105805,29,0,29,20,15,0,35,141,14,190
2105806,7,4,11,39,14,0,53,157,23,233
2105807,3,3,6,56,39,3,98,225,41,364
2105808,6,0,6,24,18,0,42,94,15,151
2105809,6,3,9,48,29,0,77,184,31,292
2105810,0,0,0,0,0,0,0,0,0,0
2105811,0,0,0,44,10,0,54,131,21,206
2105812,7,6,13,21,10,0,31,117,35,183
2105813,0,3,3,18,18,3,39,180,16,235
2105814,0,0,4,67,21,0,88,196,22,306
2105901,3,3,6,55,23,0,78,241,18,337
2105902,3,3,6,51,21,3,75,176,33,284
2105903,3,3,6,49,26,6,81,169,12,262
2105904,3,0,3,18,18,0,36,131,18,185
2105905,10,3,13,36,18,0,54,141,22,217
2105906,49,0,49,38,41,0,79,411,28,518
2105907,0,4,4,42,27,0,69,176,35,280
2105908,3,3,6,15,6,0,21,70,9,100
2105909,0,0,0,80,32,0,112,208,57,377
2105910,6,3,9,35,10,0,45,210,32,287
2105911,3,0,3,57,19,0,76,215,35,326
2105912,3,3,6,78,19,0,97,215,54,366
2105913,3,0,3,50,26,0,76,194,42,312
2105914,12,0,15,42,37,0,79,260,34,373
2105915,12,8,20,88,44,3,135,285,31,451
2105916,3,0,3,36,17,0,53,177,45,275
2105917,3,3,6,44,10,9,63,184,44,291
2106001,0,0,0,46,16,0,62,143,15,220
2106002,3,0,3,81,13,3,97,220,28,345
2106003,0,0,0,35,14,5,54,107,12,173
2106004,0,0,0,0,0,0,0,0,0,0
2106005,4,0,4,68,28,3,99,253,21,373
2106006,3,0,3,49,22,3,74,161,15,250
2106007,0,0,0,59,21,7,87,193,19,299
2106008,3,0,3,57,19,0,76,186,12,274
2106009,5,0,5,41,15,9,65,143,12,220
2106010,3,0,3,67,16,3,86,233,18,337
2106011,0,0,0,291,33,23,347,419,36,802
2106101,0,0,0,30,13,3,46,121,15,182
2106201,0,0,0,45,28,6,79,204,24,307
2106202,0,0,0,29,24,0,53,121,15,189
2106203,6,3,9,60,26,4,90,184,22,296
2106204,19,5,24,47,0,4,51,202,21,274
2106205,3,0,3,73,38,6,117,290,22,429
2106206,10,0,10,62,22,3,87,221,19,327
2106207,3,0,3,66,18,4,88,211,61,360
2106208,0,0,0,42,7,0,49,165,15,229
2106209,9,3,12,39,10,0,49,157,24,230
2106210,0,0,0,25,12,3,40,114,57,211
2106301,3,3,6,54,15,0,69,205,15,289
2106302,8,3,11,34,23,3,60,264,47,371
2106303,11,0,11,27,16,0,43,124,12,179
2106304,4,0,4,78,20,13,111,193,19,323
2106305,5,0,5,35,10,4,49,118,4,171
2106306,9,6,15,76,29,6,111,268,32,411
2106307,8,7,15,65,30,0,95,288,42,425
2106308,11,0,11,69,28,6,103,285,17,405
2106309,0,0,0,57,31,3,91,160,22,273
2106310,11,0,11,42,23,0,65,175,14,254
2106311,7,3,10,37,13,3,53,159,23,235
2106312,19,4,23,63,29,4,96,250,16,362
2106313,27,6,33,46,30,0,76,262,26,364
2106314,10,0,10,48,33,6,87,175,13,275
2106315,9,5,14,31,22,0,53,151,14,218
2106316,0,0,0,0,0,0,0,0,3,3
2106317,14,0,14,47,32,3,82,172,20,274
2106318,12,4,16,46,35,0,81,225,23,329
2106319,14,0,14,72,30,7,109,250,30,389
2106320,5,0,5,48,21,3,72,218,24,314
2106321,8,0,8,38,24,9,71,239,19,329
2106322,3,0,3,49,24,0,73,214,9,296
2106323,67,11,78,23,9,0,32,227,31,290
2106324,0,3,3,38,15,5,58,187,21,266
2106325,15,0,15,49,19,3,71,261,21,353
2106326,44,4,48,55,29,0,84,298,14,396
2106327,3,0,3,70,12,5,87,205,22,314
2106328,6,6,12,38,13,5,56,145,16,217
2106329,0,0,0,32,6,3,41,141,9,191
2106401,3,0,3,50,14,0,64,201,15,280
2106402,4,0,4,79,36,5,120,248,22,390
2106403,8,0,8,48,19,0,67,222,21,310
2106404,3,0,3,59,30,0,89,275,24,388
2106405,3,0,3,25,21,3,49,121,5,175
2106406,6,4,10,76,35,4,115,297,19,431
2106407,6,0,6,52,28,3,83,203,7,293
2106408,0,0,0,61,21,9,91,270,20,381
2106409,4,0,4,27,14,3,44,108,6,158
2106501,3,0,3,39,17,0,56,145,17,218
2106502,0,0,0,59,15,0,74,160,31,265
2106503,20,8,28,70,24,0,94,247,28,369
2106504,21,0,21,56,27,8,91,265,22,378
2106505,6,0,6,35,27,0,62,150,18,230
2106506,0,0,0,60,31,0,91,198,20,309
2106507,3,0,3,54,26,5,85,204,9,298
2106508,3,0,3,58,15,0,73,145,13,231
2106509,3,3,6,51,22,0,73,137,3,213
2106510,3,0,3,73,26,6,105,121,24,250
2106511,6,0,6,35,28,0,63,151,31,245
2106601,4,0,4,81,35,9,125,202,16,343
2106602,0,0,0,99,27,13,139,200,17,356
2106603,42,4,46,77,36,3,116,305,39,460
2106604,6,0,6,36,22,3,61,152,25,238
2106605,4,0,4,60,21,6,87,167,16,270
2106606,43,108,151,67,35,0,102,408,207,717
2106607,9,0,9,58,33,4,95,210,9,314
2106608,0,0,0,81,40,3,124,267,18,409
2106609,60,7,67,32,24,3,59,277,44,380
2106610,3,3,6,47,10,0,57,122,7,186
2106611,12,0,12,61,33,3,97,269,19,385
2106612,4,0,4,69,19,4,92,255,38,385
2106613,13,5,18,49,32,6,87,174,20,281
2106614,14,0,14,57,21,3,81,187,15,283
2106615,22,6,28,97,44,0,141,300,33,474
2106616,10,8,18,48,39,10,97,277,18,392
2106617,5,0,5,102,31,9,142,287,24,453
2106618,7,3,10,54,27,9,90,294,26,410
2106619,4,0,4,68,27,4,99,230,35,364
2106620,0,0,0,73,16,3,92,159,20,271
2106621,6,0,6,47,18,4,69,172,10,251
2106622,10,3,13,42,31,3,76,195,16,287
2106623,8,4,12,61,21,3,85,234,12,331
2106624,10,6,16,56,12,3,71,157,15,243
2106625,7,0,7,66,22,0,88,190,16,294
2106626,0,0,0,57,34,8,99,134,26,259
2106627,6,0,6,69,17,0,86,155,24,265
2106628,6,0,6,34,21,6,61,154,6,221
2106629,10,4,14,82,29,7,118,257,16,391
2106630,7,0,7,65,33,0,98,276,41,415
2106631,4,3,7,66,26,0,92,147,38,277
2106632,28,0,28,39,21,5,65,167,10,242
2106633,0,0,0,14,11,0,25,84,7,116
2106634,13,3,16,53,29,0,82,194,31,307
2106635,12,3,15,60,25,7,92,197,15,304
2106636,10,6,16,50,11,0,61,201,45,307
2106637,9,6,15,43,24,4,71,181,30,282
2106638,0,0,0,24,7,0,31,114,14,159
2106639,0,0,0,0,0,0,0,0,0,0
2106640,3,0,3,26,14,0,40,98,11,149
2106641,6,0,6,30,23,0,53,158,7,218
2106642,4,3,7,64,36,3,103,257,12,372
2106643,7,0,7,32,11,0,43,109,25,177
2106644,3,0,3,37,21,0,58,105,12,175
2106645,10,3,13,68,11,6,85,164,13,262
2106646,3,0,3,86,34,0,120,259,27,406
2106647,0,0,0,35,12,6,53,133,15,201
2106701,0,0,0,62,18,0,80,143,15,238
2106702,3,0,3,33,10,3,46,150,10,206
2106703,0,0,0,82,41,3,126,237,24,387
2106704,3,0,3,66,18,0,84,160,15,259
2106705,0,0,0,63,14,0,77,198,15,290
2106706,3,0,3,35,23,4,62,217,16,295
2106707,0,0,0,27,28,0,55,160,13,228
2106708,0,0,0,37,17,3,57,120,9,186
2106709,6,3,9,23,16,9,48,109,18,175
2106710,3,0,3,21,12,3,36,123,15,174
2106711,0,0,0,50,10,3,63,104,0,167
2106712,0,0,0,32,12,4,48,125,0,173
2106713,0,0,0,69,20,4,93,173,10,276
2106714,3,0,3,31,14,6,51,148,20,219
2106715,0,3,3,44,23,0,67,125,11,203
2106716,0,0,0,37,25,0,62,147,16,225
2106717,3,0,3,69,34,4,107,195,8,310
2106718,4,0,4,43,9,0,52,131,9,192
2106719,4,0,4,52,22,0,74,172,17,263
2106720,3,0,3,59,26,7,92,151,6,249
2106721,3,0,3,54,15,3,72,184,9,265
2106722,6,0,6,55,19,3,77,183,18,278
2106723,0,4,4,46,35,7,88,194,22,304
2106724,0,4,4,36,32,3,71,168,12,251
2106725,6,3,9,62,22,6,90,170,3,263
2106726,0,0,0,41,15,3,59,138,0,197
2106727,0,0,0,42,14,0,56,138,12,206
2106728,0,0,0,35,16,3,54,145,4,203
2106729,6,3,9,46,27,6,79,266,20,365
2106730,3,0,3,46,18,3,67,152,12,231
2106731,0,0,0,26,12,3,41,108,3,152
2106801,9,0,9,42,16,3,61,176,32,269
2106802,0,0,0,38,18,0,56,160,161,377
2106803,0,0,0,48,18,0,66,193,12,271
2106804,4,0,4,59,26,0,85,159,24,268
2106805,3,0,3,41,19,3,63,187,19,269
2106806,0,0,0,29,27,0,56,121,12,189
2106807,7,3,10,49,3,4,56,199,30,285
2106808,13,0,13,77,34,0,111,233,25,369
2106809,3,3,6,43,28,0,71,172,21,264
2106810,4,0,4,58,18,0,76,190,11,277
2106811,44,3,47,58,25,0,83,343,27,453
2106812,11,0,11,58,13,6,77,136,26,239
2106901,3,0,3,25,12,0,37,176,12,225
2106902,5,0,5,33,15,0,48,144,13,205
2106903,0,6,6,43,22,5,70,141,18,229
2106904,20,4,24,52,8,7,67,182,25,274
2106905,3,3,6,43,19,6,68,135,20,223
2106906,0,0,0,29,11,3,43,128,18,189
2106907,3,6,9,51,13,9,73,150,13,236
2106908,0,0,0,0,0,0,0,3,0,3
2106909,10,0,10,17,5,3,25,120,15,160
2106910,3,0,3,40,3,0,43,101,9,153
2106911,6,0,6,54,11,3,68,248,14,330
2106912,3,0,3,16,3,6,25,103,14,142
2106913,0,0,0,12,11,0,23,70,11,104
2106914,5,0,5,31,9,9,49,183,15,247
2106915,4,0,4,58,24,6,88,183,24,295
2106916,3,0,3,27,11,6,44,187,37,268
2106917,26,11,37,36,6,3,45,188,28,261
2106918,4,0,4,38,8,0,46,130,14,190
2106919,4,0,4,40,17,6,63,161,15,239
2106920,0,0,0,0,0,0,0,0,0,0
2106921,0,0,0,42,20,6,68,152,9,229
2106922,3,0,3,70,21,0,91,206,15,312
2106923,0,0,0,54,15,0,69,163,3,235
2106924,6,0,6,35,14,3,52,140,18,210
2106925,0,0,0,24,6,0,30,157,12,199
2106926,0,3,3,60,17,6,83,181,21,285
2106927,0,0,0,49,15,3,67,167,11,245
2106928,8,0,8,54,13,0,67,179,5,251
2106929,0,0,0,11,3,0,14,103,29,146
2106930,0,0,0,18,0,0,18,71,25,114
2106931,8,0,8,36,15,0,51,151,29,231
2107001,9,0,9,92,32,6,130,244,23,397
2107002,0,0,0,44,6,7,57,97,12,166
2107003,5,6,11,57,20,6,83,203,18,304
2107004,7,3,10,41,12,3,56,114,9,179
2107005,0,4,4,81,44,0,125,217,23,365
2107006,0,0,0,39,19,3,61,154,15,230
2107007,3,0,3,20,17,0,37,135,27,199
2107008,6,3,9,56,12,11,79,152,7,238
2107009,6,0,6,52,9,3,64,198,18,280
2107101,10,6,16,87,37,6,130,268,24,422
2107102,0,0,0,27,19,4,50,166,3,219
2107103,3,0,3,21,14,0,35,152,14,201
2107104,0,6,6,24,12,0,36,103,9,148
2107105,3,0,3,34,3,0,37,84,3,124
2107106,4,0,4,39,25,0,64,159,18,241
2107107,0,3,3,48,24,9,81,223,15,319
2107108,41,0,41,27,12,0,39,258,23,320
2107109,0,0,0,51,24,4,79,158,25,262
2107110,6,3,9,21,9,0,30,96,10,136
2107111,0,0,0,57,25,0,82,194,16,292
2107112,17,3,20,60,31,3,94,271,33,398
2107113,0,0,0,0,0,0,0,3,0,3
2107114,20,0,20,37,19,0,56,186,19,261
2107115,14,0,14,68,29,0,97,268,23,388
2107201,0,0,0,34,7,0,41,115,0,156
2107202,3,0,3,69,24,6,99,200,17,316
2107203,10,0,10,31,9,6,46,125,10,181
2107204,37,5,42,33,15,4,52,202,28,282
2107205,6,0,6,27,12,5,44,124,12,180
2107206,13,0,13,37,13,3,53,207,12,272
2107207,3,0,3,45,18,6,69,146,3,218
2107208,0,0,0,59,22,3,84,173,12,269
2107209,11,0,11,25,7,0,32,138,12,182
2107210,0,5,5,37,22,0,59,183,19,261
2107211,4,6,10,56,13,3,72,190,18,280
2107212,6,0,6,57,9,0,66,126,13,205
2107213,35,7,42,70,35,6,111,272,39,422
2107214,14,6,20,53,27,6,86,263,33,382
2107215,0,0,0,0,0,0,0,0,0,0
2107216,3,0,3,45,25,9,79,196,21,296
2107217,3,0,3,32,18,0,50,125,11,186
2107218,3,0,3,37,18,3,58,118,9,185
2107219,0,7,7,46,27,3,76,250,19,345
2107220,0,0,0,64,15,0,79,101,9,189
2107301,0,0,0,37,15,10,62,102,36,200
2107302,0,3,3,136,40,10,186,201,21,408
2107303,3,0,3,41,24,4,69,183,7,259
2107304,0,0,0,93,38,0,131,210,30,371
2107305,6,0,6,97,32,3,132,265,9,406
2107306,3,0,3,79,40,9,128,229,15,372
2107307,0,6,6,84,46,4,134,249,15,398
2107308,12,3,15,32,9,0,41,190,28,259
2107309,0,0,0,50,23,9,82,113,4,199
2107310,0,0,0,57,34,3,94,163,13,270
2107311,3,0,3,84,29,4,117,180,5,302
2107312,3,0,3,46,13,9,68,136,35,239
2107313,0,0,0,65,25,4,94,206,23,323
2107314,4,0,4,53,15,3,71,124,9,204
2107315,0,0,0,84,42,6,132,240,15,387
2107316,4,0,4,56,27,3,86,152,23,261
2107317,4,0,4,69,29,0,98,193,12,303
2107318,0,0,0,30,21,0,51,101,9,161
2107319,3,0,3,54,26,6,86,165,13,264
2107320,51,0,51,125,71,8,204,358,32,594
2107321,0,0,0,98,27,9,134,157,15,306
2107322,3,0,3,90,25,0,115,200,16,331
2107323,0,0,0,123,31,3,157,215,19,391
2107324,0,0,0,98,19,7,124,135,12,271
2107325,0,0,0,164,24,10,198,186,12,396
2107326,0,0,0,108,18,5,131,222,8,361
2107327,7,3,10,87,18,9,114,196,11,321
2107328,3,0,3,100,40,3,143,232,23,398
2107329,6,0,6,53,20,3,76,171,18,265
2107330,0,6,6,68,29,0,97,171,21,289
2107331,4,0,4,74,30,0,104,234,14,352
2107332,0,0,0,42,29,15,86,221,3,310
2107333,5,0,5,81,39,0,120,317,23,460
2107334,8,0,8,74,36,0,110,204,9,323
2107335,0,0,0,46,17,0,63,115,6,184
2107401,0,0,0,44,21,0,65,171,15,251
2107402,70,5,75,80,34,7,121,303,33,457
2107403,0,0,0,32,15,0,47,90,6,143
2107404,0,0,0,46,6,3,55,86,3,144
2107405,3,0,3,246,45,21,312,249,21,582
2107406,0,0,0,134,19,5,158,219,18,395
2107407,3,0,3,43,15,3,61,170,24,255
2107408,0,0,0,7,0,0,7,4,3,14
2107409,3,0,3,38,17,0,55,100,16,171
2107410,0,0,0,0,0,0,0,3,0,3
2107411,13,6,19,69,36,5,110,294,42,446
2107412,10,6,16,76,36,8,120,285,20,425
2107413,6,7,13,62,21,6,89,217,57,363
2107414,3,0,3,66,27,3,96,164,30,290
2107415,0,0,0,111,42,16,169,273,18,460
2107416,0,0,0,56,17,4,77,115,9,201
2107417,6,6,12,47,26,0,73,208,47,328
2107418,8,0,8,64,21,4,89,233,33,355
2107419,0,0,0,51,25,4,80,158,16,254
2107420,9,6,15,56,36,6,98,221,34,353
2107421,11,0,11,35,19,3,57,159,15,231
2107422,17,4,21,65,37,3,105,283,37,425
2107423,18,5,23,55,29,0,84,261,29,374
2107424,8,6,14,27,23,0,50,144,22,216
2107425,0,0,0,63,9,0,72,160,22,254
2107426,4,0,4,45,38,8,91,244,12,347
2107427,7,0,7,74,50,3,127,285,52,464
2107428,0,6,6,62,42,0,104,262,36,402
2107429,32,0,32,14,16,6,36,156,3,195
2107430,9,4,13,39,18,0,57,172,23,252
2107431,0,0,0,0,0,0,0,19,0,19
2107432,3,3,6,38,24,0,62,140,22,224
2107433,3,3,6,66,38,3,107,259,18,384
2107434,4,0,4,78,32,0,110,251,32,393
2107435,0,0,0,40,6,0,46,121,6,173
2107436,0,0,0,77,6,7,90,101,4,195
2107437,0,0,0,103,37,0,140,319,15,474
2107438,0,0,0,53,28,0,81,202,18,301
2107439,0,0,0,91,34,3,128,240,42,410
2107440,0,3,3,147,48,15,210,314,24,548
2107441,5,0,5,103,26,5,134,295,17,446
2107442,3,0,3,58,11,7,76,200,21,297
2107443,0,0,0,80,25,12,117,259,25,401
2107444,4,0,4,100,40,0,140,303,14,457
2107445,9,3,12,48,16,7,71,184,27,282
2107446,0,0,0,132,24,3,159,168,12,339
2107447,6,0,6,69,31,0,100,165,6,271
2107448,0,0,0,3,0,0,3,3,3,9
2107449,0,0,0,22,18,0,40,103,9,152
2107450,0,0,0,26,13,0,39,92,0,131
2107451,3,3,6,47,26,9,82,214,41,337
2107452,0,0,0,87,13,4,104,293,85,482
2107453,4,0,4,54,21,6,81,138,28,247
2107454,3,0,3,18,11,0,29,390,29,448
2107455,0,0,0,51,17,0,68,129,6,203
2107501,66,0,66,93,41,7,141,295,15,451
2107502,7,0,7,82,35,10,127,186,8,321
2107503,3,0,3,60,15,0,75,163,12,250
2107504,0,0,0,55,22,6,83,165,13,261
2107505,3,0,3,35,27,0,62,89,6,157
2107506,3,3,6,67,21,0,88,208,22,318
2107507,0,0,0,80,37,4,121,159,9,289
2107508,0,0,0,37,16,0,53,130,9,192
2107509,4,0,4,69,40,0,109,230,21,360
2107510,3,3,6,81,34,6,121,216,16,353
2107511,0,0,0,47,27,3,77,131,15,223
2107512,3,0,3,66,33,0,99,186,14,299
2107601,35,3,38,27,15,3,45,244,55,344
2107602,11,3,14,168,47,7,222,496,66,784
2107603,0,3,3,39,16,6,61,116,15,192
2107604,0,0,0,107,38,0,145,259,7,411
2107605,3,0,3,33,16,0,49,99,9,157
2107606,0,0,0,145,39,4,188,313,34,535
2107607,8,0,8,122,41,6,169,295,34,498
2107608,0,0,0,82,26,15,123,245,21,389
2107609,0,6,6,85,49,6,140,267,32,439
2107610,3,0,3,82,33,3,118,259,20,397
2107611,0,0,0,57,21,3,81,145,30,256
2107612,0,0,0,53,17,0,70,125,15,210
2107613,0,0,0,59,35,0,94,214,39,347
2107614,0,0,0,62,26,0,88,207,40,335
2107615,6,0,6,43,13,4,60,111,3,174
2107616,4,6,10,99,29,3,131,263,39,433
2107617,3,3,6,87,36,0,123,189,43,355
2107618,3,3,6,54,18,0,72,148,18,238
2107619,0,3,3,67,15,6,88,110,12,210
2107620,0,0,0,79,17,7,103,249,17,369
2107621,3,0,3,94,42,4,140,238,12,390
2107622,4,0,4,51,18,4,73,144,11,228
2107623,3,3,6,29,9,0,38,90,12,140
2107624,0,0,0,50,25,0,75,143,36,254
2107625,0,0,0,21,6,0,27,74,4,105
2107626,3,0,3,23,12,0,35,63,12,110
2107627,3,0,3,50,19,3,72,108,14,194
2107628,6,0,6,36,33,0,69,158,7,234
2107629,10,5,15,88,38,5,131,313,32,476
2107630,50,6,56,30,29,3,62,243,27,332
2107631,60,0,60,81,32,12,125,381,28,534
2107632,3,0,3,87,29,4,120,170,29,319
2107633,4,0,4,26,12,6,44,102,12,158
2107701,0,0,0,0,0,0,0,19,0,19
2107702,0,0,0,19,15,0,34,115,6,155
2107703,0,0,0,28,18,3,49,166,22,237
2107704,0,0,0,30,10,3,43,142,12,197
2107705,6,0,6,47,11,0,58,186,24,268
2107706,0,0,0,0,0,0,0,13,0,13
2107707,0,0,0,4,0,0,4,0,0,4
2107708,6,3,9,56,8,0,64,153,16,233
2107709,16,3,19,78,21,7,106,216,15,337
2107710,0,0,0,49,18,0,67,86,3,156
2107711,4,0,4,60,15,9,84,141,15,240
2107712,5,0,5,90,37,10,137,258,25,420
2107713,6,3,9,47,13,7,67,247,29,343
2107714,10,0,10,83,25,0,108,251,15,374
2107715,3,6,9,47,22,0,69,217,15,301
2107716,0,0,0,81,17,0,98,149,6,253
2107717,6,0,6,36,15,0,51,123,12,186
2107718,0,0,0,0,0,0,0,0,0,0
2107719,9,0,9,88,44,0,132,241,31,404
2107720,0,3,3,25,15,6,46,122,6,174
2107721,6,0,6,69,23,6,98,138,21,257
2107722,3,0,3,35,10,3,48,127,37,212
2107801,0,4,4,90,25,9,124,317,32,473
2107802,0,0,0,58,20,6,84,177,32,293
2107803,3,3,6,34,19,0,53,112,30,195
2107804,0,0,0,42,17,0,59,160,22,241
2107805,0,0,0,46,16,3,65,148,27,240
2107806,13,0,13,63,32,3,98,216,24,338
2107807,0,0,0,28,18,6,52,113,0,165
2107808,3,0,3,68,23,6,97,200,11,308
2107809,22,30,52,34,22,6,62,241,70,373
2107810,5,11,19,24,15,4,43,128,16,187
2107811,6,0,9,133,41,13,187,277,25,489
2107812,3,3,6,110,35,7,152,292,22,466
2107813,3,0,3,31,22,3,56,132,0,188
2107814,0,0,0,76,21,0,97,156,28,281
2107815,0,0,0,36,18,3,57,105,17,179
2107816,0,3,3,23,4,0,27,93,29,149
2107817,3,3,6,75,31,6,112,276,30,418
2107818,0,0,0,15,0,0,15,107,12,134
2107819,0,0,0,31,20,0,51,147,19,217
2107820,0,0,0,36,24,3,63,118,15,196
2107821,6,6,12,44,16,6,66,135,24,225
2107901,0,0,0,49,28,6,83,152,9,244
2107902,10,3,13,76,36,5,117,287,21,425
2107903,5,0,5,65,25,9,99,195,8,302
2107904,12,0,12,76,25,9,110,246,16,372
2107905,10,3,16,63,31,15,109,289,27,425
2107906,4,3,7,42,18,3,63,185,33,281
2107907,0,0,0,76,23,3,102,181,10,293
2107908,3,3,6,60,16,6,82,206,18,306
2107909,9,0,9,52,34,3,89,135,9,233
2107910,19,3,22,82,44,0,126,250,20,396
2107911,3,3,6,46,18,3,67,164,25,256
2107912,12,7,19,49,24,3,76,256,36,368
2107913,4,4,8,60,36,6,102,245,23,370
2107914,7,0,7,52,19,0,71,158,6,235
2107915,0,0,0,45,25,3,73,150,24,247
2107916,9,0,9,63,32,0,95,259,27,381
2107917,0,0,0,75,18,0,93,141,25,259
2107918,0,0,0,48,10,6,64,84,10,158
2107919,4,0,4,45,22,0,67,137,10,214
2107920,4,0,4,53,27,4,84,152,18,254
2107921,0,0,0,88,28,7,123,227,17,367
2107922,3,0,3,70,33,0,103,170,13,286
2107923,13,0,13,64,41,6,111,240,19,370
2107924,4,0,4,26,6,0,32,134,26,192
2107925,68,46,114,57,6,4,67,272,88,427
2107926,6,0,6,51,25,0,76,243,15,334
2107927,6,0,6,110,46,5,161,240,17,418
2107928,5,3,8,129,37,0,166,316,33,515
2107929,6,0,6,66,33,3,102,198,33,333
2107930,4,0,4,76,29,4,109,212,6,327
2107931,4,3,7,68,38,6,112,239,24,375
2107932,3,0,3,102,45,3,150,277,15,442
2107933,7,0,7,62,28,0,90,166,9,265
2107934,6,0,6,207,48,6,261,377,12,650
2107935,0,0,0,68,31,0,99,222,43,364
2107936,3,0,3,60,29,4,93,185,24,302
2107937,3,0,3,63,16,4,83,175,12,270
2107938,3,0,3,62,14,6,82,219,27,328
2107939,9,9,18,68,44,6,118,257,37,412
2107940,0,0,0,86,19,4,109,177,12,298
2108001,0,0,0,0,0,0,0,0,0,0
2108101,3,0,3,14,3,3,20,77,12,109
2108102,3,0,3,235,45,12,292,469,33,794
2108103,0,0,0,44,8,4,56,121,15,192
2108104,6,3,9,117,32,5,154,300,18,472
2108105,6,0,6,51,30,6,87,272,14,373
2108106,5,5,10,94,23,0,117,254,25,396
2108107,19,9,28,77,36,6,119,348,43,510
2108108,7,3,10,142,56,9,207,436,35,678
2108109,5,0,5,105,29,8,142,307,41,490
2108110,6,5,11,74,22,9,105,251,36,392
2108111,9,0,9,40,21,3,64,135,17,216
2108112,16,9,25,56,22,0,78,214,42,334
2108113,27,4,31,83,16,10,109,306,41,456
2108114,11,5,16,75,33,5,113,307,27,447
2108115,8,4,12,32,16,0,48,143,15,206
2108116,67,8,75,44,33,3,80,322,44,446
2108117,17,3,23,92,26,0,118,296,38,452
2108118,6,3,9,38,21,0,59,169,33,261
2108119,5,0,5,33,32,0,65,109,6,180
2108120,22,3,25,63,26,3,92,297,35,424
2108121,9,0,9,48,23,0,71,212,24,307
2108122,6,6,12,80,11,0,91,228,18,337
2108123,6,0,6,41,25,3,69,189,31,289
2108124,8,0,8,40,18,3,61,136,15,212
2108125,7,7,14,92,27,0,119,292,27,438
2108126,56,0,56,57,26,0,83,281,22,386
2108127,0,0,0,41,23,0,64,127,23,214
2108128,3,0,3,52,31,7,90,194,34,318
2108129,0,0,0,29,15,3,47,121,12,180
2108130,4,0,4,40,0,0,40,115,24,179
2108201,0,0,0,17,11,0,28,54,0,82
2108202,3,3,6,60,28,0,88,225,17,330
2108203,0,0,0,83,47,3,133,285,26,444
2108204,3,0,3,57,18,3,78,167,20,265
2108205,0,0,0,51,22,0,73,202,3,278
2108206,0,0,0,35,9,0,44,123,10,177
2108207,0,0,0,24,25,3,52,128,9,189
2108208,10,0,10,33,9,3,45,152,24,221
2108209,6,0,6,24,7,5,36,156,8,200
2108210,0,0,0,34,8,0,42,110,34,186
2108211,9,0,9,63,20,9,92,227,25,344
2108212,4,4,8,56,11,0,67,166,33,266
2108213,4,3,7,25,13,0,38,140,18,196
2108214,0,0,0,33,16,0,49,131,17,197
2108215,0,0,0,40,20,3,63,167,6,236
2108216,6,0,6,45,18,3,66,215,20,301
2108217,0,3,3,3,8,0,11,105,18,134
2108218,6,0,6,50,11,9,70,170,19,259
2108219,6,0,6,66,27,3,96,320,10,426
2108220,0,0,0,13,12,0,25,125,12,162
2108221,6,0,6,37,10,0,47,152,9,208
2108222,0,0,0,43,18,3,64,181,22,267
2108223,0,0,0,7,11,0,18,115,4,137
2108224,7,3,10,63,20,0,83,188,42,313
2108225,0,0,0,51,21,0,72,152,22,246
2108301,0,0,0,0,0,0,0,0,0,0
2108401,0,0,0,62,12,9,83,204,29,316
2108402,9,0,9,50,23,9,82,272,41,395
2108403,4,3,7,25,13,6,44,167,37,248
2108404,41,4,45,72,24,6,102,329,25,456
2108405,7,3,10,57,22,3,82,245,26,353
2108406,5,0,5,72,36,6,114,383,37,534
2108407,7,0,7,66,20,6,92,270,31,393
2108408,0,0,0,61,26,0,87,144,12,243
2108409,0,0,0,42,19,4,65,174,23,262
2108410,6,0,6,49,16,8,73,226,20,319
2108411,6,0,6,42,15,3,60,192,15,267
2108412,8,3,11,32,15,3,50,189,22,261
2108413,0,0,0,25,15,0,40,140,6,186
2108414,4,3,7,17,19,3,39,122,36,197
2108415,9,7,16,15,15,9,39,152,22,213
2108416,4,0,4,61,28,6,95,252,19,366
2108417,10,9,19,32,17,6,55,187,59,301
2108418,11,0,11,42,21,0,63,205,46,314
2108419,49,3,52,12,14,9,35,225,33,293
2108420,6,6,15,30,15,11,56,182,27,265
2108421,8,7,15,40,20,4,64,232,58,354
2108422,0,0,0,0,3,0,3,0,0,3
2108423,6,3,9,50,16,3,69,131,21,221
2108424,11,3,14,51,38,6,95,240,35,370
2108425,5,0,5,47,17,3,67,129,15,211
2108426,6,0,6,28,8,4,40,141,12,193
2108427,0,0,0,37,13,0,50,169,12,231
2108428,6,0,6,20,18,3,41,128,19,188
2108501,3,0,3,47,5,0,52,124,19,195
2108502,3,0,3,41,19,0,60,137,11,208
2108503,3,3,6,25,19,0,44,113,21,178
2108504,10,0,10,39,18,4,61,163,29,253
2108505,0,0,0,48,29,0,77,268,34,379
2108506,14,0,14,42,18,0,60,204,25,289
2108507,6,3,9,37,18,3,58,163,24,245
2108508,0,0,0,6,10,0,16,55,15,86
2108509,29,7,36,53,18,3,74,242,38,354
2108510,5,0,5,15,15,3,33,103,13,149
2108511,0,0,0,52,14,0,66,196,17,279
2108512,6,0,6,28,15,4,47,181,18,246
2108513,5,0,5,38,20,0,58,121,3,182
2108514,5,0,5,73,28,5,106,213,19,338
2108515,0,4,4,55,27,3,85,221,20,326
2108516,0,0,0,68,31,4,103,156,3,262
2108517,0,0,0,43,11,3,57,117,15,189
2108518,5,0,5,47,17,6,70,174,30,274
2108519,6,0,6,27,21,3,51,192,6,249
2108520,9,0,9,54,26,8,88,241,34,363
2108521,0,0,0,9,9,3,21,121,15,157
2108522,4,3,7,38,22,5,65,196,15,276
2108601,0,0,0,21,18,0,39,99,15,153
2108602,0,3,3,21,21,0,42,140,12,194
2108603,12,4,16,49,35,3,87,323,34,444
2108604,0,0,0,73,30,3,106,204,21,331
2108605,66,0,66,48,22,3,73,383,25,481
2108606,5,3,8,47,27,4,78,348,27,453
2108607,6,0,6,40,22,5,67,384,34,485
2108608,15,6,21,34,28,0,62,190,25,277
2108609,3,0,3,34,16,0,50,173,6,229
2108610,7,0,7,68,20,3,91,274,27,392
2108611,6,6,12,29,9,0,38,144,36,218
2108612,10,6,16,37,26,3,66,155,34,255
2108613,7,5,12,14,0,0,14,115,21,150
2108614,6,5,11,35,22,0,57,215,27,299
2108615,0,0,0,25,13,0,38,193,11,242
2108616,8,3,11,26,20,0,46,208,27,281
2108617,0,0,0,0,0,0,0,0,0,0
2108701,6,0,6,45,18,3,66,238,39,343
2108702,6,0,6,25,10,3,38,128,9,175
2108703,3,5,8,23,9,3,35,97,40,172
2108704,0,3,3,32,19,0,51,158,18,227
2108705,0,0,0,42,27,4,73,179,15,267
2108706,10,5,15,28,22,3,53,180,23,256
2108707,21,6,27,39,12,0,51,161,16,228
2108708,6,0,6,7,9,0,16,131,18,165
2108709,5,0,5,49,19,0,68,287,19,374
2108710,3,0,3,29,12,3,44,110,20,174
2108711,7,3,10,58,47,4,109,256,15,380
2108712,23,0,23,33,15,3,51,227,22,300
2108713,27,6,33,45,36,0,81,272,27,380
2108714,6,3,9,64,31,9,104,230,34,368
2108715,6,0,6,65,18,6,89,235,10,334
2108716,10,0,10,68,31,9,108,218,26,352
2108717,0,0,0,29,18,0,47,148,27,222
2108718,0,0,0,36,21,0,57,91,4,152
2108719,3,0,3,84,36,3,123,251,21,395
2108720,3,3,6,105,48,0,153,317,28,498
2108721,6,0,6,36,6,0,42,127,3,172
2108722,6,0,6,60,25,0,85,213,13,311
2108723,3,0,3,53,20,0,73,205,16,294
2108724,7,0,7,24,15,0,39,109,16,164
2108725,3,3,6,33,16,0,49,75,15,139
2108801,0,0,0,16,3,0,19,76,0,95
2108901,15,4,19,81,36,6,123,264,29,416
2108902,5,0,5,54,22,0,76,148,28,252
2108903,0,0,0,49,21,0,70,157,11,238
2108904,6,3,9,60,38,3,101,224,24,349
2108905,38,6,44,66,22,4,92,265,27,384
2108906,0,0,0,39,12,0,51,121,9,181
2108907,6,6,12,84,30,0,114,233,36,383
2108908,6,0,6,101,50,3,154,296,32,482
2108909,0,0,0,64,20,3,87,161,10,258
2108910,6,0,6,48,19,9,76,156,12,244
2108911,0,0,0,59,19,0,78,155,16,249
2108912,6,0,6,61,32,3,96,185,18,299
2108913,6,0,6,30,17,0,47,143,3,193
2108914,3,0,3,66,18,7,91,181,18,290
2108915,3,0,3,46,21,0,67,125,6,198
2108916,0,0,0,61,24,0,85,111,6,202
2108917,9,0,9,56,26,9,91,245,24,360
2108918,7,0,7,47,19,0,66,220,12,298
2108919,8,0,8,113,37,0,150,326,23,499
2108920,0,0,0,33,22,3,58,151,12,221
2108921,49,6,55,68,35,6,109,350,39,498
2108922,7,0,7,68,25,5,98,220,25,343
2108923,4,0,4,23,15,0,38,106,3,147
2109001,0,3,3,47,26,3,76,153,26,255
2109002,21,0,21,56,18,7,81,171,25,277
2109003,5,3,8,73,26,0,99,191,35,325
2109004,12,4,16,55,26,10,91,184,19,294
2109005,38,0,38,47,32,8,87,254,16,357
2109006,6,6,12,72,23,8,103,175,36,314
2109007,6,0,6,51,33,3,87,195,22,304
2109008,29,0,29,78,23,8,109,223,18,350
2109009,8,6,14,55,26,6,87,156,21,264
2109010,10,0,10,56,24,4,84,149,26,259
2109011,6,0,6,93,30,4,127,246,14,387
2109012,0,0,0,62,23,0,85,246,33,364
2109013,6,0,6,61,40,6,107,215,25,347
2109014,4,0,4,73,22,6,101,182,15,298
2109015,5,0,5,112,37,0,149,259,6,414
2109016,3,0,3,67,36,3,106,224,22,352
2109017,0,0,0,97,33,7,137,259,14,410
2109018,18,6,24,68,38,8,114,366,39,519
2109019,8,0,8,107,26,0,133,301,26,460
2109020,4,0,4,52,20,3,75,193,29,297
2109021,6,0,6,39,30,9,78,163,9,250
2109022,8,0,8,57,29,3,89,180,26,295
2109023,7,3,10,70,30,0,100,219,30,349
2109024,0,3,3,47,28,9,84,155,16,255
2109025,0,0,0,49,18,0,67,132,7,206
2109026,3,0,3,42,16,0,58,149,10,217
2109101,58,12,70,43,23,0,66,387,63,516
2109102,3,0,3,91,29,6,126,252,62,440
2109103,3,0,3,65,15,6,86,184,26,296
2109104,0,0,0,154,30,0,184,254,33,471
2109105,4,0,4,28,8,0,36,216,11,263
2109106,7,4,11,41,19,3,63,205,26,294
2109107,20,6,26,112,43,0,155,330,39,524
2109108,0,0,0,129,48,4,181,315,39,535
2109109,3,0,3,63,18,3,84,164,15,263
2109110,6,3,9,31,24,0,55,139,22,216
2109111,5,0,5,39,14,3,56,120,17,193
2109112,5,0,5,85,17,4,106,172,17,295
2109113,0,3,3,44,9,3,56,124,31,211
2109114,3,6,9,15,0,0,15,88,12,115
2109115,9,6,15,75,44,7,126,306,23,455
2109116,5,6,11,51,45,0,96,205,23,324
2109117,7,3,10,31,9,0,40,192,30,262
2109118,6,3,9,27,23,0,50,144,19,213
2109119,3,0,3,73,28,0,101,193,29,323
2109120,60,6,66,94,50,7,151,385,34,570
2109121,14,3,22,47,25,8,80,227,31,338
2109122,6,3,9,67,29,9,105,231,27,363
2109123,6,0,6,45,29,0,74,219,18,311
2109124,0,0,0,0,0,0,0,0,0,0
2109201,0,0,0,0,3,0,3,5,0,8
2109301,10,3,13,55,33,6,94,285,52,431
2109302,12,0,12,63,20,3,86,231,26,343
2109303,11,0,11,51,22,0,73,203,24,300
2109304,6,0,6,35,13,3,51,155,9,215
2109305,0,0,0,30,7,3,40,83,6,129
2109306,0,0,0,72,45,0,117,210,20,347
2109307,0,0,0,30,12,3,45,109,3,157
2109308,0,0,0,50,23,6,79,156,30,265
2109309,0,0,0,38,16,0,54,126,9,189
2109310,4,0,4,55,21,6,82,204,16,302
2109311,0,0,0,0,0,0,0,0,0,0
2109312,3,0,3,71,28,0,99,168,37,304
2109313,3,3,6,29,17,3,49,125,13,187
2109314,16,3,22,31,26,3,60,179,40,279
2109315,9,0,9,83,46,3,132,328,40,500
2109316,41,50,91,21,22,0,43,253,127,423
2109317,9,3,12,97,28,0,125,256,28,409
2109318,7,6,13,66,31,0,97,250,36,383
2109319,3,3,6,90,21,6,117,303,42,462
2109320,3,3,6,46,25,3,74,212,48,334
2109321,15,0,15,35,32,0,67,210,29,306
2109322,14,3,17,50,26,6,82,296,39,417
2109323,11,61,77,147,53,11,211,410,120,741
2109324,17,5,22,65,26,3,94,253,28,375
2109325,0,6,6,35,20,0,55,113,21,189
2109326,0,0,0,55,20,6,81,206,30,317
2109327,3,0,3,51,27,0,78,161,25,264
2109328,27,0,27,34,31,0,65,211,37,313
2109329,5,0,5,32,32,3,67,144,24,235
2109330,6,0,6,79,25,4,108,195,12,315
2109331,7,0,7,61,18,12,91,200,24,315
2109332,7,3,10,69,19,3,91,221,42,354
2109333,5,0,5,66,42,0,108,241,37,386
2109334,5,0,5,43,20,7,70,220,21,311
2109335,0,6,6,52,24,0,76,201,16,293
2109336,4,3,7,36,20,4,60,196,24,280
2109337,8,0,8,53,24,3,80,230,56,366
2109338,0,3,3,69,31,0,100,214,34,348
2109339,8,3,11,68,48,3,119,451,56,626
2109340,16,5,21,47,35,6,88,300,41,429
2109341,10,3,13,51,34,6,91,293,63,447
2109342,10,6,16,71,39,9,119,343,57,519
2109343,4,0,4,86,35,6,127,305,31,463
2109344,0,0,0,75,21,0,96,175,11,282
2109345,17,0,17,37,24,4,65,258,29,352
2109346,0,0,0,34,14,0,48,167,19,234
2109347,0,0,0,35,9,4,48,127,13,188
2109348,3,3,6,22,9,3,34,140,24,198
2109349,12,0,12,39,23,3,65,167,20,252
2109350,3,0,3,138,36,3,177,278,23,478
2109351,0,0,0,11,12,0,23,42,3,68
2109401,6,0,6,40,17,3,60,166,9,235
2109402,3,0,3,76,15,7,98,190,30,318
2109403,3,8,11,49,27,3,79,186,35,300
2109404,3,0,3,43,18,0,61,158,15,234
2109405,0,0,0,65,42,9,116,296,33,445
2109406,0,0,0,38,18,0,56,95,9,160
2109407,0,0,0,80,39,7,126,248,12,386
2109408,3,3,6,73,17,0,90,177,12,279
2109409,3,0,3,26,7,0,33,100,15,148
2109410,8,0,8,94,51,9,154,256,32,442
2109411,3,0,3,68,30,10,108,177,56,341
2109412,16,0,16,0,16,0,16,253,0,269
2109413,8,0,8,149,29,3,181,361,42,584
2109414,5,0,5,79,34,12,125,287,22,434
2109415,3,0,3,76,34,0,110,266,24,400
2109416,0,0,0,60,43,0,103,217,27,347
2109417,3,0,6,62,26,3,91,162,9,262
2109418,0,0,0,41,12,6,59,103,3,165
2109419,0,0,0,63,19,4,86,145,11,242
2109420,3,0,3,64,25,3,92,191,14,297
2109421,4,0,4,57,35,6,98,199,20,317
2109422,3,0,3,33,20,3,56,120,15,191
2109423,3,0,3,61,24,0,85,194,37,316
2109424,4,0,4,36,38,0,74,193,9,276
2109425,0,3,3,66,33,15,114,196,25,335
2109426,7,0,7,41,28,0,69,180,21,270
2109427,3,0,3,62,34,6,102,152,9,263
2109428,0,0,0,39,21,0,60,126,7,193
2109429,0,0,0,124,22,6,152,160,12,324
2109430,0,0,0,56,31,0,87,134,23,244
2109431,0,0,0,22,33,0,55,110,3,168
2109501,4,0,4,37,16,0,53,129,12,194
2109502,5,0,5,82,36,9,127,235,17,379
2109503,7,0,7,50,13,0,63,206,19,288
2109504,6,0,6,86,30,6,122,286,53,461
2109505,4,6,10,44,40,3,87,226,31,344
2109506,0,0,0,52,29,0,81,186,17,284
2109507,8,3,11,42,13,0,55,195,29,279
2109508,6,8,14,17,19,3,39,232,56,327
2109509,0,0,0,56,41,12,109,205,21,335
2109510,0,0,0,0,0,0,0,0,0,0
2109511,72,3,75,98,38,4,140,441,44,625
2109512,6,3,9,71,27,3,101,233,46,380
2109513,0,0,0,71,35,0,106,186,21,313
2109514,0,3,3,53,42,3,98,307,25,430
2109515,10,8,18,110,30,3,143,383,48,574
2109516,5,0,5,74,10,6,90,229,27,346
2109517,10,0,10,70,27,9,106,208,28,342
2109518,0,0,0,69,19,0,88,241,25,354
2109519,12,6,18,68,20,4,92,179,23,294
2109520,25,10,35,52,32,4,88,272,59,419
2109521,3,4,7,51,24,9,84,195,34,313
2109522,75,0,75,53,27,0,80,308,21,409
2109523,8,3,11,76,37,6,119,328,40,487
2109524,13,3,16,31,16,3,50,200,36,286
2109525,6,0,6,75,42,4,121,267,44,432
2109526,6,0,6,102,39,10,151,265,18,434
2109527,0,0,0,51,34,10,95,308,50,453
2109528,9,0,9,68,24,0,92,188,28,308
2109529,6,0,6,75,31,7,113,195,31,339
2109530,13,0,13,51,22,3,76,204,12,292
2109531,0,4,4,55,24,3,82,223,21,326
2109532,0,0,0,102,33,3,138,335,38,511
2109533,5,0,5,61,25,9,95,196,36,327
2109534,0,0,0,89,27,0,116,258,24,398
2109535,21,0,21,69,46,0,115,287,35,437
2109536,8,0,8,53,31,0,84,243,31,358
2109537,11,5,16,54,19,6,79,183,27,289
2109538,8,3,11,37,19,6,62,165,22,249
2109601,64,3,67,95,31,3,129,329,35,493
2109602,0,0,0,16,12,0,28,133,24,185
2109603,0,0,0,55,21,3,79,201,14,294
2109604,0,0,0,6,0,0,6,3,0,9
2109605,7,3,10,45,31,0,76,256,36,368
2109606,4,0,4,37,27,6,70,184,21,275
2109607,12,0,12,23,22,3,48,239,19,306
2109608,35,5,40,64,28,11,103,287,65,455
2109609,11,3,14,81,36,9,126,362,41,529
2109610,4,3,7,42,31,0,73,200,27,300
2109611,0,0,0,60,23,3,86,222,39,347
2109612,6,0,6,51,40,3,94,209,48,351
2109613,7,0,7,88,34,0,122,278,58,458
2109614,11,0,11,80,27,4,111,252,54,417
2109615,41,9,50,37,9,5,51,273,54,378
2109616,9,3,12,38,28,3,69,266,42,377
2109617,3,0,3,26,21,4,51,156,34,241
2109618,0,3,3,36,14,3,53,147,26,226
2109619,11,6,17,55,31,7,93,279,36,408
2109620,4,0,4,62,28,9,99,185,38,322
2109621,9,0,9,29,20,0,49,127,9,185
2109622,4,0,4,53,32,0,85,183,21,289
2109623,6,0,6,82,31,4,117,299,36,452
2109624,0,4,4,78,33,0,111,222,31,364
2109625,0,0,0,0,0,0,0,3,0,3
2109626,4,3,7,52,41,6,99,292,45,436
2109627,6,3,12,45,14,0,59,269,35,363
2109628,0,0,0,106,28,3,137,237,36,410
2109629,0,0,0,29,24,0,53,188,15,256
2109630,7,0,7,70,44,6,120,281,17,418
2109631,6,3,9,35,12,0,47,157,25,229
2109632,3,3,6,48,15,3,66,158,31,255
2109633,5,3,8,63,27,6,96,235,31,362
2109634,6,6,12,53,20,6,79,271,59,409
2109635,0,0,0,45,26,3,74,152,23,249
2109636,0,0,0,0,0,0,0,0,0,0
2109701,0,0,0,40,22,0,62,158,28,248
2109702,4,0,4,48,23,3,74,177,33,284
2109703,0,0,0,45,16,0,61,109,24,194
2109704,10,0,10,40,22,0,62,142,14,218
2109705,3,3,6,46,5,4,55,116,15,186
2109706,6,3,9,59,10,0,69,158,40,267
2109707,0,0,0,47,20,0,67,102,15,184
2109708,3,0,3,64,24,4,92,203,35,330
2109709,0,0,0,56,18,3,77,119,20,216
2109710,3,3,6,51,24,3,78,141,19,238
2109711,0,0,0,81,34,3,118,210,63,391
2109712,3,0,3,32,15,0,47,101,9,157
2109713,0,0,0,39,12,3,54,86,17,157
2109714,8,4,12,41,22,6,69,190,73,332
2109715,8,0,8,53,33,6,92,186,33,311
2109716,37,3,40,45,9,6,60,206,35,301
2109717,11,3,14,110,56,7,173,350,40,563
2109718,0,0,0,3,3,0,6,31,0,37
2109719,3,0,3,37,23,0,60,158,10,228
2109720,3,3,6,90,36,3,129,201,15,345
2109721,0,0,0,150,49,0,199,325,15,539
2109722,0,3,3,69,25,0,94,214,22,330
2109723,3,0,3,93,26,0,119,234,34,387
2109724,0,0,0,64,19,3,86,131,7,224
2109725,4,3,7,58,17,3,78,150,6,234
2109726,17,4,21,54,28,0,82,240,24,346
2109727,0,0,0,27,14,3,44,140,11,195
2109728,8,0,8,35,18,7,60,198,14,272
2109729,3,0,3,173,45,7,225,394,72,691
2109730,3,0,3,32,13,3,48,162,12,222
2109731,11,0,11,60,27,5,92,230,32,354
2109732,0,0,0,69,25,0,94,141,12,247
2109733,6,0,6,43,17,3,63,163,10,236
2109734,3,0,3,60,18,0,78,179,5,262
2109735,6,3,9,104,44,6,154,281,25,460
2109736,3,4,7,57,25,0,82,196,29,307
2109737,8,3,11,38,29,0,67,290,41,398
2109738,3,0,3,34,14,0,48,156,3,207
2109739,0,0,0,181,62,6,249,354,24,627
2109740,3,3,6,70,31,0,101,226,40,367
2109741,0,0,0,153,35,0,188,183,10,381
2109742,35,0,35,96,29,0,125,252,46,423
2109743,0,0,0,196,54,18,268,348,11,627
2109744,0,0,0,84,37,0,121,223,20,364
2109745,11,3,14,60,44,3,107,277,27,411
2109746,0,0,0,56,31,0,87,187,17,291
2109747,23,6,29,63,16,4,83,200,20,303
2109748,4,0,4,67,38,7,112,226,28,366
2109749,0,0,0,78,36,0,114,234,35,383
2109750,3,0,3,88,53,0,141,232,41,414
2109751,3,3,6,62,26,0,88,190,24,302
2109752,3,0,3,56,30,4,90,203,6,299
2109753,6,0,6,48,22,0,70,146,12,228
2109754,78,8,86,31,13,0,44,279,69,392
2109755,0,0,0,59,14,12,85,118,0,203
2109756,3,4,7,50,28,3,81,237,50,368
2109757,3,0,3,53,28,3,84,190,8,282
2109758,7,3,10,68,37,0,105,250,25,380
2109759,11,0,11,86,62,0,148,276,43,467
2109760,0,0,0,43,16,4,63,146,17,226
2109761,8,3,11,67,26,0,93,230,39,362
2109762,0,0,0,174,41,0,215,233,24,472
2109763,0,0,0,0,0,0,0,6,0,6
2109764,0,0,0,81,21,0,102,209,22,333
2109801,0,0,0,82,17,3,102,184,18,304
2109802,0,0,0,0,0,0,0,0,0,0
2109803,0,0,0,72,21,6,99,263,12,374
2109804,0,0,0,68,31,3,102,169,15,286
2109805,0,0,0,15,3,0,18,0,0,18
2109806,0,0,0,71,32,4,107,194,22,323
2109807,5,0,5,61,40,0,101,249,33,383
2109808,8,5,13,32,27,6,65,187,22,274
2109809,4,3,7,39,16,0,55,137,31,223
2109810,0,0,0,32,20,0,52,101,12,165
2109811,0,3,3,57,12,0,69,122,27,218
2109812,0,0,0,21,12,3,36,81,3,120
2109813,0,0,0,99,45,5,149,308,43,500
2109814,0,3,3,71,32,6,109,234,25,368
2109901,0,0,0,0,0,0,0,12,8,20
2110001,3,0,3,28,15,0,43,236,29,308
2110002,0,0,0,30,9,0,39,109,9,157
2110003,3,0,3,93,38,6,137,220,19,376
2110004,0,0,0,96,27,12,135,238,36,409
2110005,0,0,0,0,0,0,0,0,0,0
2110006,0,3,3,53,19,3,75,194,13,282
2110007,0,0,0,0,0,0,0,12,4,16
2110008,3,0,3,77,16,4,97,170,25,292
2110009,8,4,12,16,11,0,27,291,51,369
2110010,0,0,0,51,18,7,76,233,27,336
2110011,6,0,6,28,24,4,56,184,24,264
2110012,6,7,13,12,7,3,22,211,38,271
2110013,0,0,0,12,3,3,18,82,3,103
2110101,5,0,5,41,14,3,58,164,12,234
2110102,11,0,11,46,21,0,67,193,10,270
2110103,5,0,5,123,48,12,183,254,60,497
2110104,0,0,0,70,13,3,86,155,15,256
2110105,3,4,7,51,12,0,63,95,7,165
2110106,6,0,6,48,26,0,74,167,25,266
2110107,3,0,3,76,39,3,118,253,24,395
2110108,0,4,4,43,14,3,60,160,25,245
2110109,6,0,6,60,24,6,90,209,32,331
2110110,12,3,15,60,32,4,96,197,28,321
2110111,32,4,36,57,29,4,90,177,7,274
2110112,15,0,15,49,29,6,84,190,16,290
2110113,3,0,3,57,21,6,84,164,19,267
2110114,3,0,3,30,26,3,59,180,12,251
2110115,0,0,0,73,37,9,119,256,70,445
2110116,5,0,5,50,32,9,91,234,52,377
2110117,5,0,5,65,33,10,108,199,26,333
2110118,3,0,3,100,32,4,136,209,19,364
2110119,3,0,3,68,38,9,115,229,37,381
2110120,3,0,3,28,22,3,53,92,3,148
2110121,7,3,10,75,24,0,99,180,28,307
2110122,6,3,9,98,44,3,145,271,21,437
2110123,52,7,59,65,21,3,89,260,25,374
2110124,14,0,14,50,32,6,88,195,29,312
2110125,14,7,21,74,36,3,113,247,22,382
2110126,17,3,20,66,34,9,109,317,34,460
2110127,0,0,0,41,23,6,70,155,15,240
2110128,3,0,3,60,36,0,96,138,24,258
2110129,7,0,7,46,35,3,84,171,8,263
2110130,0,0,3,82,52,6,140,264,38,442
2110131,0,0,0,23,8,5,36,130,17,183
2110132,3,3,6,61,29,0,90,165,68,323
2110133,0,0,0,49,16,4,69,127,19,215
2110134,0,0,0,58,18,0,76,137,10,223
2110135,3,0,3,27,17,0,44,118,18,180
2110201,0,0,0,51,18,3,72,152,8,232
2110202,6,0,6,71,29,0,100,272,21,393
2110203,0,0,0,6,8,0,14,14,809,837
2110204,4,0,4,42,22,3,67,118,13,198
2110205,3,3,6,35,16,3,54,167,40,261
2110206,3,3,6,78,26,3,107,242,12,361
2110207,3,0,3,48,26,3,77,143,21,241
2110208,0,0,0,57,8,7,72,145,9,226
2110209,4,0,4,84,44,0,128,189,13,330
2110210,0,0,0,54,28,0,82,181,26,289
2110211,3,0,6,40,14,3,57,184,25,266
2110212,0,0,0,38,12,3,53,140,9,202
2110301,7,0,7,115,11,6,132,292,24,448
2110302,0,0,0,26,6,0,32,46,9,87
2110303,6,0,6,124,39,5,168,205,18,391
2110304,0,0,0,57,18,4,79,186,25,290
2110305,0,0,0,106,16,5,127,189,18,334
2110306,11,0,11,31,22,0,53,160,16,229
2110307,8,0,8,54,42,6,102,244,23,369
2110308,6,0,6,68,29,12,109,201,21,331
2110309,0,0,0,74,25,4,103,209,19,331
2110310,0,0,0,12,16,6,34,92,19,145
2110311,35,3,38,87,32,9,128,285,24,437
2110312,0,0,0,72,21,3,96,145,15,256
2110313,13,3,16,89,34,0,123,293,30,446
2110314,8,3,11,61,20,0,81,182,22,285
2110315,3,0,3,28,14,0,42,147,31,220
2110316,6,3,9,45,31,0,76,273,38,387
2110317,10,3,13,71,43,7,121,271,25,417
2110318,15,8,23,89,14,4,107,251,28,386
2110319,60,6,66,57,25,6,88,324,35,447
2110320,14,3,17,72,34,0,106,243,36,385
2110321,3,0,3,86,24,10,120,202,20,342
2110322,0,0,0,62,21,0,83,136,24,243
2110323,19,0,19,104,34,6,144,275,34,453
2110324,18,12,30,50,23,6,79,162,37,278
2110325,0,0,0,130,18,6,154,241,27,422
2110326,6,3,9,52,39,3,94,228,29,351
2110327,16,3,19,85,30,9,124,321,44,489
2110328,6,4,10,35,23,0,58,258,57,373
2110329,0,0,0,23,24,9,56,111,9,176
2110330,4,0,4,45,23,3,71,164,15,250
2110331,3,0,3,85,32,0,117,232,30,379
2110332,6,0,6,35,9,3,47,90,10,147
2110333,10,0,10,83,47,6,136,253,23,412
2110334,11,0,11,80,35,0,115,265,29,409
2110401,3,0,3,38,15,0,53,124,23,200
2110402,0,0,0,31,13,0,44,100,10,154
2110403,8,0,8,73,34,0,107,277,12,396
2110404,4,0,4,45,5,4,54,125,5,184
2110405,5,0,5,42,30,0,72,165,11,248
2110406,0,3,3,32,21,9,62,140,26,228
2110407,0,0,0,0,0,0,0,3,0,3
2110408,0,3,3,18,13,0,31,163,33,227
2110409,8,3,11,33,12,0,45,167,10,222
2110410,7,0,7,44,17,0,61,215,29,305
2110411,6,3,9,55,31,8,94,294,17,405
2110412,14,6,23,34,24,0,58,238,34,330
2110413,15,0,15,42,17,3,62,209,18,289
2110414,16,3,19,64,28,3,95,316,29,440
2110415,34,5,39,52,9,0,61,297,51,409
2110416,3,0,3,65,24,0,89,237,15,341
2110501,3,0,3,26,12,0,38,144,5,187
2110502,8,0,8,59,28,4,91,432,19,542
2110503,6,4,10,51,21,3,75,249,86,410
2110504,0,0,0,37,19,0,56,208,19,283
2110505,3,0,3,32,13,3,48,238,10,296
2110506,8,0,8,51,32,0,83,294,35,412
2110507,6,0,6,54,30,3,87,288,29,404
2110508,4,0,4,38,21,0,59,264,25,348
2110509,0,3,3,25,7,3,35,212,28,275
2110510,21,4,25,74,33,4,111,353,45,509
2110511,0,57,57,115,39,12,166,631,143,940
2110512,3,0,3,57,7,8,72,170,24,266
2110513,0,0,0,76,35,3,114,538,57,709
2110514,3,0,3,62,27,11,100,253,25,378
2110515,6,0,6,71,27,0,98,201,17,316
2110516,0,0,0,27,25,0,52,162,14,228
2110517,6,0,6,99,8,0,107,228,21,356
2110518,3,0,3,59,27,3,89,233,23,345
2110519,3,0,3,38,15,3,56,201,27,284
2110520,8,0,8,69,19,3,91,220,11,322
2110521,0,0,0,35,16,3,54,271,53,378
2110522,7,3,10,60,18,0,78,464,56,598
2110523,10,3,13,81,28,3,112,435,67,614
2110524,6,6,12,66,14,3,83,268,27,378
2110525,3,3,6,49,19,0,68,191,49,308
2110526,13,0,13,65,17,6,88,279,13,380
2110527,0,0,0,45,16,3,64,189,24,277
2110528,6,0,6,40,15,9,64,186,6,256
2110529,4,0,4,52,27,6,85,328,18,431
2110530,7,0,7,54,23,0,77,338,14,429
2110531,43,0,43,76,30,3,109,361,30,500
2110532,6,0,6,20,13,0,33,135,17,185
2110533,8,0,8,67,19,8,94,294,21,409
2110534,3,0,3,80,30,7,117,389,27,533
2110535,7,0,7,64,24,4,92,436,42,570
2110536,7,3,10,43,19,3,65,235,16,316
2110537,3,0,3,34,17,3,54,338,50,442
2110538,3,0,3,41,27,6,74,330,41,445
2110539,6,0,6,29,25,6,60,311,13,384
2110540,3,3,6,91,14,4,109,320,9,438
2110541,4,0,4,44,30,0,74,416,55,545
2110542,0,0,0,48,18,0,66,288,42,396
2110543,10,0,10,76,33,6,115,339,28,482
2110544,3,3,6,80,40,4,124,591,76,791
2110545,0,0,0,49,27,0,76,465,22,563
2110546,0,3,3,24,17,0,41,181,21,243
2110547,3,0,3,31,6,0,37,191,13,241
2110548,6,0,6,27,3,3,33,140,3,176
2110549,0,0,0,48,25,3,76,214,9,299
2110550,8,3,11,47,24,6,77,254,39,370
2110601,9,0,9,79,34,3,116,355,17,488
2110602,7,3,10,43,25,6,74,393,71,538
2110603,3,0,3,38,24,3,65,290,36,391
2110604,6,0,6,58,36,0,94,305,19,418
2110605,6,0,6,53,21,0,74,266,12,352
2110606,7,0,7,31,13,8,52,206,28,286
2110607,7,0,7,43,18,3,64,326,25,415
2110608,10,3,16,66,29,3,98,294,45,437
2110609,0,4,4,64,24,9,97,323,38,458
2110610,5,0,5,29,3,0,32,255,25,312
2110611,0,0,0,48,24,3,75,309,34,418
2110612,9,0,9,71,27,8,106,313,36,455
2110613,11,0,11,60,28,8,96,249,9,354
2110614,6,0,6,62,34,0,96,450,35,581
2110615,0,0,0,54,17,0,71,259,9,339
2110616,6,3,9,56,9,7,72,172,23,267
2110617,5,0,5,61,37,6,104,301,34,439
2110618,3,0,3,42,9,4,55,211,13,279
2110619,5,0,5,35,30,6,71,157,22,250
2110701,8,0,8,81,15,6,102,272,16,390
2110702,7,0,7,45,31,3,79,222,28,329
2110703,8,0,8,55,15,0,70,327,24,421
2110704,6,0,6,47,15,3,65,233,22,320
2110705,11,0,11,56,25,4,85,315,37,437
2110706,8,0,8,107,21,0,128,315,55,498
2110707,10,6,16,80,30,5,115,342,41,498
2110708,0,0,0,38,16,0,54,259,15,328
2110709,4,3,7,55,25,3,83,480,28,591
2110710,4,0,4,56,7,0,63,192,15,270
2110711,29,3,32,33,9,0,42,217,21,280
2110712,6,6,12,66,20,7,93,291,29,413
2110713,8,0,8,61,26,3,90,272,20,382
2110714,7,0,7,73,24,3,100,281,26,407
2110715,30,0,30,45,17,3,65,326,33,424
2110716,6,3,9,43,6,4,53,304,64,421
2110717,8,0,8,44,14,0,58,226,26,310
2110718,3,0,3,29,9,6,44,264,28,336
2110719,6,0,6,67,16,4,87,351,46,484
2110720,6,7,13,57,22,4,83,338,75,496
2110721,4,0,4,43,11,0,54,289,18,361
2110722,8,0,8,23,3,0,26,135,21,182
2110723,5,4,9,46,24,3,73,189,17,279
2110724,3,0,3,19,15,3,37,240,33,310
2110725,10,0,10,72,23,9,104,262,20,386
2110726,5,6,11,66,21,0,87,229,30,346
2110727,4,0,4,33,16,0,49,218,42,309
2110728,3,3,6,43,9,0,52,175,9,236
2110729,0,0,0,42,12,0,54,170,25,249
2110730,3,0,3,21,7,0,28,226,24,278
2110731,3,3,6,74,19,6,99,326,21,446
2110801,6,0,6,33,23,0,56,221,11,288
2110802,0,0,0,29,12,6,47,145,21,213
2110803,6,0,6,65,37,6,108,298,52,458
2110804,3,0,3,46,15,0,61,169,43,273
2110805,12,6,18,74,22,12,108,291,44,443
2110806,3,0,6,53,24,6,83,279,44,406
2110807,0,0,0,56,15,3,74,190,10,274
2110808,14,4,18,55,26,3,84,259,16,359
2110809,0,4,4,71,28,0,99,355,41,495
2110810,10,0,10,95,17,9,121,216,15,352
2110811,4,0,4,72,15,3,90,233,16,339
2110812,0,0,0,53,3,0,56,127,13,196
2110813,0,0,0,75,21,3,99,203,9,311
2110814,0,0,0,88,19,9,116,206,10,332
2110815,7,3,13,50,33,6,89,326,39,454
2110816,12,0,12,66,21,0,87,228,18,333
2110817,4,0,4,47,20,3,70,178,18,266
2110818,6,0,6,44,10,0,54,188,21,263
2110819,7,0,7,67,28,7,102,354,58,514
2110820,34,6,40,61,25,6,92,336,60,488
2110821,6,0,6,63,29,0,92,323,41,456
2110822,0,0,0,144,19,0,163,368,44,575
2110823,9,0,9,82,23,12,117,281,48,446
2110824,0,3,6,95,37,3,135,287,32,454
2110825,9,5,14,89,30,0,119,314,41,474
2110826,3,0,3,64,15,5,84,208,7,299
2110827,12,0,12,51,18,3,72,203,22,297
2110828,4,3,7,86,9,5,100,194,15,309
2110829,0,0,0,68,32,3,103,275,36,414
2110830,5,0,5,60,21,3,84,156,11,251
2110831,6,0,6,104,14,6,124,250,35,409
2110832,10,0,10,49,19,3,71,240,29,340
2110833,8,0,8,71,25,0,96,355,36,487
2110834,6,0,6,45,24,3,72,244,47,363
2110835,0,3,3,67,13,7,87,211,31,329
2110836,5,0,5,58,16,6,80,173,28,281
2110837,7,0,7,46,23,0,69,166,23,258
2110838,0,0,0,114,37,3,154,291,20,465
2110839,8,0,8,51,15,0,66,172,18,256
2110840,6,3,9,30,22,9,61,187,18,266
2110841,9,3,12,52,15,0,67,245,55,367
2110842,7,0,7,55,23,0,78,276,22,376
2110843,7,3,10,56,25,3,84,247,31,362
2110844,0,3,3,75,23,6,104,260,12,376
2110845,4,0,4,68,3,6,77,152,22,251
2110846,6,0,6,75,15,4,94,228,24,346
2110847,3,0,3,53,15,4,72,196,42,310
2110848,4,3,7,35,11,0,46,134,12,192
2110849,3,0,3,77,22,3,102,250,14,366
2110850,7,0,7,72,22,6,100,241,20,361
2110851,0,0,0,52,23,0,75,146,20,241
2110852,0,0,0,28,6,0,34,145,7,186
2110853,0,0,0,95,25,3,123,443,78,644
2110854,6,3,9,54,7,0,61,164,24,249
2110855,6,0,6,49,16,0,65,252,24,341
2110856,0,0,0,26,13,0,39,105,13,157
2110857,3,0,3,39,10,0,49,137,11,197
2110858,3,0,3,99,25,0,124,234,20,378
2110859,8,48,56,29,4,0,33,163,80,276
2110860,0,0,0,20,8,0,28,231,23,282
2110901,11,0,11,72,21,3,96,326,26,448
2110902,9,0,9,72,10,6,88,184,16,288
2110903,9,3,12,46,14,3,63,178,15,256
2110904,11,3,14,88,11,0,99,222,21,342
2110905,3,0,3,75,4,4,83,176,12,271
2110906,7,0,7,111,13,4,128,239,10,377
2110907,10,3,13,81,27,9,117,211,9,337
2110908,0,6,6,85,24,0,109,120,9,238
2110909,6,0,6,112,32,0,144,220,15,379
2110910,10,3,13,58,9,8,75,149,15,239
2110911,6,0,6,94,23,3,120,228,9,357
2110912,6,3,9,80,16,0,96,212,14,322
2110913,6,3,9,88,16,4,108,220,21,349
2110914,7,0,7,60,6,6,72,153,14,239
2110915,3,0,3,65,11,4,80,206,15,301
2110916,5,0,5,55,19,0,74,186,12,272
2110917,6,0,6,86,12,3,101,195,9,305
2110918,15,0,15,87,27,6,120,267,18,405
2110919,56,4,60,55,13,6,74,225,24,323
2110920,13,0,13,72,7,4,83,179,23,285
2110921,8,3,11,38,24,0,62,226,48,336
2110922,6,6,12,80,16,0,96,238,32,366
2110923,4,3,7,90,18,0,108,202,24,334
2110924,8,3,11,35,12,0,47,141,18,206
2111001,8,0,8,71,9,7,87,216,16,319
2111002,3,0,3,83,9,9,101,201,20,322
2111003,5,0,5,99,24,8,131,236,23,390
2111004,6,0,6,43,20,4,67,150,21,238
2111005,3,0,3,55,7,0,62,94,9,165
2111006,6,0,6,94,25,11,130,263,21,414
2111007,7,0,7,74,26,4,104,289,18,411
2111008,15,6,21,79,22,4,105,294,34,433
2111009,0,0,0,0,0,0,0,3,0,3
2111010,13,3,16,65,43,0,108,399,43,550
2111011,0,0,0,55,18,0,73,165,0,238
2111012,6,0,6,80,38,11,129,229,18,376
2111013,0,0,0,91,33,7,131,308,12,451
2111014,10,0,10,52,15,0,67,233,22,322
2111015,7,0,7,118,21,0,139,356,30,525
2111016,8,3,11,92,18,9,119,186,15,320
2111017,10,0,10,57,18,0,75,127,4,206
2111018,0,0,0,49,15,0,64,240,20,324
2111019,8,3,11,57,18,6,81,278,34,393
2111020,0,0,0,0,0,0,0,0,0,0
2111021,0,0,0,0,0,0,0,7,0,7
2111022,6,0,6,77,11,9,97,208,12,317
2111101,48,10,58,59,12,3,74,219,18,311
2111102,5,0,5,27,20,0,47,207,13,267
2111103,6,4,10,81,20,11,112,469,25,606
2111104,4,0,4,75,31,0,106,386,37,529
2111105,0,0,0,97,20,4,121,330,27,478
2111106,3,0,3,71,29,4,104,130,24,258
2111107,3,3,6,100,31,0,131,286,15,432
2111108,39,0,39,68,20,6,94,370,63,527
2111109,0,0,0,56,18,6,80,165,10,255
2111110,7,0,7,91,26,6,123,276,36,435
2111111,4,0,4,55,9,0,64,128,12,204
2111112,6,0,6,142,22,3,167,292,21,480
2111113,3,3,6,87,37,8,132,292,35,459
2111114,8,0,8,90,31,12,133,295,37,465
2111115,13,4,17,84,27,9,120,248,16,384
2111116,3,0,3,37,15,0,52,135,23,210
2111117,6,3,9,69,25,0,94,199,27,320
2111118,7,4,11,78,12,9,99,234,27,360
2111119,3,0,3,67,14,0,81,152,9,242
2111120,0,0,0,31,16,0,47,237,19,303
2111121,0,0,0,48,23,0,71,177,27,275
2111122,3,0,3,60,22,6,88,163,19,270
2111123,8,0,8,39,23,0,62,419,68,549
2111124,4,0,4,54,31,7,92,229,15,336
2111125,0,0,0,43,25,0,68,159,4,231
2111126,8,0,8,66,15,6,87,237,13,337
2111127,5,0,5,91,20,3,114,202,3,319
2111128,9,3,12,81,19,9,109,315,25,449
2111129,11,0,11,75,22,6,103,298,19,420
2111130,0,0,0,91,37,7,135,323,12,470
2111131,3,3,6,24,20,0,44,219,24,287
2111132,0,3,6,69,34,0,103,243,42,388
2111133,7,3,10,61,29,7,97,306,27,430
2111134,6,0,6,65,27,0,92,177,12,281
2111135,8,3,11,63,23,12,98,221,23,342
2111136,11,0,11,119,37,15,171,276,15,462
2111137,3,6,9,101,23,10,134,249,11,394
2111138,6,0,6,78,32,11,121,207,9,337
2111139,0,0,0,50,17,9,76,165,18,259
2111140,6,3,9,105,26,3,134,275,24,433
2111141,5,0,5,48,21,7,76,237,9,322
2111142,37,7,44,70,12,0,82,255,14,351
2111143,9,0,9,75,37,3,115,360,32,507
2111144,9,0,9,66,26,0,92,221,10,323
2111145,3,0,3,86,29,7,122,304,24,450
2111146,7,0,7,55,23,4,82,258,27,367
2111147,0,0,0,64,27,6,97,157,40,294
2111148,11,0,11,90,21,5,116,396,15,527
2111149,8,0,8,50,24,3,77,226,22,325
2111150,50,4,54,10,6,3,19,198,23,240
2111151,0,0,0,81,18,6,105,175,21,301
2111152,3,0,3,51,26,0,77,238,6,321
2111153,0,0,0,0,0,0,0,0,0,0
2111201,11,0,11,72,42,4,118,296,29,443
2111202,9,4,13,60,26,3,89,252,44,385
2111203,6,3,9,53,25,0,78,196,21,295
2111204,6,0,6,36,18,0,54,173,22,249
2111205,13,0,13,75,29,9,113,385,58,556
2111206,6,0,6,65,15,0,80,196,34,310
2111207,10,4,14,88,29,0,117,223,37,377
2111208,11,0,14,55,26,3,84,204,18,306
2111209,6,0,6,58,26,3,87,318,62,467
2111210,17,0,17,69,27,3,99,288,22,409
2111211,4,0,4,54,3,0,57,147,7,211
2111212,6,0,6,51,16,6,73,311,45,429
2111213,6,0,6,60,33,7,100,244,32,376
2111214,3,0,3,79,19,0,98,298,18,414
2111215,3,3,6,68,24,10,102,192,39,333
2111216,3,0,3,70,28,0,98,260,11,369
2111217,6,0,6,71,13,0,84,179,20,283
2111218,6,0,6,38,12,6,56,196,10,262
2111219,6,0,6,98,13,4,115,206,9,330
2111220,7,3,10,68,30,0,98,259,49,406
2111221,51,6,57,56,27,3,86,332,29,447
2111222,4,0,4,41,18,6,65,153,21,239
2111223,4,0,4,98,26,4,128,252,29,409
2111224,8,0,8,67,29,0,96,239,34,369
2111225,9,4,16,85,21,3,109,293,67,469
2111226,4,0,4,80,12,5,97,220,14,331
2111227,8,3,11,43,14,0,57,201,42,300
2111228,10,4,14,111,16,8,135,218,14,367
2111229,3,0,3,82,17,3,102,237,19,358
2111230,6,0,6,82,22,6,110,281,15,406
2111231,4,3,7,29,8,6,43,142,10,195
2111232,6,0,6,67,15,10,92,249,23,364
2111233,4,0,7,66,12,11,89,219,31,339
2111234,9,0,9,61,18,0,79,264,54,397
2111235,6,0,6,67,40,3,110,354,30,494
2111236,3,6,9,37,14,6,57,147,15,219
2111237,3,0,3,45,20,0,65,222,9,296
2111238,4,0,4,58,18,0,76,223,25,324
2111239,6,0,6,42,14,3,59,262,33,354
2111240,15,3,18,13,7,3,23,220,23,266
2111241,3,0,3,45,11,0,56,185,4,245
2111242,0,0,0,34,9,3,46,216,37,299
2111301,0,0,0,0,0,0,0,0,0,0
2111302,4,0,4,62,17,0,79,172,9,260
2111303,6,3,15,118,25,6,149,302,30,481
2111304,8,0,8,112,22,3,137,327,24,488
2111305,10,0,10,103,40,11,154,408,39,601
2111306,10,8,18,125,36,15,176,342,15,533
2111307,25,0,25,129,12,3,144,320,17,481
2111308,7,0,7,55,17,0,72,197,12,281
2111309,4,0,4,52,15,0,67,197,18,282
2111310,3,3,6,44,15,3,62,165,15,242
2111311,6,0,6,93,31,4,128,334,23,485
2111312,6,3,9,61,26,0,87,314,47,448
2111313,3,0,3,51,23,0,74,257,26,357
2111314,6,0,6,47,13,6,66,251,27,344
2111315,0,0,0,57,14,3,74,271,33,378
2111316,0,0,0,67,16,4,87,187,55,329
2111317,3,0,3,67,3,4,74,228,72,374
2111318,4,0,4,37,4,0,41,134,60,235
2111319,3,4,7,36,12,0,48,322,58,428
2111320,0,0,0,49,24,3,76,200,24,300
2111321,6,0,6,65,6,3,74,172,51,297
2111322,0,0,0,41,27,0,68,214,23,305
2111323,6,3,9,47,15,0,62,250,26,338
2111324,4,0,4,97,14,4,115,278,22,415
2111325,3,0,3,74,21,8,103,183,21,307
2111326,3,0,3,65,15,4,84,271,30,385
2111327,4,0,4,95,35,3,133,280,38,451
2111328,3,3,6,90,22,0,112,212,39,363
2111329,3,0,3,31,6,6,43,122,11,176
2111330,0,0,0,42,3,12,57,180,18,255
2111331,6,3,9,44,22,0,66,181,27,274
2111332,0,5,5,32,6,3,41,144,30,215
2111401,0,0,0,28,21,0,49,170,4,223
2111402,9,3,12,60,35,0,95,277,37,409
2111403,15,7,22,68,9,3,80,202,22,304
2111404,22,4,26,52,28,0,80,213,26,319
2111405,21,4,25,42,18,4,64,234,23,321
2111406,13,3,16,77,19,0,96,299,30,425
2111407,4,5,9,103,32,3,138,279,32,449
2111408,8,3,11,68,17,4,89,205,25,319
2111409,11,3,14,106,31,4,141,272,24,437
2111410,14,6,20,85,26,7,118,257,46,421
2111411,12,0,12,49,22,3,74,150,12,236
2111412,7,0,7,81,15,0,96,156,12,264
2111413,16,6,22,94,52,3,149,320,32,501
2111414,6,0,6,93,22,0,115,252,26,393
2111415,8,3,11,36,18,0,54,136,9,199
2111416,13,0,13,64,15,0,79,146,29,254
2111417,5,0,5,61,23,9,93,203,21,317
2111418,11,0,11,66,12,3,81,190,27,298
2111419,4,0,4,38,17,0,55,153,15,223
2111420,3,0,3,58,22,0,80,177,16,273
2111421,10,0,10,81,18,3,102,281,21,404
2111422,3,0,3,51,14,0,65,157,21,243
2111423,11,0,11,63,23,6,92,258,41,391
2111424,3,3,6,42,23,6,71,154,23,248
2111425,7,7,14,76,23,0,99,207,26,332
2111426,6,3,9,66,26,0,92,235,18,345
2111427,3,4,7,66,28,0,94,310,104,508
2111428,12,0,12,67,22,5,94,267,28,389
2111429,7,0,7,59,17,9,85,191,12,288
2111430,13,0,13,61,11,9,81,164,9,254
2111431,3,0,3,41,28,6,75,158,30,263
2111432,0,3,3,44,16,3,63,259,30,352
2111433,11,0,11,52,18,0,70,294,18,382
2111434,6,0,6,52,16,0,68,187,10,265
2111435,8,3,11,70,30,6,106,280,25,411
2111436,7,0,7,61,15,6,82,187,19,288
2111437,4,3,7,74,20,6,100,332,37,469
2111438,3,3,6,71,29,4,104,295,18,417
2111439,8,0,8,55,21,0,76,172,12,260
2111440,70,10,80,78,20,3,101,285,30,416
2111441,7,3,10,95,23,3,121,251,41,413
2111442,8,4,12,93,35,4,132,283,14,429
2111443,6,18,24,58,18,3,79,242,47,368
2111444,12,3,15,122,28,0,150,303,21,474
2111445,6,0,6,54,21,6,81,247,29,357
2111446,3,0,3,61,15,0,76,230,39,345
2111447,30,10,40,65,6,0,71,227,38,336
2111448,4,0,4,61,23,4,88,195,21,304
2111449,15,0,15,85,22,3,110,246,12,368
2111450,5,0,8,43,24,0,67,195,9,271
2111451,4,0,4,53,6,4,63,156,6,225
2111452,8,0,8,84,30,6,120,300,27,447
2111453,6,6,12,45,18,0,63,228,28,319
2111454,3,0,3,54,14,3,71,198,13,282
2111455,0,26,26,33,13,0,46,124,56,226
2111456,0,0,0,22,21,3,46,191,6,243
2111457,14,44,58,21,9,0,30,173,88,291
2111458,8,0,8,59,5,9,73,245,6,324
2111459,0,0,0,52,15,0,67,189,9,265
2111460,12,0,12,47,13,0,60,233,18,311
2111461,9,0,9,79,39,0,118,281,20,419
2111501,6,3,9,56,20,4,80,238,16,334
2111502,7,0,7,52,18,7,77,264,31,372
2111503,7,0,7,48,11,0,59,200,16,275
2111504,0,0,0,45,6,0,51,210,12,273
2111505,3,0,3,51,18,3,72,298,16,386
2111506,3,0,3,47,17,0,64,192,53,309
2111507,3,3,6,69,5,6,80,226,71,377
2111508,0,0,0,77,34,5,116,353,27,496
2111509,0,0,0,36,9,6,51,120,37,208
2111510,3,0,3,33,16,3,52,249,41,342
2111511,3,0,3,76,22,4,102,270,36,408
2111512,7,4,11,60,23,0,83,320,70,473
2111513,0,0,0,66,20,0,86,231,9,326
2111514,27,4,31,23,6,0,29,273,27,329
2111515,6,0,6,73,6,4,83,241,46,370
2111516,6,0,6,64,31,3,98,288,29,415
2111517,6,0,6,82,35,6,123,904,123,1150
2111518,0,0,0,0,0,0,0,0,0,0
2111519,0,0,0,43,9,0,52,138,43,233
2111520,7,0,10,51,10,3,64,192,87,343
2111521,3,0,3,32,0,0,32,146,38,216
2111601,3,3,6,57,9,12,78,189,16,283
2111602,13,30,43,45,22,0,67,295,94,456
2111603,11,3,14,75,24,6,105,242,27,374
2111604,8,0,8,75,8,4,87,229,26,342
2111605,3,0,3,29,17,0,46,236,35,317
2111606,0,3,3,71,25,3,99,174,21,294
2111607,3,0,3,60,15,0,75,282,10,367
2111608,9,0,9,85,27,6,118,236,18,372
2111609,5,3,8,51,14,0,65,181,28,274
2111610,3,3,6,78,19,5,102,209,23,334
2111611,6,0,9,73,24,8,105,236,9,350
2111612,6,0,6,87,19,3,109,209,21,339
2111613,6,4,10,78,24,0,102,339,31,472
2111614,10,0,10,70,27,0,97,243,30,370
2111615,14,0,14,76,21,7,104,311,42,457
2111616,7,0,7,65,29,0,94,296,27,417
2111617,7,0,7,58,21,4,83,263,49,395
2111618,3,0,3,90,12,6,108,245,18,371
2111619,7,0,7,76,24,0,100,268,39,407
2111620,10,0,10,61,27,0,88,209,16,313
2111621,6,0,6,93,14,4,111,235,14,360
2111622,11,0,11,89,25,3,117,243,24,384
2111623,7,0,7,59,21,3,83,323,10,416
2111624,14,0,14,69,17,6,92,211,13,316
2111625,16,3,19,47,10,4,61,303,35,399
2111626,21,0,21,74,22,4,100,290,33,423
2111627,6,3,9,71,17,0,88,172,18,278
2111628,7,0,7,46,26,3,75,261,36,372
2111629,0,0,0,3,0,0,3,0,0,3
2111630,0,3,3,60,9,0,69,195,15,279
2111631,78,4,82,90,23,4,117,390,21,528
2111632,0,0,0,74,15,4,93,115,9,217
2111701,0,0,0,22,31,0,53,530,56,639
2111702,3,0,3,31,24,0,55,304,35,394
2111703,3,0,3,9,24,0,33,194,15,242
2111704,0,0,0,38,18,3,59,293,38,390
2111705,0,4,4,26,12,0,38,298,32,368
2111706,0,0,0,31,20,0,51,450,69,570
2111707,3,0,3,36,5,0,41,480,24,545
2111708,0,0,0,6,9,0,15,433,45,493
2111709,6,0,6,22,27,0,49,300,64,413
2111710,0,0,0,7,12,0,19,372,122,513
2111711,9,0,9,18,12,3,33,254,34,321
2111712,0,0,0,34,17,0,51,276,29,356
2111713,0,0,0,31,22,3,56,284,23,363
2111714,0,3,3,17,6,0,23,189,59,271
2111715,6,0,6,33,31,0,64,310,70,444
2111716,3,0,3,16,35,3,54,192,31,277
2111717,0,0,0,27,18,0,45,155,11,211
2111718,3,3,6,59,12,3,74,267,91,432
2111719,0,0,0,4,4,0,8,509,52,569
2111720,0,3,3,30,9,3,42,152,85,279
2111721,0,0,0,11,6,0,17,423,82,522
2111722,6,3,9,45,6,0,51,140,44,235
2111723,3,3,6,52,15,0,67,154,93,314
2111724,0,0,0,0,0,0,0,0,0,0
2111725,0,0,0,27,30,0,57,265,36,358
2111726,0,0,0,19,0,0,19,208,42,269
2111727,0,0,0,18,16,0,34,292,34,360
2111728,0,0,0,6,6,0,12,508,38,558
2111729,0,0,0,14,7,0,21,248,38,307
2111730,0,0,0,19,9,3,31,638,74,743
2111731,0,0,0,0,8,0,8,351,49,408
2111732,0,0,0,0,5,0,5,844,80,929
2111801,0,0,0,27,24,0,51,313,34,398
2111802,0,0,0,35,43,6,84,339,59,482
2111803,0,0,0,57,12,3,72,651,187,910
2111804,0,0,0,48,14,0,62,431,138,631
2111805,0,0,0,30,18,0,48,360,102,510
2111806,0,0,0,17,3,0,20,155,6,181
2111807,3,0,3,19,3,0,22,151,11,184
2111808,3,0,3,25,10,0,35,195,18,248
2111809,0,0,0,14,4,0,18,152,66,236
2111810,3,0,3,34,16,3,53,534,139,726
2111811,0,0,0,0,0,0,0,3,3,6
2111812,0,0,0,7,15,0,22,108,33,163
2111813,0,0,0,65,23,0,88,452,118,658
2111814,0,0,0,21,0,0,21,63,26,110
2111901,3,0,3,26,26,3,55,165,7,227
2111902,4,0,4,21,17,0,38,287,58,383
2111903,5,0,5,29,29,0,58,257,27,342
2111904,6,0,6,18,11,0,29,212,29,270
2111905,0,0,0,19,18,3,40,153,12,205
2111906,7,0,7,20,27,3,50,208,91,349
2111907,3,0,3,26,23,0,49,373,84,506
2111908,60,3,63,26,31,3,60,339,46,445
2111909,0,0,0,32,22,0,54,395,51,500
2111910,0,0,0,19,18,0,37,168,23,228
2111911,0,0,0,18,13,0,31,134,12,177
2111912,3,0,3,36,28,3,67,300,38,405
2111913,0,0,0,0,0,0,0,0,0,0
2111914,6,0,6,20,25,0,45,203,22,270
2111915,4,0,4,15,18,0,33,276,13,322
2112001,0,0,0,3,3,0,6,60,4,70
2112101,0,0,0,0,3,0,3,11,0,14
2112102,3,0,3,48,14,0,62,199,4,265
2112103,0,3,3,66,25,3,94,282,29,405
2112104,0,0,0,50,13,6,69,246,25,340
2112105,5,3,8,49,19,3,71,352,28,451
2112106,0,0,0,0,0,0,0,0,0,0
2112107,3,3,6,79,37,3,119,664,71,854
2112108,4,0,4,62,9,6,77,341,34,452
2112109,0,0,0,69,17,7,93,189,37,319
2112110,3,3,6,48,15,0,63,204,20,287
2112111,0,0,0,0,0,0,0,0,0,0
2112112,0,0,0,42,9,0,51,233,23,307
2112113,4,25,29,34,27,0,61,247,94,402
2112114,3,0,3,40,9,3,52,187,12,251
2112115,0,0,0,136,17,3,156,319,27,502
2112116,0,0,0,63,4,9,76,138,24,238
2112117,6,0,6,137,21,5,163,372,41,576
2112118,3,0,3,81,21,3,105,280,12,397
2112119,3,0,3,136,21,0,157,306,7,470
2112120,0,0,0,75,25,0,100,524,25,649
2112121,0,0,0,22,3,0,25,125,6,156
2112122,0,0,0,63,20,3,86,317,31,434
2112123,3,4,7,72,32,0,104,427,40,571
2112201,6,0,6,18,12,0,30,881,86,997
2112202,0,0,0,8,7,3,18,278,52,348
2112203,0,0,0,30,23,0,53,535,84,672
2112204,0,0,0,16,6,0,22,278,21,321
2112205,0,0,0,0,0,0,0,0,0,0
2112206,0,0,0,20,4,0,24,420,134,578
2112207,6,0,6,39,25,0,64,737,143,944
2112208,0,0,0,22,6,0,28,757,148,933
2112209,3,0,3,18,9,0,27,376,109,512
2112210,0,0,0,21,0,0,21,253,101,375
2112211,0,0,0,18,4,0,22,359,54,435
2112212,0,0,0,34,23,0,57,482,102,641
2112213,0,0,0,37,8,0,45,351,64,460
2112214,0,0,0,17,7,0,24,378,40,442
2112215,0,0,0,38,15,0,53,484,102,639
2112216,0,0,0,20,4,0,24,275,58,357
2112217,3,4,7,18,9,0,27,466,73,566
2112218,0,0,0,6,0,0,6,171,57,234
2112219,3,0,3,57,22,0,79,895,281,1255
2112220,0,3,3,34,18,0,52,638,172,862
2112221,0,0,0,11,15,0,26,236,69,331
2112222,0,0,0,37,18,0,55,332,28,415
2112223,0,0,0,23,0,0,23,187,7,217
2112224,0,0,0,36,13,0,49,246,87,382
2112225,6,0,6,5,15,0,20,139,54,213
2112226,3,0,3,43,15,0,58,813,61,932
2112227,0,0,0,51,29,0,80,1431,181,1692
2112228,0,0,0,13,3,0,16,316,25,357
2112229,0,0,0,30,24,0,54,632,54,740
2112230,0,0,0,13,24,0,37,269,43,349
2112231,8,0,11,20,5,4,29,200,25,254
2112232,4,0,4,10,16,0,26,466,112,604
2112233,3,0,3,23,16,0,39,336,32,407
2112234,0,0,0,15,6,0,21,319,18,358
2112235,3,0,3,20,12,0,32,456,48,536
2112301,0,0,0,64,13,4,81,716,54,851
2112302,0,0,0,13,6,0,19,204,90,313
2112303,0,0,0,32,21,0,53,281,127,461
2112304,0,0,0,29,6,4,39,187,66,292
2112305,3,0,3,28,19,0,47,181,14,242
2112306,9,0,9,23,26,0,49,235,18,302
2112307,4,0,4,27,12,0,39,181,20,240
2112308,3,0,3,45,18,3,66,340,90,496
2112309,0,0,0,24,19,0,43,299,90,432
2112310,4,0,4,16,7,0,23,221,18,262
2112311,11,3,14,52,15,4,71,399,52,522
2112312,0,0,0,52,14,3,69,433,86,588
2112313,0,0,0,0,0,0,0,0,234,234
2112314,0,0,0,17,24,0,41,552,50,643
2112315,0,0,0,0,0,0,0,0,0,0
2112316,5,3,8,31,13,4,48,359,91,498
2112317,0,0,0,0,0,0,0,0,0,0
2112318,6,0,6,54,26,3,83,328,23,434
2112319,0,0,0,39,7,0,46,280,37,363
2112320,0,0,0,12,8,0,20,123,26,169
2112321,0,0,0,67,25,3,95,156,71,322
2112322,8,6,14,50,4,3,57,251,119,427
2112323,3,0,3,10,9,0,19,134,10,163
2112324,0,0,0,25,15,6,46,322,70,438
2112325,3,0,3,70,19,0,89,354,28,471
2112326,3,0,3,29,7,0,36,140,27,203
2112327,0,0,0,24,0,0,24,194,0,218
2112328,4,0,4,22,16,0,38,303,20,361
2112329,0,0,0,36,37,0,73,331,44,448
2112330,0,0,0,36,18,3,57,369,48,474
2112331,6,0,6,30,4,0,34,255,65,354
2112332,0,0,0,49,18,0,67,346,57,470
2112333,0,0,0,0,0,0,0,20,23,43
2112334,0,0,0,26,6,0,32,295,24,351
2112335,4,3,7,78,37,3,118,350,57,525
2112336,0,0,0,19,6,0,25,418,46,489
2112337,6,0,6,61,13,3,77,409,75,561
2112338,3,0,3,38,19,0,57,152,36,245
2112401,7,3,10,0,0,0,0,35,29,64
2112402,0,0,0,28,21,0,49,365,8,422
2112403,0,0,0,0,0,0,0,4,0,4
2112404,0,0,0,24,12,0,36,254,26,316
2112405,9,0,12,36,31,0,67,436,90,593
2112406,4,0,4,18,11,0,29,209,14,252
2112407,0,0,0,15,68,3,86,1378,40,1504
2112408,97,3,100,111,42,0,153,680,49,882
2112409,23,0,23,17,11,0,28,242,30,300
2112410,0,0,0,14,9,0,23,354,18,395
2112411,8,0,8,29,14,3,46,251,53,350
2112412,4,0,4,28,20,0,48,242,32,322
2112413,4,0,4,45,31,9,85,263,40,388
2112501,3,0,3,36,21,0,57,302,42,401
2112502,5,3,8,53,37,0,90,359,49,498
2112503,0,0,0,25,41,0,66,330,22,418
2112504,7,0,7,30,24,0,54,213,36,303
2112505,60,30,90,42,6,0,48,431,116,595
2112506,24,3,27,27,37,4,68,266,34,368
2112507,7,3,10,41,34,3,78,333,63,474
2112508,4,0,4,7,19,0,26,328,32,386
2112509,16,4,20,20,22,0,42,194,33,269
2112510,3,3,6,49,30,0,79,310,51,440
2112511,6,0,6,16,23,0,39,158,16,213
2112512,10,0,10,50,29,0,79,427,74,580
2112513,6,3,9,42,19,0,61,186,41,288
2112514,0,0,0,35,13,0,48,189,38,275
2112601,0,0,0,23,18,0,41,593,13,647
2112602,3,0,3,44,28,0,72,409,25,506
2112603,0,0,0,31,20,0,51,326,34,411
2112604,0,0,0,20,17,0,37,259,42,338
2112605,3,3,6,26,42,0,68,201,24,293
2112606,0,0,0,19,23,0,42,345,35,422
2112607,0,0,0,31,13,0,44,407,121,572
2112608,3,0,3,27,12,0,39,361,146,546
2112609,0,0,0,67,29,0,96,467,173,736
2112610,0,0,0,11,13,0,24,178,53,255
2112611,0,0,0,47,17,0,64,529,40,633
2112612,0,0,0,0,0,0,0,0,0,0
2112613,0,0,0,32,4,3,39,335,53,427
2112614,0,0,0,27,12,0,39,249,47,335
2112615,3,0,3,36,6,3,45,368,39,452
2112616,0,0,0,19,10,0,29,330,32,391
2112617,0,0,0,16,11,0,27,441,24,492
2112618,0,0,0,54,29,0,83,693,74,850
2112619,0,0,0,43,23,0,66,512,47,625
2112620,0,0,0,12,12,0,24,269,9,302
2112621,0,0,0,26,9,0,35,594,104,733
2112622,0,0,0,9,0,0,9,43,12,64
2112623,0,0,0,11,3,0,14,45,21,80
2112624,0,0,0,0,0,0,0,3,3,6
2112625,0,0,0,15,16,0,31,143,18,192
2112626,0,0,0,0,0,0,0,0,0,0
2112627,0,0,0,10,6,0,16,136,5,157
2112628,0,0,0,12,9,3,24,270,24,318
2112701,0,0,0,0,0,0,0,0,0,0
2112702,0,0,0,0,0,0,0,0,0,0
2112801,0,0,0,32,13,0,45,163,14,222
2112802,4,0,4,63,18,3,84,175,21,280
2112803,6,0,6,89,34,6,129,301,19,449
2112804,10,0,10,52,28,0,80,287,21,388
2112805,3,0,3,64,27,0,91,137,17,245
2112806,4,0,4,17,18,0,35,302,34,371
2112807,6,0,9,70,18,6,94,258,21,373
2112808,9,0,9,69,28,4,101,277,57,435
2112809,4,9,13,88,15,0,103,261,38,402
2112810,27,0,27,31,15,0,46,154,13,213
2112811,0,3,3,62,21,0,83,182,29,294
2112812,0,0,0,68,34,0,102,205,18,325
2112813,0,0,0,103,43,6,152,320,19,491
2112814,4,0,4,77,29,0,106,180,24,310
2112815,7,3,10,59,28,0,87,202,13,302
2112816,11,8,19,48,29,3,80,284,41,405
2112817,6,0,6,81,15,0,96,211,42,349
2112818,5,0,5,55,19,3,77,138,0,215
2112819,4,0,4,84,22,6,112,258,13,383
2112820,4,4,8,68,40,0,108,255,25,388
2112821,6,0,6,51,12,0,63,162,29,254
2112822,8,0,8,53,32,0,85,244,25,354
2112823,7,0,7,50,26,0,76,185,39,300
2112824,9,0,9,68,14,3,85,200,28,313
2112825,6,0,6,65,29,3,97,215,19,331
2112826,7,4,11,96,33,4,133,250,20,403
2112827,0,5,5,48,27,0,75,387,44,506
2112828,5,6,11,43,28,0,71,438,91,600
2112829,12,0,12,72,45,3,120,742,58,920
2112830,0,0,0,60,25,0,85,547,42,674
2112831,0,0,0,13,17,0,30,165,27,222
2112832,0,0,0,0,0,0,0,3,0,3
2112833,0,0,0,38,26,0,64,448,68,580
2112901,3,3,6,37,8,0,45,237,33,315
2112902,6,0,6,58,30,3,91,360,26,477
2112903,4,0,7,50,27,3,80,311,31,422
2112904,3,4,7,63,21,4,88,254,41,383
2112905,6,0,6,93,20,5,118,328,64,510
2112906,3,3,6,26,15,0,41,202,21,264
2112907,4,0,4,49,40,9,98,412,21,531
2112908,8,0,8,67,30,8,105,299,28,432
2112909,3,0,3,69,20,3,92,269,33,394
2112910,6,0,6,49,6,0,55,244,35,334
2112911,0,0,0,40,13,0,53,177,19,249
2112912,0,0,0,15,13,3,31,161,15,207
2112913,4,3,7,63,15,0,78,230,83,391
2112914,0,0,0,35,18,3,56,232,42,330
2112915,0,0,0,41,12,6,59,139,11,209
2112916,6,0,6,73,13,0,86,248,57,391
2112917,0,0,0,0,0,0,0,0,0,0
2112918,0,0,0,0,0,0,0,0,0,0
2112919,0,0,0,0,0,0,0,0,0,0
2112920,0,0,0,0,0,0,0,0,0,0
2112921,0,4,4,47,15,3,65,286,41,392
2112922,5,0,5,90,13,3,106,341,28,475
2112923,3,0,3,51,18,6,75,381,44,500
2112924,0,3,3,69,19,6,94,207,53,354
2112925,5,0,5,81,24,3,108,325,41,474
2112926,6,0,6,50,14,0,64,266,42,372
2112927,0,0,0,33,18,0,51,218,23,292
2112928,0,0,0,53,23,6,82,205,26,313
2112929,6,0,6,34,12,0,46,206,24,276
2112930,3,3,6,55,10,3,68,267,31,366
2112931,4,3,10,61,35,0,96,319,53,468
2112932,0,0,0,32,19,0,51,234,60,345
2112933,0,0,0,36,9,3,48,243,44,335
2112934,0,0,0,55,16,0,71,179,20,270
2112935,5,0,5,50,24,0,74,251,32,357
2112936,3,0,3,78,11,6,95,236,25,356
2112937,3,0,3,26,3,4,33,111,28,172
2112938,0,0,0,46,15,9,70,120,9,199
2112939,4,0,4,74,23,7,104,216,15,335
2112940,6,0,6,69,15,6,90,148,13,251
2113001,3,0,3,30,30,0,60,387,45,492
2113002,5,3,8,88,10,6,104,339,27,470
2113003,0,0,0,75,23,3,101,277,24,402
2113004,6,0,6,33,6,7,46,215,30,291
2113005,6,0,6,38,20,3,61,189,22,272
2113006,3,0,3,49,16,10,75,209,28,312
2113007,6,0,6,104,20,6,130,244,13,387
2113008,4,3,7,33,11,3,47,130,23,200
2113009,7,0,7,42,15,0,57,193,28,278
2113010,0,0,0,42,27,0,69,397,46,512
2113011,3,4,7,56,17,3,76,266,44,386
2113012,3,0,3,39,16,0,55,172,27,254
2113013,6,3,9,49,30,0,79,189,50,318
2113014,5,3,8,33,11,0,44,166,28,238
2113015,4,0,4,37,10,6,53,159,35,247
2113016,4,0,4,38,30,0,68,300,67,435
2113017,0,0,0,65,42,0,107,306,69,482
2113018,3,3,6,125,62,0,187,1031,85,1303
2113019,0,0,0,59,22,3,84,176,21,281
2113020,7,0,7,91,32,6,129,334,42,505
2113021,3,0,3,29,7,4,40,176,13,229
2113022,0,3,3,49,24,0,73,424,53,550
2113023,11,0,11,57,7,0,64,186,8,258
2113024,12,0,12,85,31,0,116,277,24,417
2113025,0,4,4,52,41,0,93,253,39,385
2113026,0,0,0,44,39,3,86,311,43,440
2113027,8,3,11,45,21,0,66,240,41,347
2113028,0,0,0,51,26,3,80,191,36,307
2113029,0,0,0,83,15,3,101,240,24,365
2113030,6,0,6,29,44,0,73,224,16,313
2113031,3,0,3,135,54,0,189,368,39,596
2113032,4,0,4,45,15,0,60,132,15,207
2113033,0,0,0,22,13,3,38,175,20,233
2113101,0,0,0,0,0,0,0,0,0,0
2113102,0,0,0,0,0,0,0,9,0,9
2113201,4,0,4,45,24,0,69,188,26,283
2113202,4,7,11,27,16,0,43,169,47,259
2113203,28,0,28,30,13,0,43,393,83,519
2113204,0,0,0,38,8,0,46,192,50,288
2113205,6,0,6,44,17,0,61,241,45,347
2113206,3,0,3,54,9,6,69,190,15,274
2113207,4,0,4,55,23,0,78,183,17,278
2113208,3,0,3,71,26,0,97,251,21,369
2113209,0,0,0,71,23,0,94,254,13,361
2113210,4,0,4,52,17,0,69,228,57,354
2113211,0,0,0,34,15,0,49,118,47,214
2113212,6,0,6,63,24,3,90,183,28,301
2113213,37,0,37,81,30,0,111,322,33,466
2113214,19,0,19,55,18,3,76,261,28,365
2113215,3,0,3,60,39,0,99,317,31,447
2113216,0,0,0,53,21,0,74,465,33,572
2113217,3,0,3,40,40,0,80,368,34,482
2113218,0,0,0,36,11,0,47,232,26,305
2113219,0,0,0,27,9,3,39,324,35,398
2113220,0,0,0,16,7,3,26,254,22,302
2113221,0,0,0,21,3,0,24,188,25,237
2113222,0,0,0,19,0,0,19,142,0,161
2113223,0,0,0,37,10,0,47,281,27,355
2113224,6,0,6,53,18,3,74,177,21,272
2113225,5,0,5,10,12,0,22,172,63,257
2113226,0,0,0,37,21,7,65,153,15,233
2113301,3,0,3,9,15,0,24,219,33,276
2113302,3,0,3,18,7,0,25,176,20,221
2113303,0,0,0,10,13,3,26,215,20,261
2113304,0,0,0,27,10,3,40,226,21,287
2113305,7,0,7,38,13,3,54,294,34,382
2113306,0,0,0,0,0,0,0,0,0,0
2113307,0,0,0,62,17,0,79,362,23,464
2113308,6,3,9,39,30,0,69,478,62,609
2113309,0,0,0,0,0,0,0,0,0,0
2113310,0,0,0,27,20,0,47,114,6,167
2113311,0,0,3,28,24,0,52,229,13,294
2113312,0,0,0,34,5,3,42,253,73,368
2113313,3,0,3,35,13,0,48,273,53,374
2113314,4,0,4,30,14,0,44,362,106,512
2113315,0,0,0,39,21,0,60,277,32,369
2113316,7,3,10,36,20,0,56,305,57,418
2113317,0,3,3,20,13,6,39,397,51,487
2113318,0,0,0,27,18,0,45,365,39,449
2113319,0,0,0,0,0,0,0,0,0,0
2113320,0,0,0,39,15,0,54,198,23,275
2113321,3,0,3,46,9,6,61,153,23,237
2113322,5,0,5,48,13,0,61,351,55,467
2113323,6,0,6,72,21,0,93,338,43,474
2113324,3,3,6,48,16,3,67,180,35,282
2113325,0,0,0,0,0,0,0,0,0,0
2113326,0,0,0,20,7,0,27,415,16,458
2113327,0,0,0,30,18,3,51,331,44,426
2113328,3,3,6,34,7,3,44,273,28,345
2113329,4,0,4,35,9,6,50,317,46,413
2113330,3,0,3,26,7,6,39,255,86,380
2113331,3,0,3,43,24,3,70,356,85,511
2113332,0,0,0,97,32,0,129,405,77,611
2113333,0,3,3,67,27,3,97,256,66,419
2113334,0,0,0,55,21,0,76,591,37,704
2113335,3,0,3,36,18,3,57,254,47,358
2113336,6,0,6,34,18,0,52,304,39,395
2113337,4,0,4,40,28,0,68,505,53,626
2113338,19,0,19,22,15,3,40,236,31,307
2113339,4,3,7,28,33,6,67,382,28,477
2113340,0,0,0,25,9,0,34,291,19,344
2113341,0,74,74,13,3,0,16,166,173,355
2113342,6,92,98,12,0,0,12,178,216,406
2113343,3,0,3,31,22,0,53,351,48,452
2113344,3,0,3,34,32,3,69,331,44,444
2113345,3,0,3,11,8,0,19,203,68,290
2113346,11,0,11,28,8,0,36,335,36,407
2113347,4,0,4,29,9,0,38,191,13,242
2113348,0,0,0,18,18,0,36,361,99,496
2113349,4,0,4,45,25,0,70,348,48,466
2113350,0,6,6,35,19,0,54,318,37,409
2113351,10,3,13,37,25,0,62,326,113,501
2113352,4,0,4,27,24,0,51,453,66,570
2113353,0,0,0,36,15,3,54,344,21,419
2113354,0,0,0,32,15,0,47,299,38,384
2113355,3,0,3,40,12,3,55,328,65,448
2113356,3,0,3,14,10,3,27,195,24,246
2113401,5,0,5,34,18,0,52,263,27,342
2113402,0,0,0,29,16,3,48,238,11,297
2113403,5,0,5,26,17,0,43,263,22,328
2113404,0,0,0,27,12,0,39,118,31,188
2113405,0,0,0,66,15,3,84,285,61,430
2113406,3,0,3,42,17,0,59,364,39,462
2113407,3,0,3,39,22,0,61,313,28,402
2113408,3,0,3,39,7,0,46,230,34,310
2113409,0,0,0,6,15,0,21,217,19,257
2113410,0,0,0,27,0,0,27,172,19,218
2113411,0,0,0,36,21,0,57,230,43,330
2113412,3,0,3,62,38,3,103,371,44,518
2113413,11,0,11,66,28,4,98,381,14,493
2113414,3,0,3,70,18,0,88,197,25,310
2113415,0,0,0,55,23,0,78,272,31,381
2113416,3,3,6,64,16,7,87,289,37,413
2113417,0,0,0,35,10,0,45,311,21,377
2113418,3,3,6,24,12,0,36,224,37,297
2113419,3,3,6,69,22,3,94,264,32,390
2113420,0,3,3,35,16,0,51,388,34,473
2113421,3,3,6,42,29,6,77,204,21,302
2113422,17,5,22,30,16,9,55,360,38,453
2113423,3,0,3,32,15,0,47,282,21,350
2113424,3,0,3,42,9,4,55,164,7,226
2113425,0,3,3,51,28,0,79,299,15,393
2113426,0,0,0,43,10,3,56,217,8,281
2113427,0,0,0,47,16,0,63,336,28,427
2113428,4,0,4,59,13,0,72,305,26,403
2113429,0,0,0,47,9,6,62,211,33,306
2113430,5,3,8,58,12,0,70,236,39,345
2113431,0,3,3,16,9,0,25,205,11,241
2113432,4,0,4,108,24,3,135,325,27,487
2113433,4,0,4,67,8,0,75,205,24,304
2113434,0,3,3,42,21,0,63,337,19,419
2113435,13,0,13,76,16,6,98,234,7,339
2113436,0,3,3,30,15,0,45,125,12,182
2113437,3,0,3,66,18,3,87,268,40,395
2113438,5,0,5,50,19,0,69,389,30,488
2113439,6,3,9,40,15,0,55,245,27,327
2113501,29,3,32,82,18,3,103,337,25,465
2113502,4,3,7,62,9,4,75,224,33,332
2113503,27,4,31,80,67,3,150,378,44,572
2113504,8,0,8,76,34,0,110,259,12,381
2113505,0,0,0,54,33,6,93,163,22,278
2113506,0,0,0,66,13,6,85,334,26,445
2113507,16,3,19,91,35,3,129,391,56,576
2113508,3,0,3,62,19,3,84,189,23,296
2113509,3,0,3,44,40,4,88,234,41,363
2113510,3,0,3,71,0,3,74,251,24,349
2113511,9,0,9,69,12,3,84,199,26,309
2113512,7,3,10,51,31,4,86,221,36,343
2113513,8,3,11,78,24,0,102,281,39,422
2113514,7,0,7,25,16,0,41,255,33,329
2113515,13,0,13,20,11,3,34,328,42,404
2113516,14,0,14,58,24,0,82,384,51,517
2113517,17,0,17,75,35,0,110,389,49,548
2113518,3,0,3,15,3,0,18,171,36,225
2113519,3,0,3,52,16,6,74,316,34,424
2113601,3,0,3,28,13,0,41,517,53,611
2113602,0,0,0,23,9,3,35,404,73,512
2113603,6,0,6,33,18,3,54,275,32,361
2113604,0,0,0,30,13,3,46,227,32,305
2113605,0,0,0,56,29,0,85,318,44,447
2113606,15,12,27,30,4,0,34,271,149,454
2113607,0,0,0,65,17,8,90,337,22,449
2113608,0,0,0,41,37,6,84,364,44,492
2113609,6,0,6,29,25,0,54,195,26,275
2113610,0,0,0,48,15,4,67,332,42,441
2113611,0,0,0,45,20,0,65,282,34,381
2113612,25,0,25,42,12,0,54,209,24,287
2113613,3,0,3,48,16,0,64,268,45,377
2113614,4,3,7,22,12,0,34,257,47,338
2113615,0,0,0,8,7,0,15,156,9,180
2113616,18,12,30,21,10,0,31,257,82,370
2113617,3,3,6,58,18,3,79,302,71,452
2113618,39,0,39,56,19,0,75,322,37,434
2113619,6,0,6,46,27,6,79,317,28,424
2113620,0,0,0,16,13,3,32,287,36,355
2113621,4,0,4,42,9,0,51,236,18,305
2113622,3,0,3,24,12,0,36,245,13,294
2113623,32,3,35,23,22,3,48,424,15,487
2113624,6,0,6,61,24,0,85,408,37,530
2113625,3,0,3,44,27,3,74,323,24,421
2113626,9,3,12,60,13,0,73,350,48,471
2113627,3,0,3,35,23,0,58,330,46,434
2113628,10,0,10,64,25,6,95,439,32,566
2113629,10,18,28,34,18,0,52,272,59,383
2113630,0,0,0,38,6,0,44,329,20,393
2113631,21,3,24,39,21,0,60,247,19,326
2113632,6,0,6,47,17,0,64,249,46,359
2113633,9,4,13,63,28,0,91,325,92,508
2113634,6,0,6,75,18,3,96,244,27,367
2113635,6,0,6,65,31,6,102,297,27,426
2113636,0,4,4,29,11,0,40,163,25,228
2113637,0,0,0,21,18,6,45,243,38,326
2113638,4,0,4,38,8,0,46,200,0,246
2113639,0,0,0,62,23,3,88,304,41,433
2113640,0,0,0,24,9,0,33,157,15,205
2113641,5,0,5,19,15,0,34,219,23,276
2113701,0,0,0,0,0,0,0,0,0,0
2113702,3,0,3,32,12,0,44,524,102,670
2113703,0,0,0,9,9,0,18,224,15,257
2113704,0,4,4,60,28,0,88,435,58,581
2113705,5,0,5,31,25,0,56,249,26,331
2113706,0,0,0,48,25,9,82,316,20,418
2113707,0,0,0,29,24,0,53,360,55,468
2113708,3,0,3,47,17,4,68,237,31,336
2113709,16,0,16,50,19,0,69,399,16,484
2113710,7,6,13,71,31,0,102,441,62,605
2113711,7,0,7,38,17,0,55,292,58,405
2113712,3,0,3,22,12,0,34,231,20,285
2113713,3,0,3,36,19,0,55,239,58,352
2113714,0,0,0,44,19,0,63,287,48,398
2113715,0,4,4,52,23,0,75,356,19,450
2113716,0,0,0,42,9,0,51,238,22,311
2113717,5,0,5,26,17,0,43,472,89,604
2113718,3,3,6,32,15,0,47,233,38,318
2113719,0,3,3,17,21,0,38,391,67,496
2113720,5,0,5,46,26,0,72,462,62,596
2113721,6,3,9,20,12,0,32,227,30,289
2113722,0,0,0,23,14,0,37,388,25,450
2113723,0,0,0,43,27,3,73,413,39,525
2113724,6,0,6,54,19,5,78,348,43,469
2113725,0,3,3,53,24,3,80,381,26,487
2113726,0,0,0,33,21,0,54,264,31,349
2113727,11,7,18,36,15,0,51,326,121,498
2113728,26,0,26,43,32,3,78,364,72,514
2113729,6,0,6,34,44,0,78,545,62,685
2113730,6,5,11,31,37,3,71,481,54,606
2113731,6,0,6,26,13,0,39,237,30,306
2113801,4,0,4,36,17,0,53,237,17,307
2113802,9,0,9,45,17,0,62,289,38,389
2113803,6,3,9,45,21,0,66,155,21,242
2113804,6,0,6,47,34,0,81,240,22,343
2113805,11,0,11,52,19,3,74,264,27,365
2113806,4,0,4,44,17,3,64,151,18,233
2113807,18,3,21,21,10,0,31,190,35,256
2113808,18,0,21,49,30,0,79,233,39,351
2113809,9,0,9,31,33,3,67,186,20,273
2113810,3,0,3,52,26,0,78,215,35,328
2113811,3,0,3,58,28,0,86,215,22,323
2113812,25,10,35,51,50,0,101,418,69,588
2113813,3,3,12,49,37,0,86,264,42,392
2113814,20,7,27,30,42,0,72,394,57,523
2113815,26,10,36,29,24,3,56,261,56,373
2113816,36,9,45,30,36,0,66,245,44,355
2113817,6,0,6,35,31,0,66,264,19,349
2113818,9,0,9,63,40,0,103,260,24,387
2113819,14,0,14,36,40,3,79,247,50,376
2113820,13,0,17,58,46,0,104,357,40,501
2113821,4,0,7,68,25,0,93,173,10,276
2113822,29,6,35,34,27,0,61,277,35,373
2113823,18,4,25,49,32,0,81,367,48,496
2113824,12,6,18,43,28,0,71,296,23,390
2113825,6,0,6,60,33,0,93,266,32,391
2113826,10,0,10,37,29,0,66,233,16,315
2113827,6,3,9,18,31,0,49,307,66,422
2113828,5,0,5,35,32,3,70,153,21,244
2113829,18,5,26,39,30,3,72,232,41,345
2113830,12,3,15,57,38,0,95,270,37,402
2113831,19,3,22,25,25,3,53,243,29,325
2113832,9,0,9,39,20,3,62,139,18,219
2113901,0,0,0,49,16,0,65,178,39,282
2113902,47,3,50,27,9,6,42,297,70,409
2113903,3,0,3,58,30,3,91,289,27,407
2113904,4,0,4,16,16,0,32,192,38,262
2113905,10,0,10,41,28,5,74,404,77,555
2113906,0,0,0,45,18,3,66,270,14,350
2113907,6,0,6,67,29,3,99,431,86,616
2113908,0,0,0,16,18,0,34,187,18,239
2113909,6,0,6,60,35,6,101,245,70,416
2113910,6,0,6,37,15,0,52,299,67,418
2113911,5,0,5,79,12,4,95,326,19,440
2114001,3,0,3,29,11,6,46,197,9,252
2114002,6,0,6,38,19,0,57,244,18,319
2114003,0,0,0,23,20,0,43,185,9,237
2114004,3,0,3,52,25,3,80,177,9,266
2114005,6,0,6,36,23,3,62,228,7,297
2114006,3,0,3,47,20,0,67,246,12,325
2114007,10,4,14,36,15,7,58,217,29,304
2114008,22,8,30,66,33,0,99,285,63,447
2114009,10,0,10,55,28,0,83,284,21,388
2114010,3,0,3,61,27,6,94,278,20,392
2114011,7,0,7,45,24,6,75,214,12,301
2114012,7,0,7,42,18,6,66,206,19,291
2114013,0,0,0,0,0,0,0,0,0,0
2114014,3,3,6,60,18,0,78,329,43,450
2114015,0,0,0,42,19,3,64,287,33,384
2114016,6,0,6,65,36,6,107,349,21,477
2114017,4,0,4,35,25,0,60,240,6,306
2114018,6,0,6,53,15,3,71,214,15,300
2114019,0,0,0,34,17,3,54,239,15,308
2114020,0,3,3,31,18,3,52,178,18,248
2114021,4,0,4,21,13,0,34,329,37,400
2114022,0,0,0,31,22,0,53,273,21,347
2114023,3,0,3,32,19,3,54,280,18,352
2114101,6,0,6,66,27,3,96,473,41,610
2114102,3,0,3,46,18,5,69,303,30,402
2114103,0,0,0,23,3,0,26,212,25,263
2114104,15,0,15,40,12,0,52,397,151,600
2114105,0,0,0,38,16,3,57,439,126,622
2114106,0,0,0,107,16,6,129,298,134,561
2114107,4,0,4,40,6,0,46,124,66,236
2114108,5,3,8,21,13,0,34,162,42,238
2114109,0,0,0,32,20,6,58,329,40,427
2114110,0,0,0,14,15,0,29,205,25,259
2114111,3,0,3,43,24,0,67,250,15,332
2114112,0,3,3,60,34,0,94,419,47,560
2114113,0,0,0,26,15,0,41,166,12,219
2114114,0,0,0,55,11,0,66,181,50,297
2114201,6,0,6,64,12,0,76,199,41,316
2114202,0,0,0,31,9,3,43,257,41,341
2114203,3,0,3,45,7,0,52,186,43,281
2114204,6,0,6,71,13,0,84,224,53,361
2114205,4,0,4,69,15,0,84,238,45,367
2114206,0,0,0,26,20,0,46,347,83,476
2114207,0,0,0,18,18,0,36,144,29,209
2114208,4,0,4,65,21,0,86,297,40,423
2114209,0,0,0,36,15,8,59,294,33,386
2114210,0,0,0,37,23,0,60,350,22,432
2114211,3,0,3,42,25,3,70,242,14,326
2114212,0,6,6,35,23,3,61,337,46,444
2114213,8,16,24,21,25,0,46,229,80,355
2114214,0,0,0,3,7,0,10,145,72,227
2114215,6,9,15,12,0,0,12,136,141,289
2114216,0,0,0,36,5,0,41,229,3,273
2114217,0,0,0,53,43,0,96,412,47,555
2114218,0,0,0,15,3,0,18,167,42,227
2114219,0,0,0,32,18,0,50,249,32,331
2114220,7,0,7,35,25,0,60,335,38,433
2114221,6,3,9,42,25,0,67,314,69,450
2114222,0,0,0,25,15,0,40,190,13,243
2114223,0,0,0,39,26,0,65,434,66,565
2114301,9,0,9,57,25,0,82,269,17,368
2114302,4,0,4,50,17,7,74,153,12,239
2114303,4,0,4,72,33,3,108,258,3,369
2114304,0,0,0,37,5,0,42,184,6,232
2114305,23,6,29,69,24,3,96,377,28,501
2114306,3,0,3,57,31,6,94,357,37,488
2114307,9,0,9,83,35,9,127,315,19,461
2114308,6,0,6,60,27,0,87,334,68,489
2114309,0,0,0,95,16,9,120,282,32,434
2114310,3,3,6,61,14,0,75,212,15,302
2114311,3,0,3,64,11,4,79,277,36,392
2114312,0,4,4,48,18,6,72,325,24,421
2114313,0,0,0,21,12,6,39,159,13,211
2114314,6,3,9,70,27,6,103,274,43,420
2114315,7,3,10,58,22,9,89,288,25,402
2114316,0,0,0,51,29,3,83,354,41,478
2114317,4,0,4,73,27,3,103,320,32,455
2114318,4,0,4,53,14,0,67,224,34,325
2114319,33,5,38,22,18,3,43,178,23,244
2114320,0,0,0,37,16,6,59,215,12,286
2114321,6,0,6,51,18,0,69,212,12,293
2114322,0,0,0,60,23,3,86,253,16,355
2114323,3,0,3,55,23,0,78,229,21,328
2114324,0,0,0,43,26,6,75,369,34,478
2114325,6,0,6,39,21,0,60,260,32,352
2114326,9,0,9,39,13,6,58,176,19,253
2114327,5,0,5,55,23,6,84,288,16,388
2114401,12,3,15,29,25,7,61,286,47,394
2114402,11,3,14,65,15,0,80,240,29,349
2114403,3,0,3,20,21,0,41,383,58,482
2114404,3,3,6,24,24,3,51,251,30,332
2114405,6,0,6,50,9,4,63,261,63,387
2114406,11,0,11,71,15,3,89,270,22,381
2114407,6,0,6,58,12,3,73,272,25,370
2114408,0,3,3,17,21,0,38,279,54,371
2114409,0,4,4,50,20,0,70,334,23,427
2114410,4,0,4,50,24,3,77,294,37,408
2114411,0,0,0,32,8,3,43,144,34,221
2114412,9,0,9,63,19,0,82,351,21,454
2114413,4,0,4,40,24,0,64,312,25,401
2114414,0,0,0,64,20,4,88,244,22,354
2114415,0,0,0,32,15,0,47,261,16,324
2114416,0,0,0,45,19,10,74,249,13,336
2114417,3,3,6,45,24,6,75,298,24,397
2114418,4,0,4,62,40,3,105,314,30,449
2114419,0,0,0,34,13,0,47,281,19,347
2114420,10,0,10,57,12,0,69,266,13,348
2114421,0,0,0,26,0,0,26,196,38,260
2114422,3,0,3,40,6,0,46,210,17,273
2114423,0,3,3,70,25,4,99,285,30,414
2114424,4,0,4,44,24,3,71,341,15,427
2114425,0,0,0,36,31,0,67,353,17,437
2114426,6,0,6,33,26,3,62,306,50,418
2114427,0,0,0,49,18,6,73,340,31,444
2114428,0,0,0,66,37,0,103,277,29,409
2114429,0,0,0,30,18,3,51,168,16,235
2114430,3,0,3,33,22,3,58,320,18,396
2114431,0,0,0,27,15,3,45,205,11,261
2114432,3,0,3,57,27,0,84,333,21,438
2114433,22,0,22,36,25,0,61,322,35,418
2114434,0,0,0,20,16,0,36,208,32,276
2114435,3,0,3,56,12,5,73,352,32,457
2114436,3,0,3,43,26,3,72,277,30,379
2114437,0,0,0,20,12,0,32,187,21,240
2114438,6,0,6,23,18,0,41,198,21,260
2114439,4,0,4,21,21,0,42,213,24,279
2114440,3,0,3,45,12,0,57,327,43,427
2114441,10,0,10,37,0,0,37,208,29,274
2114442,3,0,3,61,24,0,85,283,24,392
2114443,10,6,16,41,21,0,62,416,50,528
2114444,0,3,3,68,29,3,100,546,74,720
2114445,4,0,4,57,41,3,101,492,35,628
2114446,0,0,0,49,16,3,68,305,57,430
2114447,0,0,0,51,26,0,77,250,16,343
2114448,0,0,0,75,21,6,102,319,10,431
2114449,6,0,6,57,21,3,81,301,17,399
2114450,6,0,6,60,24,9,93,381,39,513
2114451,4,0,4,30,32,0,62,306,19,387
2114452,8,0,8,54,22,0,76,311,68,455
2114453,8,0,8,26,13,0,39,317,46,402
2114454,13,0,13,72,28,0,100,335,57,492
2114455,7,0,7,67,24,0,91,382,13,486
2114456,0,0,0,8,9,0,17,220,26,263
2114457,8,0,8,59,31,0,90,383,45,518
2114458,4,0,4,25,18,0,43,254,34,331
2114459,7,3,10,26,11,3,40,193,38,271
2114460,8,0,8,45,18,0,63,273,39,375
2114461,0,0,0,3,0,0,3,0,0,3
2114501,3,0,3,38,18,4,60,305,35,400
2114502,0,0,0,91,16,0,107,280,27,414
2114503,0,0,0,56,21,9,86,304,19,409
2114504,3,0,3,60,32,0,92,212,4,308
2114505,0,4,4,70,24,9,103,284,16,403
2114506,4,0,4,87,30,3,120,348,16,484
2114507,3,0,3,49,9,3,61,159,18,238
2114508,3,3,6,52,5,0,57,206,21,284
2114509,0,0,0,0,0,0,0,0,0,0
2114510,7,0,7,110,29,4,143,292,21,456
2114511,0,0,0,64,7,10,81,221,7,309
2114512,8,0,8,63,17,10,90,211,18,319
2114513,26,6,32,53,11,0,64,220,21,305
2114514,3,0,3,72,27,3,102,280,19,401
2114515,0,6,6,57,39,3,99,227,33,359
2114516,0,0,0,32,5,0,37,216,12,265
2114517,0,0,0,75,39,3,117,302,26,445
2114518,0,0,0,54,11,3,68,177,19,264
2114519,0,0,0,48,23,6,77,188,18,283
2114520,0,3,3,25,18,3,46,231,42,319
2114521,8,0,8,51,6,0,57,200,23,280
2114601,6,0,6,69,28,6,103,193,0,296
2114602,3,0,3,53,23,4,80,107,3,190
2114603,7,3,10,96,12,9,117,190,9,316
2114604,12,6,18,63,15,12,90,154,15,259
2114605,10,0,10,82,26,6,114,133,0,247
2114606,15,6,21,135,14,14,163,258,31,452
2114607,8,0,8,85,7,3,95,189,11,295
2114608,10,0,10,45,7,3,55,134,9,198
2114609,10,4,14,126,24,9,159,222,20,401
2114610,35,3,38,67,18,9,94,237,25,356
2114611,7,5,12,81,23,0,104,279,25,408
2114612,4,0,4,71,9,6,86,172,10,268
2114613,7,0,7,58,13,7,78,140,9,227
2114614,13,0,13,133,29,12,174,249,6,429
2114615,39,0,39,53,23,0,76,254,13,343
2114616,39,0,39,59,10,3,72,175,15,262
2114617,5,0,5,46,21,0,67,111,13,191
2114618,6,3,9,63,6,0,69,199,21,289
2114619,9,3,12,115,27,4,146,341,39,526
2114701,15,6,21,50,23,0,73,323,33,429
2114702,4,0,4,67,17,0,84,192,6,282
2114703,4,0,4,55,21,0,76,116,0,192
2114704,11,0,11,62,37,4,103,194,15,312
2114705,10,0,10,80,15,0,95,265,32,392
2114706,72,7,79,102,39,0,141,333,24,498
2114707,8,0,8,41,20,9,70,129,9,208
2114708,3,0,3,41,19,3,63,138,7,208
2114709,7,3,13,57,31,6,94,344,33,471
2114710,11,0,11,89,33,6,128,330,33,491
2114711,12,0,12,80,21,3,104,287,9,400
2114712,9,0,9,70,16,0,86,241,6,333
2114713,12,0,12,104,20,9,133,329,33,495
2114714,11,0,11,124,37,4,165,329,37,531
2114715,11,0,11,64,18,0,82,248,4,334
2114716,31,12,43,58,30,0,88,322,36,446
2114717,10,0,10,89,13,0,102,246,18,366
2114718,11,0,11,74,15,0,89,183,13,285
2114719,4,0,4,105,31,0,136,297,18,451
2114720,11,6,17,80,21,9,110,306,12,428
2114721,4,3,7,65,23,7,95,210,17,322
2114722,8,0,8,82,14,0,96,253,13,362
2114723,39,8,47,75,32,6,113,296,39,448
2114724,11,5,16,84,34,9,127,276,21,424
2114725,16,0,16,79,47,0,126,335,26,487
2114726,36,6,42,68,29,6,103,280,16,399
2114727,7,3,10,77,33,0,110,279,10,399
2114728,18,6,24,62,37,4,103,307,27,437
2114729,22,3,25,76,33,0,109,245,18,372
2114730,56,7,63,61,18,3,82,290,36,408
2114731,9,6,15,42,23,0,65,175,33,273
2114732,12,7,19,70,16,0,86,209,27,322
2114733,9,0,9,89,20,0,109,241,21,371
2114734,6,0,6,29,19,0,48,159,9,216
2114735,8,0,8,47,9,3,59,165,9,233
2114801,7,3,10,54,25,3,82,199,12,293
2114802,6,0,6,84,28,3,115,256,22,393
2114803,8,3,11,77,17,3,97,173,14,284
2114804,6,0,6,89,25,3,117,241,10,368
2114805,5,3,8,50,16,0,66,149,15,230
2114806,9,0,9,89,18,4,111,259,18,388
2114807,18,0,18,118,28,7,153,300,9,462
2114808,10,4,14,73,35,0,108,265,23,396
2114809,7,0,7,71,32,0,103,209,13,325
2114810,10,0,10,46,28,0,74,157,8,239
2114811,12,3,15,102,46,9,157,217,15,389
2114812,14,0,14,93,38,0,131,293,9,433
2114813,5,0,5,62,11,0,73,212,15,300
2114814,8,0,8,52,22,0,74,207,13,294
2114815,3,0,3,54,25,0,79,230,15,324
2114816,12,3,15,74,28,0,102,274,23,399
2114817,20,0,20,77,33,10,120,354,16,490
2114818,9,3,12,42,23,3,68,145,6,219
2114819,7,5,12,70,28,3,101,208,15,324
2114820,15,0,15,48,25,0,73,174,18,265
2114821,6,0,6,43,17,0,60,145,7,212
2114822,6,3,9,83,30,5,118,263,15,396
2114823,7,3,10,78,19,0,97,263,17,377
2114824,12,4,16,68,17,5,90,226,7,323
2114825,9,6,15,82,21,0,103,166,15,284
2114826,7,3,10,58,18,0,76,151,15,242
2114827,10,3,13,104,32,9,145,313,27,485
2114828,24,0,24,85,39,3,127,328,21,476
2114829,6,0,6,74,24,3,101,198,15,314
2114830,10,3,13,75,22,0,97,227,16,340
2114831,11,4,15,80,20,3,103,270,17,390
2114832,14,0,14,87,31,0,118,349,15,482
2114833,6,0,6,99,30,3,132,173,16,321
2114834,17,0,17,63,24,3,90,194,13,297
2114835,4,0,4,59,15,0,74,124,6,204
2114836,11,0,11,46,11,6,63,130,12,205
2114837,9,0,9,34,21,0,55,132,7,194
2114838,11,10,21,74,26,0,100,221,20,341
2114839,14,3,17,84,27,0,111,245,38,394
2114840,10,3,13,73,16,0,89,199,15,303
2114841,6,0,6,81,33,0,114,247,25,386
2114842,13,3,19,33,17,3,53,149,23,225
2114843,14,0,14,54,20,0,74,153,24,251
2114844,7,0,7,51,22,9,82,146,13,241
2114845,6,6,12,90,16,0,106,216,19,341
2114846,0,0,0,0,0,0,0,0,0,0
2114847,0,0,0,0,0,0,0,0,0,0
2114848,9,0,9,52,12,0,64,183,6,253
2114849,12,0,12,34,14,0,48,187,13,248
2114850,70,6,76,52,31,6,89,315,16,420
2114851,4,0,4,58,0,5,63,141,15,219
2114852,4,0,4,65,9,3,77,171,7,255
2114901,38,0,38,80,15,0,95,260,14,369
2114902,0,0,0,79,25,3,107,189,27,323
2114903,3,0,3,49,29,0,78,151,15,244
2114904,27,3,30,47,26,3,76,280,36,392
2114905,13,6,19,77,27,3,107,202,27,336
2114906,25,47,72,86,42,3,131,247,79,457
2114907,0,5,5,61,22,4,87,247,22,356
2114908,8,4,12,73,26,4,103,294,15,412
2114909,7,3,13,71,37,7,115,295,31,441
2114910,4,0,4,57,14,3,74,211,12,297
2114911,3,0,3,47,21,5,73,158,6,237
2114912,19,0,19,45,14,3,62,183,3,248
2114913,31,0,31,52,18,0,70,207,15,292
2114914,9,0,9,79,13,0,92,204,12,308
2114915,7,0,7,42,19,3,64,131,18,213
2114916,6,0,6,126,18,3,147,197,18,362
2114917,6,4,10,70,29,0,99,175,8,282
2114918,9,0,9,73,29,0,102,315,14,431
2114919,0,0,3,78,31,3,112,271,10,393
2114920,6,3,9,70,15,0,85,221,21,327
2114921,0,0,0,53,14,3,70,118,7,195
2114922,16,0,16,29,19,0,48,167,12,227
2114923,4,3,7,29,21,0,50,110,9,169
2114924,0,0,0,74,25,0,99,228,11,338
2114925,8,3,11,49,32,3,84,139,15,238
2114926,45,0,45,56,13,0,69,220,9,298
2114927,44,11,55,48,17,0,65,222,11,298
2114928,10,0,10,82,37,0,119,314,19,452
2114929,9,0,9,66,38,10,114,222,15,351
2114930,5,0,5,100,23,0,123,262,31,416
2114931,9,0,9,74,17,3,94,241,36,371
2114932,7,0,7,78,53,9,140,260,16,416
2114933,4,0,4,38,10,0,48,74,12,134
2114934,7,0,7,60,25,5,90,342,11,443
2114935,52,7,62,122,38,3,163,387,27,577
2114936,5,0,5,102,25,7,134,174,3,311
2114937,3,0,3,37,15,3,55,185,3,243
2114938,81,29,110,16,3,0,19,194,50,263
2114939,44,8,52,81,33,0,114,311,23,448
2114940,5,0,5,86,31,6,123,238,10,371
2114941,6,3,9,93,40,6,139,303,12,454
2114942,3,0,3,57,19,0,76,179,16,271
2114943,8,3,11,83,24,3,110,215,11,336
2114944,6,0,6,100,31,15,146,272,18,436
2114945,9,0,9,59,19,4,82,120,9,211
2114946,14,0,14,103,39,9,151,316,15,482
2114947,4,0,4,61,19,0,80,237,17,334
2114948,0,0,0,53,18,0,71,152,18,241
2114949,13,0,16,74,32,6,112,198,12,322
2115001,4,0,4,79,6,0,85,141,10,236
2115002,6,3,9,83,21,8,112,287,10,409
2115003,6,0,6,119,14,4,137,187,9,333
2115004,8,0,8,55,18,0,73,216,14,303
2115005,6,0,6,97,22,3,122,192,13,327
2115006,4,0,7,99,37,5,141,229,0,370
2115007,3,0,3,55,13,3,71,90,9,170
2115008,3,0,3,46,7,0,53,110,12,175
2115009,0,0,0,83,11,0,94,187,4,285
2115010,15,3,18,85,33,3,121,242,27,390
2115011,0,0,0,90,9,3,102,149,15,266
2115012,4,0,4,75,18,6,99,197,4,300
2115013,6,0,6,110,30,5,145,311,20,476
2115014,4,0,4,56,12,5,73,183,10,266
2115015,13,3,16,107,33,0,140,306,43,489
2115016,0,0,0,70,22,7,99,202,18,319
2115017,6,0,6,50,25,3,78,174,9,261
2115018,6,0,6,87,21,6,114,245,23,382
2115019,12,0,12,92,17,3,112,217,5,334
2115020,8,0,8,85,38,6,129,246,22,397
2115021,12,0,12,109,36,6,151,310,18,479
2115022,11,4,15,103,30,4,137,239,12,388
2115023,11,3,14,85,37,0,122,182,23,327
2115024,11,3,14,77,12,9,98,200,24,322
2115025,9,0,9,71,26,0,97,163,4,264
2115026,21,0,21,133,30,6,169,276,12,457
2115027,8,0,11,159,61,4,224,613,82,919
2115028,3,0,3,42,12,3,57,68,10,135
2115029,5,0,5,103,15,10,128,229,15,372
2115030,13,0,13,68,24,0,92,171,12,275
2115031,10,0,10,79,24,6,109,220,28,357
2115032,8,0,8,76,34,6,116,249,15,380
2115033,6,0,6,67,23,6,96,154,8,258
2115034,3,0,3,82,13,0,95,150,12,257
2115035,6,0,6,48,10,3,61,119,14,194
2115036,4,0,4,80,15,6,101,169,7,277
2115037,0,3,3,62,18,3,83,106,9,198
2115038,0,0,0,46,27,6,79,139,10,228
2115101,4,0,4,114,28,3,145,321,22,488
2115102,5,3,8,27,13,0,40,215,26,281
2115103,0,0,0,44,18,0,62,231,55,348
2115104,0,0,0,67,12,3,82,293,44,419
2115105,4,3,7,66,15,3,84,338,36,458
2115106,3,0,3,60,25,9,94,345,24,463
2115107,3,4,7,64,14,0,78,240,32,350
2115108,0,0,0,24,9,3,36,194,14,244
2115109,0,0,0,62,24,3,89,247,18,354
2115110,33,10,43,62,15,6,83,222,22,327
2115111,7,0,7,83,25,3,111,179,12,302
2115112,0,0,0,13,4,4,21,166,18,205
2115113,6,0,6,96,31,3,130,391,16,537
2115114,3,3,9,67,26,6,99,365,18,482
2115115,7,0,7,58,15,7,80,157,33,270
2115116,0,0,0,36,21,0,57,453,9,519
2115117,3,0,3,34,24,0,58,268,12,338
2115118,0,5,5,43,32,0,75,285,34,394
2115119,13,13,26,66,30,0,96,389,59,544
2115120,19,3,22,17,12,3,32,145,21,198
2115121,3,3,6,62,34,0,96,385,27,508
2115122,17,3,20,34,18,0,52,325,21,398
2115123,6,0,6,14,14,3,31,294,22,347
2115124,4,0,4,41,19,5,65,130,9,204
2115125,11,0,11,51,30,3,84,273,25,382
2115126,4,0,4,51,15,6,72,172,25,269
2115127,9,0,9,61,25,0,86,253,23,362
2115128,10,3,13,58,32,0,90,378,62,530
2115129,7,0,7,40,16,6,62,255,29,346
2115130,11,3,14,66,18,6,90,180,16,286
2115131,3,0,3,53,20,3,76,228,43,347
2115132,0,0,0,41,4,3,48,93,9,150
2115133,5,0,5,80,27,0,107,303,25,435
2115134,3,0,3,49,42,3,94,303,15,412
2115135,3,0,3,77,21,3,101,173,15,289
2115136,0,0,0,65,30,3,98,233,40,371
2115137,0,4,4,39,31,3,73,334,32,439
2115138,0,0,0,49,24,0,73,265,35,373
2115139,15,0,15,46,23,0,69,480,29,578
2115140,3,0,3,46,10,0,56,274,22,352
2115141,0,5,5,33,19,0,52,594,17,663
2115142,6,3,9,68,36,3,107,273,19,399
2115143,6,0,6,83,15,6,104,250,29,383
2115144,4,0,4,58,21,3,82,399,17,498
2115145,0,0,0,54,18,6,78,175,12,265
2115146,0,3,3,42,20,0,62,314,39,415
2115147,34,6,40,100,22,6,128,349,18,495
2115201,8,0,8,69,34,0,103,384,31,518
2115202,11,0,11,77,38,10,125,200,18,343
2115203,3,0,3,33,20,0,53,148,10,211
2115204,0,0,0,57,21,0,78,203,29,310
2115205,3,3,6,69,23,3,95,280,31,406
2115206,8,3,14,71,39,6,116,302,27,445
2115207,0,0,0,35,29,3,67,327,38,432
2115208,7,3,10,63,13,0,76,192,22,290
2115209,8,0,8,25,10,0,35,218,29,282
2115210,6,0,6,101,25,9,135,225,29,389
2115211,5,0,5,68,16,4,88,251,40,379
2115212,4,0,4,34,17,3,54,250,32,336
2115213,4,0,4,59,15,0,74,153,24,251
2115214,6,0,6,49,29,0,78,190,25,293
2115215,0,0,0,47,20,0,67,282,41,390
2115216,0,0,0,65,16,0,81,241,29,351
2115217,0,0,0,38,13,0,51,237,28,316
2115218,4,0,4,96,22,0,118,212,14,344
2115219,3,0,3,63,23,4,90,249,57,396
2115220,3,3,6,69,33,6,108,363,37,508
2115221,62,6,68,38,11,3,52,246,18,316
2115222,13,0,13,67,37,6,110,402,29,541
2115223,0,3,3,52,27,0,79,202,23,304
2115224,10,0,10,89,32,4,125,303,36,464
2115225,8,3,11,39,23,0,62,165,9,236
2115226,3,0,3,107,19,3,129,233,17,379
2115227,0,3,6,25,21,0,46,447,76,569
2115228,12,0,15,79,32,3,114,246,21,381
2115229,4,0,4,89,22,6,117,237,17,371
2115230,4,3,10,82,22,6,110,211,26,347
2115231,27,0,27,58,17,0,75,302,31,408
2115301,21,51,72,47,18,3,68,218,92,378
2115302,6,0,6,55,25,3,83,308,10,401
2115303,3,0,3,73,21,0,94,257,21,372
2115304,6,3,9,50,40,0,90,289,12,391
2115305,0,0,0,80,21,0,101,270,12,383
2115306,0,0,0,66,29,3,98,286,22,406
2115307,0,0,0,67,16,0,83,269,24,376
2115308,24,4,28,88,47,0,135,317,17,469
2115309,11,0,11,77,53,0,130,238,12,380
2115310,7,80,87,50,22,0,72,209,141,422
2115311,11,0,11,73,26,3,102,224,15,341
2115312,4,0,4,73,19,3,95,195,22,312
2115313,0,0,0,82,27,3,112,315,34,461
2115314,0,0,0,44,11,3,58,183,40,281
2115315,3,0,3,59,16,6,81,200,24,305
2115316,3,0,6,62,30,3,95,390,39,524
2115317,35,0,35,75,29,0,104,352,39,495
2115318,10,0,10,41,30,3,74,234,33,341
2115319,7,0,7,45,14,0,59,149,19,227
2115320,34,4,38,62,26,3,91,271,20,382
2115321,9,0,9,75,33,3,111,223,9,343
2115322,31,3,34,79,37,6,122,329,13,464
2115323,12,0,12,50,15,0,65,161,28,254
2115324,37,4,44,46,31,0,77,259,38,374
2115325,14,0,14,85,33,3,121,256,51,428
2115326,17,0,17,58,30,3,91,187,13,291
2115327,6,0,6,69,28,3,100,186,25,311
2115328,4,0,4,87,37,4,128,204,11,343
2115329,8,3,11,46,29,0,75,183,31,289
2115330,6,0,6,61,21,0,82,295,28,405
2115331,15,0,15,84,32,15,131,392,30,553
2115332,5,3,8,57,22,3,82,186,9,277
2115333,8,0,8,63,25,4,92,184,10,286
2115334,6,3,12,61,41,0,102,253,27,382
2115335,8,0,8,71,32,5,108,253,15,376
2115336,9,6,15,51,22,3,76,244,34,354
2115337,3,0,3,66,15,0,81,147,15,243
2115338,8,0,8,71,21,4,96,206,21,323
2115339,3,6,9,71,17,9,97,251,34,382
2115340,3,3,6,57,7,0,64,176,20,260
2115341,5,3,8,69,24,4,97,192,29,318
2115342,0,4,4,55,18,3,76,190,21,287
2115343,6,0,10,48,14,4,66,256,31,353
2115344,76,4,80,39,30,0,69,361,46,476
2115345,8,3,11,62,16,0,78,194,34,306
2115346,7,3,10,75,35,3,113,273,27,413
2115347,6,3,9,57,18,7,82,178,15,275
2115348,8,0,8,84,36,3,123,273,21,417
2115349,10,6,16,69,29,0,98,295,62,455
2115350,7,0,7,80,18,11,109,181,7,297
2115351,7,0,7,77,24,0,101,218,4,323
2115352,6,0,6,44,6,3,53,151,6,210
2115353,5,0,5,45,22,0,67,176,36,279
2115354,5,0,5,54,39,0,93,219,12,324
2115355,0,0,0,0,0,0,0,0,0,0
2115356,6,0,6,46,17,6,69,184,7,260
2115357,5,0,5,50,10,0,60,136,8,204
2115401,0,0,0,56,17,3,76,148,18,242
2115402,3,0,3,49,6,3,58,166,14,238
2115403,11,4,15,52,20,0,72,196,19,287
2115404,8,0,8,63,30,6,99,210,15,324
2115405,3,6,9,45,15,6,66,123,15,204
2115406,9,0,9,61,11,3,75,119,15,209
2115407,4,3,7,73,12,0,85,172,24,281
2115408,7,3,10,87,20,6,113,171,19,303
2115409,5,0,5,77,24,3,104,202,9,315
2115410,18,0,21,100,21,6,127,240,6,373
2115411,5,0,5,82,34,6,122,248,12,382
2115412,12,0,12,102,30,3,135,291,22,448
2115413,0,3,3,73,27,0,100,195,16,311
2115414,6,0,6,63,13,3,79,139,12,230
2115415,6,0,6,59,16,3,78,96,3,177
2115416,12,0,12,82,16,5,103,228,10,341
2115417,10,0,10,65,13,3,81,235,26,342
2115418,0,0,0,0,0,0,0,0,0,0
2115501,3,0,3,87,17,6,110,206,16,332
2115502,0,0,0,84,14,4,102,161,7,270
2115503,4,0,4,118,31,11,160,273,15,448
2115504,0,0,0,43,20,3,66,182,20,268
2115505,116,5,121,33,22,0,55,303,15,373
2115506,11,6,17,53,12,3,68,199,33,300
2115507,5,0,5,32,13,0,45,153,15,213
2115508,0,0,0,81,33,0,114,197,12,323
2115509,9,0,9,56,26,0,82,188,0,270
2115510,3,0,3,81,42,3,126,254,16,396
2115511,19,3,22,89,32,0,121,318,12,451
2115512,9,0,9,52,36,0,88,204,15,307
2115513,6,0,6,69,14,3,86,120,12,218
2115514,6,0,6,93,27,4,124,244,13,381
2115515,3,0,3,58,19,0,77,128,12,217
2115516,0,0,0,55,6,0,61,124,6,191
2115517,0,0,0,49,30,3,82,158,9,249
2115518,6,0,6,71,23,0,94,189,8,291
2115519,6,0,6,62,16,0,78,186,15,279
2115520,90,6,96,47,21,0,68,308,9,385
2115521,4,4,8,47,23,4,74,227,9,310
2115522,19,5,24,65,51,3,119,346,28,493
2115523,0,0,0,30,14,0,44,149,0,193
2115524,3,3,6,69,22,3,94,204,15,313
2115525,6,0,6,70,17,3,90,266,12,368
2115526,10,0,10,96,31,6,133,302,6,441
2115527,3,0,3,52,9,0,61,99,8,168
2115528,10,0,10,74,27,3,104,205,3,312
2115529,7,0,7,47,20,0,67,112,10,189
2115530,9,0,9,87,34,0,121,259,12,392
2115531,11,0,11,63,25,3,91,179,3,273
2115532,6,6,12,71,19,0,90,247,33,370
2115533,8,0,8,78,13,3,94,217,13,324
2115534,9,3,12,102,23,6,131,278,24,433
2115535,6,0,6,80,20,3,103,178,12,293
2115536,9,0,9,54,12,3,69,149,4,222
2115537,6,3,9,55,12,0,67,141,8,216
2115538,3,3,6,72,5,0,77,132,17,226
2115539,0,0,0,47,14,6,67,119,12,198
2115540,4,3,7,72,24,3,99,231,15,345
2115541,0,0,0,35,24,3,62,133,3,198
2115542,6,0,6,78,23,0,101,213,7,321
2115543,0,0,0,41,20,0,61,92,3,156
2115601,3,3,6,66,20,0,86,201,34,321
2115602,3,0,3,94,36,4,134,293,24,451
2115603,16,0,16,82,50,0,132,345,13,490
2115604,8,0,8,51,15,0,66,175,23,264
2115605,8,0,8,77,31,3,111,324,16,451
2115606,0,0,0,0,0,0,0,3,0,3
2115607,4,0,4,36,23,0,59,131,16,206
2115608,0,0,0,0,0,0,0,7,0,7
2115609,15,0,18,70,36,3,109,285,15,409
2115610,7,0,7,70,43,0,113,312,28,453
2115611,3,0,3,69,16,0,85,229,3,317
2115612,0,0,0,107,12,0,119,142,4,265
2115613,19,3,22,97,47,8,152,306,9,467
2115614,6,0,6,47,22,4,73,170,19,262
2115615,7,3,10,69,57,3,129,308,28,465
2115616,7,0,10,43,32,4,79,160,12,251
2115617,11,0,11,51,30,0,81,218,13,312
2115618,9,0,9,57,45,0,102,256,26,384
2115619,11,3,14,69,33,6,108,355,21,484
2115620,6,0,6,77,29,0,106,273,37,416
2115621,11,0,11,78,37,5,120,303,15,438
2115622,14,3,17,34,21,3,58,204,14,276
2115623,7,0,7,59,20,0,79,220,3,302
2115624,6,3,9,79,19,0,98,160,30,288
2115625,4,0,4,72,33,3,108,214,18,340
2115626,8,0,8,60,33,0,93,182,18,293
2115627,3,3,6,78,13,0,91,174,7,272
2115628,16,0,16,43,25,0,68,196,17,281
2115701,74,11,85,15,44,0,59,377,43,479
2115702,9,0,9,57,11,6,74,169,9,252
2115703,7,6,13,54,34,6,94,325,18,437
2115704,0,0,0,52,26,0,78,207,12,297
2115705,8,5,13,38,31,0,69,207,12,288
2115706,8,7,15,73,28,0,101,196,23,320
2115707,9,0,9,88,46,4,138,291,18,447
2115708,18,0,18,64,34,4,102,329,24,455
2115709,9,0,9,62,27,0,89,240,26,355
2115710,7,0,7,89,35,0,124,347,22,493
2115711,6,3,12,57,25,0,82,204,25,311
2115712,13,0,13,79,36,4,119,340,21,480
2115713,6,0,6,41,16,0,57,196,18,271
2115714,9,3,12,44,29,0,73,159,6,238
2115715,10,6,16,83,52,0,135,307,24,466
2115716,4,0,4,75,39,0,114,277,8,399
2115717,0,0,0,41,27,7,75,308,11,394
2115718,6,0,6,34,18,0,52,195,4,251
2115719,0,0,0,0,0,0,0,0,0,0
2115720,0,0,0,50,9,0,59,244,12,315
2115721,3,0,3,66,18,7,91,174,21,286
2115722,6,0,6,35,15,0,50,179,8,237
2115723,13,3,16,61,30,3,94,180,15,289
2115724,11,0,11,54,22,0,76,300,15,391
2115725,46,9,58,40,13,0,53,285,37,375
2115726,0,0,0,42,37,0,79,201,34,314
2115727,6,0,6,50,24,0,74,193,12,279
2115728,6,0,6,38,25,0,63,161,8,232
2115729,5,4,9,76,18,6,100,234,26,360
2115730,5,3,8,66,28,0,94,186,12,292
2115731,6,0,6,77,47,6,130,282,27,439
2115732,15,3,18,89,46,0,135,304,28,467
2115733,3,0,3,90,29,3,122,356,21,499
2115734,9,3,12,115,37,0,152,290,18,460
2115735,0,0,0,72,23,0,95,174,21,290
2115736,10,0,10,44,16,0,60,263,34,357
2115737,4,0,4,71,28,0,99,376,33,508
2115738,4,3,7,54,24,0,78,227,22,327
2115739,9,0,9,48,18,3,69,183,7,259
2115740,0,0,0,37,24,0,61,126,10,197
2115741,5,3,8,60,40,3,103,219,21,343
2115742,10,0,10,66,39,0,105,265,8,378
2115743,8,0,8,66,21,0,87,271,24,382
2115744,6,3,9,39,15,3,57,168,15,240
2115745,3,0,3,50,22,3,75,191,7,273
2115746,11,3,14,60,19,0,79,249,20,348
2115801,4,0,4,45,18,6,69,172,7,248
2115802,4,0,4,63,20,0,83,222,0,305
2115803,0,0,0,95,34,3,132,318,15,465
2115804,10,5,15,53,36,0,89,260,25,374
2115805,15,0,15,37,22,3,62,186,0,248
2115806,6,0,6,46,21,3,70,235,10,315
2115807,5,0,5,56,18,0,74,200,17,291
2115808,0,0,0,55,16,0,71,149,9,229
2115809,0,4,4,60,28,0,88,166,23,277
2115810,0,0,0,53,25,0,78,115,13,206
2115811,9,0,9,70,25,0,95,265,20,380
2115812,6,0,6,91,43,0,134,233,15,382
2115813,3,0,3,94,36,0,130,286,12,428
2115814,4,0,4,45,10,4,59,181,6,246
2115815,5,0,5,63,33,4,100,214,3,317
2115816,6,3,9,83,30,3,116,269,18,403
2115817,4,0,4,35,12,3,50,136,4,190
2115818,9,0,9,71,29,0,100,268,17,385
2115819,3,3,6,49,17,0,66,182,15,263
2115820,8,5,13,72,31,3,106,268,10,384
2115821,8,3,11,47,22,4,73,195,18,286
2115822,9,0,9,45,22,0,67,210,8,285
2115823,18,3,21,36,17,0,53,155,18,226
2115824,3,0,3,50,19,0,69,179,24,272
2115825,3,0,3,40,16,0,56,116,9,181
2115826,3,0,3,52,32,0,84,175,9,268
2115827,3,0,3,78,24,6,108,218,7,333
2115828,6,0,6,118,45,8,171,352,19,542
2115829,0,4,4,84,31,0,115,212,12,339
2115830,4,0,4,51,24,0,75,143,18,236
2115831,6,4,10,56,19,3,78,202,38,318
2115832,3,0,3,77,40,3,120,259,25,404
2115833,4,0,4,83,32,0,115,292,7,414
2115834,3,0,3,106,36,0,142,345,10,497
2115835,0,0,0,45,7,4,56,192,0,248
2115836,3,4,7,92,32,0,124,321,19,464
2115837,0,0,0,62,24,0,86,307,18,411
2115838,0,0,0,52,9,0,61,228,16,305
2115839,0,0,0,72,22,0,94,159,4,257
2115840,6,0,6,78,44,0,122,230,12,364
2115841,3,0,3,75,23,0,98,237,4,339
2115842,3,3,6,82,31,0,113,244,24,381
2115843,7,0,7,56,27,0,83,237,39,359
2115844,8,9,17,91,37,5,133,377,38,548
2115845,4,0,4,47,27,9,83,285,23,391
2115846,3,0,3,50,21,3,74,147,12,233
2115847,0,0,0,44,19,0,63,151,9,223
2115848,4,0,4,90,26,7,123,297,24,444
2115849,56,0,56,31,12,0,43,259,11,313
2115850,3,0,3,53,15,3,71,209,21,301
2115851,0,0,0,64,10,0,74,232,33,339
2115852,6,3,9,67,17,0,84,225,21,330
2115853,8,3,11,53,26,0,79,170,30,279
2115854,8,0,8,66,27,0,93,221,15,329
2115855,15,0,15,52,30,7,89,183,13,285
2115856,7,3,10,35,16,0,51,145,9,205
2115857,0,0,0,54,24,3,81,282,3,366
2115858,5,0,5,61,37,0,98,235,12,345
2115859,45,8,53,60,26,6,92,305,22,419
2115860,9,0,9,93,42,4,139,333,11,483
2115861,6,3,9,46,19,9,74,196,27,297
2115862,57,16,73,42,15,0,57,283,35,375
2115863,8,0,8,67,13,0,80,232,15,327
2115864,8,0,8,87,36,4,127,273,21,421
2115865,7,0,7,111,37,3,151,373,24,548
2115866,0,0,0,0,0,0,0,0,0,0
2115867,0,0,0,44,32,0,76,142,6,224
2115868,3,0,3,33,21,0,54,158,6,218
2115869,6,0,6,51,18,0,69,212,22,303
2115901,9,0,9,95,43,0,138,305,12,455
2115902,6,0,6,38,15,0,53,156,4,213
2115903,3,0,3,51,19,0,70,186,15,271
2115904,3,0,3,85,31,0,116,293,18,427
2115905,7,3,10,72,33,3,108,273,18,399
2115906,6,0,6,63,22,0,85,226,15,326
2115907,0,0,0,92,27,3,122,260,17,399
2115908,4,0,4,51,20,0,71,157,15,243
2115909,3,0,3,64,20,0,84,160,4,248
2115910,3,0,3,97,43,4,144,296,24,464
2115911,7,0,7,55,23,0,78,224,12,314
2115912,6,0,6,70,35,3,108,235,15,358
2115913,6,0,6,29,21,0,50,134,21,205
2115914,39,0,39,41,29,0,70,207,6,283
2115915,6,0,6,57,25,0,82,221,19,322
2115916,4,0,4,43,21,0,64,218,21,303
2115917,6,3,9,60,28,0,88,238,10,336
2115918,4,0,4,59,23,0,82,206,17,305
2115919,23,36,59,55,15,0,70,221,76,367
2115920,26,0,26,89,30,0,119,300,12,431
2115921,6,0,6,87,42,0,129,311,8,448
2115922,3,0,3,50,41,3,94,269,12,375
2115923,3,0,3,70,18,3,91,146,6,243
2115924,4,0,4,80,25,0,105,299,24,428
2115925,0,0,0,0,0,0,0,0,0,0
2115926,4,0,4,69,42,3,114,295,11,420
2115927,0,33,33,41,30,3,74,170,74,318
2115928,0,0,0,38,11,3,52,177,15,244
2115929,3,0,3,43,0,0,43,178,9,230
2115930,3,0,3,47,27,3,77,243,12,332
2115931,0,0,0,33,28,0,61,187,0,248
2115932,0,0,0,33,9,0,42,75,0,117
2115933,10,0,13,97,37,0,134,262,21,417
2115934,7,0,7,59,42,3,104,274,19,397
2115935,6,0,6,36,17,0,53,145,0,198
2115936,72,16,88,41,20,3,64,276,53,393
2115937,3,0,3,25,15,3,43,153,0,196
2115938,3,6,9,44,37,0,81,288,10,379
2115939,0,0,0,64,37,0,101,270,16,387
2115940,0,0,0,39,21,0,60,182,0,242
2115941,3,0,3,88,21,6,115,249,15,379
2115942,6,0,6,50,39,0,89,213,24,326
2115943,0,0,0,45,34,4,83,257,6,346
2115944,6,0,6,27,9,0,36,128,10,174
2116001,6,0,6,45,17,0,62,135,6,203
2116002,17,5,22,67,35,3,105,271,26,402
2116003,5,0,5,59,51,4,114,195,10,319
2116004,8,0,8,55,30,0,85,163,10,258
2116005,4,0,4,37,14,3,54,122,12,188
2116006,3,3,6,90,35,4,129,256,20,405
2116007,7,0,7,73,51,0,124,260,6,390
2116008,7,4,11,67,33,0,100,249,8,357
2116009,3,0,3,43,16,0,59,183,6,248
2116010,37,87,124,51,11,3,65,224,160,449
2116011,3,6,9,71,26,0,97,205,21,323
2116012,14,3,17,58,14,0,72,205,24,301
2116013,3,3,6,67,48,0,115,228,31,374
2116014,0,0,0,72,49,5,126,334,26,486
2116015,3,0,3,49,18,3,70,153,17,240
2116016,4,0,4,56,42,3,101,215,10,326
2116017,0,38,38,76,42,7,125,300,68,493
2116018,33,4,37,28,22,0,50,178,7,235
2116019,33,0,33,68,24,6,98,304,18,420
2116020,3,0,3,53,19,3,75,186,3,264
2116021,3,0,3,48,17,0,65,153,9,227
2116022,10,0,10,53,27,6,86,208,11,305
2116023,15,6,21,65,38,0,103,331,37,471
2116024,6,3,9,60,41,9,110,269,36,415
2116025,12,0,12,100,52,3,155,332,21,508
2116026,3,0,3,57,35,4,96,210,10,316
2116027,3,0,3,73,40,4,117,243,15,375
2116028,3,0,3,83,38,0,121,183,21,325
2116029,29,4,33,48,26,0,74,216,13,303
2116030,4,0,4,35,38,3,76,121,3,200
2116031,6,4,10,74,25,3,102,244,27,373
2116032,4,0,4,77,34,0,111,244,27,382
2116033,3,0,3,40,26,0,66,104,3,173
2116101,8,0,8,55,19,3,77,159,15,251
2116102,10,3,13,95,32,3,130,249,27,406
2116103,10,0,10,103,27,0,130,212,27,369
2116104,6,4,10,62,32,0,94,184,4,282
2116105,3,0,3,123,34,0,157,257,41,455
2116106,15,0,15,70,34,3,107,204,30,341
2116107,6,5,11,76,18,9,103,218,24,345
2116108,6,3,9,65,16,0,81,144,7,232
2116109,10,0,10,103,24,0,127,221,25,373
2116110,7,5,12,57,27,4,88,124,20,232
2116111,3,0,6,113,28,7,148,274,24,446
2116112,8,0,8,70,33,0,103,188,12,303
2116113,3,0,3,50,13,0,63,91,15,169
2116114,9,6,15,49,21,3,73,189,25,287
2116115,11,0,11,86,28,0,114,182,12,308
2116116,7,0,7,80,26,7,113,238,10,361
2116117,21,6,33,73,49,0,122,358,27,507
2116118,7,0,10,109,30,3,142,246,24,412
2116119,8,0,11,70,30,0,100,234,15,349
2116120,3,6,9,55,20,0,75,243,30,348
2116121,17,0,17,91,63,16,170,348,6,524
2116122,8,3,11,64,41,3,108,207,22,337
2116123,18,3,21,76,42,3,121,320,24,465
2116124,10,0,10,82,38,10,130,310,6,446
2116125,8,83,91,58,34,0,92,199,179,470
2116126,7,0,7,60,20,0,80,146,5,231
2116127,11,0,11,92,33,6,131,239,39,409
2116128,5,6,11,93,17,10,120,231,57,408
2116129,9,6,15,74,24,7,105,215,52,372
2116130,13,0,13,79,19,0,98,235,23,356
2116131,16,4,20,73,39,3,115,283,10,408
2116132,6,4,10,84,29,11,124,237,14,375
2116133,9,28,37,49,6,4,59,119,46,224
2116134,10,3,13,74,26,0,100,191,16,307
2116135,12,3,15,101,43,3,147,338,23,508
2116136,26,7,33,104,32,4,140,342,31,513
2116137,9,0,9,61,8,4,73,187,18,278
2116138,27,7,34,54,21,0,75,356,32,463
2116139,13,0,13,112,17,3,132,255,32,419
2116140,6,4,10,73,12,3,88,136,8,232
2116141,0,3,3,60,22,6,88,205,17,310
2116142,9,0,9,126,33,3,162,276,16,454
2116143,15,0,15,58,37,5,100,238,5,343
2116144,3,0,3,0,0,0,0,3,0,3
2116145,7,6,13,81,10,6,97,249,30,376
2116201,10,0,10,87,20,0,107,174,15,296
2116202,4,0,4,78,13,0,91,179,9,279
2116203,30,9,39,54,20,0,74,239,31,344
2116204,7,3,10,61,23,3,87,208,22,317
2116205,7,3,10,58,11,0,69,147,24,240
2116206,8,3,11,75,35,4,114,371,18,503
2116207,8,0,8,53,21,9,83,184,0,267
2116208,8,3,11,100,39,3,142,225,16,383
2116209,9,0,9,53,15,0,68,189,12,269
2116210,13,0,13,122,37,0,159,319,27,505
2116211,9,4,13,100,35,0,135,262,26,423
2116212,6,0,6,83,21,3,107,202,0,309
2116213,0,0,0,91,46,6,143,259,16,418
2116214,7,3,10,84,29,3,116,214,19,349
2116215,5,0,5,58,25,0,83,176,23,282
2116216,3,0,3,37,22,0,59,121,13,193
2116217,68,132,200,6,8,0,14,215,283,512
2116218,9,0,9,96,21,6,123,229,24,376
2116219,6,0,6,98,30,9,137,259,31,427
2116220,3,0,3,65,19,6,90,130,7,227
2116221,13,7,20,111,35,4,150,349,31,530
2116222,10,3,13,51,23,3,77,204,15,296
2116223,0,3,3,67,23,3,93,177,12,282
2116224,6,0,6,65,26,0,91,111,6,208
2116225,4,0,4,106,24,6,136,228,32,396
2116301,42,3,45,40,15,0,55,259,33,347
2116302,0,0,0,55,15,4,74,197,16,287
2116303,3,3,6,62,9,6,77,215,21,313
2116304,11,0,11,75,11,0,86,345,21,452
2116305,6,0,6,51,6,0,57,234,33,324
2116306,0,0,0,59,12,0,71,318,44,433
2116307,0,3,3,86,3,3,92,201,27,320
2116308,74,9,83,39,32,0,71,398,34,503
2116309,7,0,7,94,18,4,116,273,12,401
2116310,6,3,9,78,12,0,90,177,15,282
2116311,3,0,3,72,16,3,91,395,62,548
2116312,6,0,6,26,12,0,38,233,48,319
2116313,4,0,4,40,10,0,50,196,11,257
2116314,5,0,5,63,15,3,81,255,6,342
2116315,9,0,9,95,28,12,135,413,32,580
2116316,5,3,8,73,31,3,107,366,18,491
2116317,10,78,88,34,19,0,53,453,347,853
2116318,15,3,18,61,31,0,92,308,41,441
2116319,17,0,17,88,32,0,120,266,50,436
2116320,6,0,6,68,19,5,92,183,33,308
2116321,6,0,6,77,20,4,101,204,4,309
2116322,34,10,44,32,33,0,65,242,30,337
2116323,16,0,16,39,7,0,46,150,28,224
2116324,8,0,8,68,20,0,88,202,48,338
2116325,3,3,6,41,11,4,56,141,15,212
2116326,7,0,7,60,9,3,72,224,9,305
2116327,5,0,5,71,11,4,86,190,19,295
2116328,9,0,9,63,16,7,86,201,12,299
2116329,10,0,13,88,18,3,109,197,27,333
2116330,10,0,10,133,32,5,170,316,34,520
2116331,6,0,6,55,0,6,61,167,7,235
2116332,7,0,7,51,21,3,75,180,12,267
2116333,10,5,15,94,18,4,116,211,20,347
2116334,0,0,0,37,13,0,50,172,16,238
2116335,8,3,11,46,3,3,52,429,40,521
2116336,3,3,6,80,16,6,102,356,23,481
2116337,3,4,7,55,10,9,74,177,14,265
2116338,3,0,3,19,3,0,22,246,41,309
2116339,12,0,12,28,16,0,44,144,9,197
2116340,7,3,10,56,5,0,61,192,3,256
2116341,0,0,0,37,7,0,44,188,13,245
2116401,8,3,11,102,28,3,133,255,14,402
2116402,8,3,14,63,35,3,101,241,23,365
2116403,9,0,9,47,7,3,57,194,11,262
2116404,9,3,12,83,24,9,116,287,12,415
2116405,7,0,7,78,28,4,110,246,16,372
2116406,5,3,8,80,15,0,95,168,10,273
2116407,15,0,15,114,39,3,156,263,18,437
2116408,7,3,10,45,24,3,72,239,3,314
2116409,5,0,5,50,10,0,60,306,27,393
2116410,9,0,9,79,28,0,107,273,26,406
2116411,9,0,9,81,36,4,121,280,15,416
2116412,7,6,16,134,36,3,173,317,51,541
2116413,19,3,22,88,13,5,106,217,19,342
2116414,9,3,12,72,18,5,95,264,24,383
2116415,10,0,10,94,23,4,121,290,52,463
2116416,4,0,4,91,23,6,120,274,18,412
2116417,11,4,15,99,19,7,125,357,36,518
2116418,5,4,9,63,24,0,87,214,8,309
2116419,9,0,9,90,26,4,120,218,12,350
2116420,7,3,10,84,20,0,104,260,28,392
2116421,11,0,11,51,12,7,70,216,20,306
2116422,0,0,0,44,17,11,72,159,13,244
2116423,19,0,19,76,12,0,88,265,22,375
2116424,3,0,3,50,19,3,72,152,13,237
2116425,4,0,4,75,24,5,104,228,16,348
2116426,5,0,5,96,30,3,129,235,8,372
2116427,15,6,21,95,32,9,136,322,28,486
2116428,29,0,29,64,22,4,90,254,18,362
2116429,10,0,10,87,32,0,119,296,29,444
2116430,11,3,14,78,27,6,111,219,20,350
2116431,9,7,16,117,28,4,149,265,28,442
2116432,9,0,9,59,15,0,74,185,25,284
2116433,8,6,14,62,22,3,87,192,27,306
2116434,6,0,6,64,23,3,90,186,21,297
2116435,9,0,9,52,15,0,67,182,16,265
2116436,17,0,17,98,40,8,146,217,4,367
2116437,0,0,0,49,15,0,64,127,15,206
2116501,0,0,0,78,22,0,100,293,27,420
2116502,6,3,9,77,10,7,94,285,33,412
2116503,68,15,83,21,10,0,31,276,30,337
2116504,6,6,12,40,12,0,52,235,21,308
2116505,3,3,6,47,18,7,72,259,14,345
2116506,9,6,15,51,20,0,71,260,18,349
2116507,44,7,51,37,15,3,55,196,20,271
2116508,7,0,10,33,22,0,55,137,22,214
2116509,12,0,12,37,6,0,43,151,12,206
2116510,9,0,9,40,17,0,57,340,43,440
2116511,4,0,4,26,12,0,38,260,47,345
2116512,15,4,19,54,17,3,74,344,37,455
2116513,17,3,20,45,18,3,66,432,27,525
2116514,8,0,8,61,19,0,80,239,15,334
2116515,7,0,7,60,16,4,80,289,21,390
2116516,34,0,34,33,15,3,51,220,6,277
2116517,6,6,12,93,29,3,125,220,15,360
2116518,60,10,73,45,25,0,70,297,32,399
2116519,7,0,7,118,32,12,162,363,39,564
2116520,6,3,9,48,13,0,61,304,27,392
2116521,0,0,0,64,24,6,94,215,21,330
2116522,8,3,11,59,21,3,83,190,18,291
2116523,12,0,16,58,36,3,97,387,43,527
2116524,6,0,6,39,17,0,56,273,32,361
2116525,0,0,0,0,0,0,0,0,0,0
2116526,0,3,3,11,10,0,21,220,15,256
2116527,0,0,0,45,5,0,50,212,12,274
2116601,0,0,0,79,38,0,117,320,20,457
2116602,0,0,0,44,28,0,72,183,21,276
2116603,14,0,14,51,28,0,79,335,20,434
2116604,9,0,9,86,34,0,120,295,24,439
2116605,7,0,7,64,28,6,98,317,13,428
2116606,0,0,0,39,14,0,53,138,10,201
2116607,4,0,4,34,19,0,53,190,30,273
2116608,10,0,10,25,18,0,43,257,17,317
2116609,4,0,4,34,8,3,45,116,12,173
2116610,6,3,9,20,17,0,37,169,3,209
2116611,0,0,0,45,16,0,61,118,3,182
2116612,0,0,0,25,19,0,44,130,10,184
2116613,25,3,28,39,14,0,53,296,19,368
2116614,3,0,3,66,33,0,99,291,18,408
2116615,12,0,12,49,26,3,78,218,22,318
2116616,3,3,6,26,19,3,48,130,15,193
2116617,6,0,6,77,31,8,116,293,22,431
2116618,3,0,3,32,15,4,51,192,19,262
2116619,8,0,8,49,14,0,63,244,18,325
2116620,13,0,13,83,41,6,130,329,28,487
2116621,4,0,4,93,41,3,137,353,18,508
2116622,0,0,0,46,22,0,68,156,22,246
2116623,4,8,12,46,17,0,63,130,44,237
2116624,4,0,4,76,18,6,100,180,12,292
2116625,0,3,3,49,22,0,71,199,24,294
2116626,5,0,5,64,20,0,84,275,18,377
2116627,0,0,0,74,45,3,122,279,15,416
2116701,7,0,7,46,22,9,77,243,13,333
2116702,21,0,21,90,23,0,113,383,37,533
2116703,15,6,21,74,27,3,104,226,21,351
2116704,14,0,14,77,19,3,99,224,21,344
2116705,5,0,5,81,20,0,101,244,18,363
2116706,12,3,15,77,33,0,110,298,12,420
2116707,4,4,8,96,40,0,136,209,18,363
2116708,6,0,6,93,27,0,120,248,8,376
2116709,7,0,7,60,29,0,89,165,24,278
2116710,3,0,3,103,19,3,125,235,9,369
2116711,0,0,0,43,6,0,49,161,9,219
2116712,9,0,9,74,28,0,102,178,17,297
2116713,76,0,76,66,30,3,99,322,8,429
2116714,5,0,5,67,29,3,99,208,29,336
2116715,14,0,14,75,32,0,107,301,18,426
2116716,9,4,13,110,37,0,147,269,21,437
2116717,6,3,9,68,23,6,97,258,36,391
2116718,6,0,6,57,16,0,73,208,15,296
2116719,7,0,7,75,20,3,98,236,28,362
2116720,6,0,6,32,9,6,47,129,15,191
2116721,4,0,4,31,9,4,44,133,5,182
2116722,3,3,6,59,12,3,74,183,21,278
2116723,3,0,3,97,18,6,121,341,15,477
2116801,0,0,0,0,0,0,0,0,0,0
2116802,3,0,3,74,23,9,106,192,15,313
2116803,13,0,13,55,33,9,97,178,15,290
2116804,13,0,13,76,33,0,109,221,6,336
2116805,14,0,14,65,28,6,99,212,15,326
2116806,18,0,21,94,44,9,147,288,18,453
2116807,6,0,9,59,28,3,90,164,14,268
2116808,12,0,12,88,40,4,132,302,11,445
2116809,12,3,15,89,31,3,123,245,9,377
2116810,10,0,10,89,48,0,137,302,9,448
2116811,5,7,12,43,15,3,61,125,16,202
2116812,0,0,0,36,28,3,67,168,15,250
2116813,14,3,17,92,41,0,133,286,21,440
2116814,10,4,14,79,31,0,110,253,22,385
2116815,16,0,16,76,36,4,116,210,15,341
2116816,7,3,10,46,20,3,69,176,6,251
2116817,10,4,14,64,32,9,105,232,17,354
2116818,6,6,12,85,22,0,107,186,9,302
2116819,10,6,16,95,35,3,133,265,16,414
2116820,15,0,15,87,25,6,118,322,32,472
2116821,18,0,18,74,23,0,97,189,12,298
2116822,11,0,11,56,18,7,81,128,4,213
2116823,5,0,5,92,38,3,133,256,20,409
2116824,16,5,21,106,33,4,143,309,17,469
2116825,9,0,9,61,19,4,84,157,8,249
2116826,17,3,26,95,60,8,163,321,19,503
2116827,6,0,6,49,31,9,89,162,12,263
2116828,7,0,7,83,22,4,109,200,11,320
2116829,6,5,11,70,20,0,90,125,11,226
2116830,3,0,3,52,17,8,77,140,21,238
2116831,6,0,9,71,3,12,86,147,3,236
2116832,11,6,17,45,21,0,66,131,15,212
2116901,6,0,6,71,21,0,92,202,9,303
2116902,13,3,16,63,46,3,112,203,18,333
2116903,12,6,18,95,37,0,132,272,39,443
2116904,16,0,16,84,41,4,129,253,25,407
2116905,4,3,7,69,19,0,88,156,31,275
2116906,0,0,0,46,26,0,72,179,15,266
2116907,14,6,20,72,42,5,119,261,15,395
2116908,0,0,0,53,19,0,72,113,9,194
2116909,8,0,8,71,26,0,97,164,12,273
2116910,23,6,29,68,49,6,123,366,52,541
2116911,8,4,12,68,17,3,88,124,21,233
2116912,7,7,17,56,30,0,86,203,25,314
2116913,8,0,11,84,45,6,135,254,15,404
2116914,53,4,57,59,23,0,82,276,27,385
2116915,37,0,37,50,23,3,76,227,27,330
2116916,8,0,8,30,37,0,67,172,22,261
2116917,13,0,13,75,41,7,123,271,25,419
2116918,9,0,9,45,37,4,86,171,22,279
2116919,4,0,4,34,6,0,40,149,11,200
2116920,0,0,0,52,19,0,71,149,7,227
2116921,6,0,6,47,35,3,85,170,5,260
2116922,8,4,12,54,29,3,86,163,23,272
2116923,4,0,4,71,22,6,99,241,26,366
2116924,34,0,34,105,45,3,153,284,23,460
2116925,6,0,6,96,49,0,145,232,59,436
2116926,0,0,4,54,25,0,79,141,13,233
2116927,82,8,90,21,13,4,38,193,20,251
2116928,9,0,9,64,31,0,95,176,16,287
2116929,10,5,15,82,31,0,113,280,19,412
2116930,14,4,18,108,36,0,144,363,16,523
2116931,24,5,29,77,34,6,117,253,24,394
2116932,11,0,11,65,19,0,84,164,12,260
2116933,3,4,7,87,44,0,131,290,52,473
2116934,48,3,51,58,28,3,89,208,18,315
2116935,17,3,20,68,24,4,96,249,28,373
2116936,7,0,10,59,25,4,88,194,10,292
2116937,22,5,27,58,19,3,80,183,44,307
2116938,37,8,48,78,42,9,129,306,53,488
2116939,37,3,40,58,20,0,78,237,40,355
2116940,26,0,26,54,34,0,88,207,24,319
2116941,5,0,5,125,24,5,154,304,18,476
2116942,0,3,3,67,15,0,82,119,17,218
2116943,9,0,9,72,28,9,109,192,6,307
2116944,11,3,14,72,26,6,104,141,21,266
2116945,8,0,8,39,14,3,56,134,20,210
2116946,4,0,4,46,15,6,67,122,18,207
2116947,3,0,3,60,33,3,96,177,10,283
2116948,11,3,14,75,29,0,104,219,43,366
2116949,7,0,7,55,32,4,91,229,13,333
2116950,12,0,12,64,24,6,94,243,19,356
2116951,10,0,10,76,43,3,122,202,18,342
2116952,6,0,6,25,15,3,43,149,18,210
2116953,10,0,10,52,30,3,85,170,75,330
2117001,7,0,10,107,16,0,123,221,33,377
2117002,0,0,0,62,21,3,86,148,9,243
2117003,4,0,4,41,15,0,56,132,10,198
2117004,8,0,8,68,31,0,99,182,11,292
2117005,6,0,6,42,4,3,49,116,9,174
2117006,8,0,8,123,26,12,161,245,17,423
2117007,4,4,8,51,11,7,69,124,9,202
2117008,6,3,9,44,19,3,66,176,12,254
2117009,3,0,3,66,27,4,97,169,0,266
2117010,3,3,6,58,17,0,75,190,18,283
2117011,6,0,6,66,19,0,85,248,10,343
2117012,9,0,12,99,28,6,133,199,18,350
2117013,11,0,11,53,23,0,76,112,6,194
2117014,8,0,8,82,24,0,106,170,15,291
2117015,6,6,15,78,20,9,107,186,15,308
2117016,6,3,9,71,20,7,98,170,15,283
2117017,4,3,7,78,31,0,109,177,18,304
2117018,0,0,0,65,29,3,97,190,18,305
2117019,38,10,48,62,19,0,81,252,48,381
2117020,78,6,84,78,26,3,107,282,32,421
2117021,8,5,13,79,22,3,104,289,10,403
2117022,6,0,6,109,25,8,142,255,13,410
2117023,9,0,9,100,35,3,138,222,29,389
2117024,6,0,6,41,18,7,66,125,7,198
2117025,12,0,12,80,27,0,107,250,12,369
2117026,16,0,16,103,16,0,119,293,36,448
2117027,9,3,12,70,18,6,94,155,33,282
2117028,8,0,8,82,29,10,121,232,31,384
2117029,0,0,0,78,25,3,106,220,5,331
2117030,105,14,119,31,17,0,48,250,47,345
2117031,0,0,0,81,19,0,100,168,29,297
2117032,7,78,85,83,22,0,105,237,146,488
2117033,13,0,13,124,34,8,166,266,22,454
2117034,7,3,10,57,30,3,90,225,12,327
2117035,6,0,6,65,12,9,86,172,19,277
2117036,7,0,7,86,13,7,106,205,10,321
2117037,3,4,7,93,38,3,134,237,19,390
2117038,6,6,12,78,26,8,112,194,15,321
2117101,9,3,12,103,21,4,128,277,22,427
2117102,49,0,49,65,29,6,100,252,25,377
2117103,4,0,4,78,12,4,94,131,21,246
2117104,7,0,7,63,0,4,67,94,5,166
2117105,7,3,10,79,30,6,115,188,28,331
2117106,20,3,29,126,32,4,162,270,30,462
2117107,39,3,42,115,23,6,144,259,32,435
2117108,13,0,13,109,35,8,152,288,12,452
2117109,7,0,7,93,15,3,111,211,0,322
2117110,15,0,15,133,33,10,176,285,32,493
2117111,7,4,11,89,22,4,115,261,25,401
2117112,6,3,9,69,29,0,98,253,35,386
2117113,11,0,11,40,28,0,68,198,8,274
2117114,6,0,6,34,17,0,51,124,23,198
2117115,12,0,12,133,26,3,162,268,21,451
2117116,12,0,15,88,37,3,128,272,39,439
2117117,13,0,13,107,19,8,134,235,33,402
2117118,11,0,11,85,17,3,105,203,9,317
2117119,6,0,6,89,20,7,116,183,15,314
2117120,8,3,11,46,16,6,68,168,18,254
2117121,7,3,10,60,18,3,81,156,30,267
2117122,14,3,17,44,15,6,65,218,28,311
2117123,15,8,23,72,38,0,110,272,58,440
2117201,0,3,3,107,25,0,132,245,31,408
2117202,17,3,20,51,15,4,70,115,12,197
2117203,6,0,9,81,25,6,112,194,14,320
2117204,13,0,13,86,33,6,125,318,59,502
2117205,4,0,4,72,23,9,104,163,16,283
2117206,6,0,6,81,23,0,104,191,16,311
2117207,11,3,14,111,42,0,153,248,33,434
2117208,12,0,15,84,26,3,113,238,21,372
2117209,4,0,4,85,28,6,119,219,15,353
2117210,10,6,16,88,30,0,118,223,44,385
2117211,3,3,6,113,36,9,158,202,48,408
2117212,6,0,6,91,26,11,128,213,12,353
2117213,0,6,6,106,12,4,122,88,17,227
2117214,8,0,8,89,17,7,113,146,11,270
2117215,6,3,9,71,26,3,100,162,28,290
2117216,22,6,28,75,15,4,94,161,35,290
2117217,13,0,13,83,17,6,106,266,26,398
2117218,28,6,34,101,21,8,130,338,44,512
2117219,8,3,11,106,26,9,141,214,33,388
2117220,3,0,3,73,12,6,91,253,39,383
2117221,9,0,9,65,22,6,93,260,35,388
2117222,8,0,8,120,28,0,148,292,29,469
2117223,3,6,9,56,15,5,76,229,30,335
2117224,7,0,7,91,22,3,116,246,18,380
2117225,3,0,3,104,22,6,132,177,15,324
2117226,6,6,12,100,17,14,131,212,24,367
2117227,6,3,9,82,36,11,129,246,35,410
2117228,6,0,6,130,22,4,156,240,26,422
2117229,0,0,0,126,27,8,161,187,20,368
2117230,11,0,11,122,37,6,165,229,29,423
2117231,6,3,9,52,28,0,80,195,16,291
2117232,0,0,0,63,18,0,81,190,7,278
2117233,7,0,7,30,8,4,42,128,7,177
2117234,4,0,7,75,24,3,102,156,24,282
2117235,3,0,3,48,9,3,60,148,13,221
2117236,10,0,10,75,36,7,118,287,51,456
2117237,0,0,0,33,15,0,48,140,9,197
2117238,18,3,21,68,32,6,106,241,19,366
2117301,8,0,8,81,10,6,97,188,3,288
2117302,8,0,8,99,28,0,127,201,14,342
2117303,17,6,23,125,39,0,164,332,21,517
2117304,49,3,55,57,21,3,81,239,21,341
2117305,10,6,16,83,17,3,103,176,21,300
2117306,11,3,17,109,18,3,130,209,15,354
2117307,12,0,12,79,29,0,108,193,12,313
2117308,3,3,6,65,21,0,86,144,6,236
2117309,7,3,13,87,28,6,121,205,23,349
2117310,7,0,7,93,17,12,122,169,12,303
2117311,4,0,4,51,13,0,64,131,46,241
2117312,13,0,13,86,19,4,109,188,15,312
2117313,0,6,6,107,24,3,134,170,9,313
2117314,7,0,7,78,24,0,102,241,26,369
2117315,9,0,9,64,35,0,99,178,3,280
2117316,15,0,15,84,28,8,120,226,21,367
2117317,19,0,19,79,26,0,105,188,9,302
2117318,6,0,6,58,7,3,68,148,12,228
2117319,6,0,6,38,14,0,52,134,15,201
2117320,3,3,6,34,30,6,70,276,33,379
2117321,8,0,8,52,21,0,73,138,20,231
2117322,104,14,118,52,29,10,91,365,45,501
2117323,108,10,121,45,16,4,65,251,23,339
2117324,3,3,6,120,27,0,147,199,25,371
2117325,16,3,19,73,12,3,88,167,15,270
2117326,23,3,29,103,22,10,135,249,44,428
2117327,3,0,3,44,42,4,90,183,14,287
2117328,13,9,26,63,59,0,122,280,36,438
2117329,26,3,29,71,55,8,134,360,52,546
2117330,7,3,13,74,36,6,116,228,21,365
2117331,16,9,25,67,27,0,94,222,32,348
2117332,9,3,12,110,48,0,158,226,33,417
2117333,15,0,15,62,44,4,110,201,53,364
2117334,9,3,12,35,25,0,60,174,24,258
2117335,13,4,20,69,43,6,118,279,56,453
2117336,19,0,19,68,39,3,110,240,35,385
2117401,9,3,12,100,18,9,127,300,30,457
2117402,5,0,5,80,15,6,101,237,29,367
2117403,78,9,87,59,4,4,67,301,21,389
2117404,7,0,7,71,14,0,85,141,7,233
2117405,3,0,3,116,23,15,154,228,7,389
2117406,12,0,12,75,19,4,98,174,13,285
2117407,3,4,7,81,10,9,100,138,14,252
2117408,6,3,9,62,5,0,67,190,21,278
2117409,22,0,22,61,22,9,92,257,22,371
2117410,5,0,5,86,22,3,111,224,23,358
2117411,11,6,17,77,21,0,98,218,12,328
2117412,8,3,11,91,33,9,133,351,24,508
2117413,0,0,0,72,7,0,79,139,10,228
2117414,9,3,12,107,28,0,135,394,30,559
2117415,7,0,7,48,21,0,69,193,9,271
2117416,0,0,0,58,0,0,58,126,4,188
2117417,9,0,9,112,6,0,118,174,15,307
2117418,7,0,7,76,13,0,89,175,10,274
2117419,6,0,6,87,19,6,112,205,9,326
2117420,3,4,7,99,16,10,125,244,11,380
2117421,15,0,15,66,23,0,89,289,18,396
2117422,10,6,16,68,21,0,89,258,18,365
2117423,16,0,16,103,39,5,147,262,15,424
2117424,7,0,11,82,24,3,109,249,5,363
2117425,6,0,6,55,19,3,77,177,23,277
2117426,23,0,23,71,18,9,98,230,9,337
2117427,14,3,17,67,15,6,88,180,12,280
2117428,12,0,12,87,32,3,122,210,12,344
2117429,11,0,11,83,20,3,106,205,12,323
2117430,12,7,19,110,29,7,146,231,28,405
2117431,0,5,5,27,16,3,46,111,17,174
2117432,6,0,6,57,0,3,60,135,12,207
2117433,9,0,9,52,16,0,68,207,11,286
2117434,8,3,11,55,21,3,79,243,15,337
2117435,17,3,20,76,12,3,91,260,24,375
2117436,13,0,13,43,15,9,67,190,27,284
2117437,33,0,33,49,5,3,57,200,10,267
2117438,7,0,7,52,18,6,76,140,12,228
2117439,7,0,7,101,27,12,140,270,32,442
2117440,3,3,9,99,31,0,130,276,22,428
2117441,8,3,11,88,11,7,106,204,16,326
2117442,9,0,9,43,18,0,61,196,7,264
2117443,7,0,7,64,24,3,91,153,12,256
2117444,6,0,6,56,22,6,84,157,21,262
2117445,4,4,8,103,24,0,127,169,4,300
2117446,10,0,10,85,24,0,109,183,19,311
2117447,8,0,8,85,7,0,92,196,18,306
2117448,4,0,4,58,12,3,73,154,9,236
2117449,137,29,170,5,18,0,23,328,53,404
2117450,3,6,9,69,18,7,94,174,18,286
2117451,9,0,9,68,18,0,86,143,10,239
2117452,6,0,6,90,7,6,103,144,14,261
2117501,8,0,14,117,31,3,151,253,18,422
2117502,15,3,18,110,28,7,145,235,14,394
2117503,8,3,14,119,18,4,141,223,12,376
2117504,11,3,14,104,15,0,119,278,25,422
2117505,8,0,8,42,17,7,66,189,14,269
2117506,5,0,5,39,17,0,56,136,13,205
2117507,16,0,16,118,34,6,158,356,27,541
2117508,16,6,22,108,26,9,143,264,24,431
2117509,13,0,13,92,31,6,129,294,24,447
2117510,7,8,15,93,37,0,130,203,20,353
2117511,9,3,12,62,11,0,73,176,21,270
2117512,0,7,7,62,31,0,93,180,17,290
2117513,5,0,5,80,25,6,111,264,12,387
2117514,10,0,10,125,25,0,150,234,21,405
2117515,7,0,7,44,14,3,61,187,23,271
2117516,11,6,17,96,17,6,119,283,19,421
2117517,11,0,11,69,31,3,103,259,37,399
2117518,18,0,18,96,45,6,147,339,32,518
2117519,11,0,11,52,30,3,85,200,27,312
2117520,3,0,3,70,15,0,85,166,15,266
2117521,14,0,14,66,27,0,93,189,22,304
2117522,8,0,8,99,30,5,134,312,38,484
2117523,12,5,17,76,17,0,93,150,26,269
2117524,0,3,3,80,26,0,106,170,15,291
2117525,3,3,6,52,19,0,71,183,22,276
2117526,11,0,11,115,19,7,141,292,21,454
2117527,25,3,28,88,46,0,134,213,27,374
2117528,6,0,6,60,35,3,98,270,18,386
2117529,66,7,73,81,34,0,115,276,22,413
2117530,6,0,6,87,21,0,108,258,9,375
2117531,6,3,9,66,20,6,92,154,35,281
2117532,7,0,7,76,27,7,110,271,30,411
2117533,12,0,12,83,26,0,109,219,18,346
2117534,6,0,6,77,13,0,90,223,18,331
2117535,20,0,20,74,17,0,91,247,21,359
2117536,13,4,17,69,24,0,93,233,34,360
2117537,9,0,9,61,24,4,89,148,6,243
2117538,6,0,6,61,17,0,78,155,22,255
2117539,11,6,17,79,19,3,101,235,24,360
2117540,11,0,11,85,9,4,98,227,11,336
2117541,10,0,10,87,34,0,121,216,6,343
2117542,14,6,20,97,18,4,119,186,21,326
2117543,13,3,16,91,39,7,137,332,27,496
2117544,5,0,5,50,20,0,70,228,20,318
2117545,0,3,3,53,11,0,64,233,15,312
2117546,14,0,14,65,22,9,96,173,7,276
2117547,8,3,11,41,21,0,62,99,3,164
2117548,6,0,6,74,9,0,83,136,3,222
2117549,6,3,9,83,6,6,95,129,15,239
2117550,13,0,13,93,6,0,99,189,13,301
2117551,12,0,12,52,6,0,58,135,21,214
2117552,9,0,9,51,21,0,72,155,11,238
2117553,17,0,17,81,22,3,106,228,16,350
2117554,11,3,14,74,24,6,104,225,23,352
2117555,22,7,29,101,21,7,129,266,30,425
2117556,3,3,6,39,14,3,56,193,15,264
2117557,6,3,9,81,15,0,96,192,9,297
2117558,9,3,12,94,33,12,139,165,21,325
2117559,8,0,8,67,28,6,101,199,9,309
2117560,9,3,12,50,12,0,62,127,21,210
2117561,3,0,6,50,25,0,75,104,0,179
2117562,6,0,6,95,18,4,117,239,9,365
2117601,6,0,6,60,25,7,92,151,9,252
2117602,6,0,6,115,34,0,149,289,16,454
2117603,0,0,0,68,13,4,85,213,21,319
2117604,6,4,10,54,13,6,73,238,25,336
2117605,8,3,11,82,29,3,114,303,25,442
2117606,6,6,12,47,20,0,67,160,18,245
2117607,6,0,6,81,12,3,96,174,3,273
2117608,6,3,9,118,28,13,159,279,22,460
2117609,4,0,7,54,13,6,73,165,12,250
2117610,75,8,83,53,15,0,68,285,24,377
2117611,8,4,12,44,10,4,58,209,24,291
2117612,11,0,11,67,30,6,103,358,51,512
2117613,8,0,8,58,16,0,74,341,17,432
2117614,8,0,11,59,10,3,72,274,12,358
2117615,18,33,51,74,31,0,105,342,64,511
2117616,10,0,10,103,31,3,137,343,31,511
2117617,37,8,45,47,12,3,62,225,43,330
2117618,6,3,9,29,9,0,38,133,3,174
2117619,4,0,4,55,15,0,70,265,12,347
2117620,8,0,8,46,12,0,58,213,17,288
2117621,6,0,6,34,20,0,54,256,15,325
2117622,7,0,7,75,22,6,103,267,18,388
2117623,7,3,10,59,10,0,69,259,30,358
2117624,7,0,7,60,13,0,73,196,6,275
2117625,17,3,20,56,27,0,83,389,25,497
2117626,6,3,9,49,9,3,61,154,15,230
2117627,3,3,6,34,21,3,58,340,22,420
2117628,9,0,9,49,25,0,74,256,16,346
2117629,6,6,12,57,18,0,75,271,12,358
2117630,3,3,6,92,24,4,120,264,15,399
2117631,7,3,10,89,19,6,114,294,29,437
2117632,3,3,9,52,9,0,61,223,42,326
2117633,5,0,5,85,32,3,120,377,28,525
2117634,0,0,0,56,15,0,71,276,57,404
2117635,3,3,6,62,4,8,74,113,23,210
2117636,9,3,12,60,24,0,84,250,24,358
2117637,6,5,11,47,9,0,56,210,5,271
2117638,0,0,0,48,13,7,68,233,15,316
2117639,4,3,7,46,19,0,65,201,39,305
2117701,3,0,3,23,10,3,36,242,19,297
2117702,7,0,7,68,8,0,76,288,33,397
2117703,4,0,4,68,9,14,91,266,28,385
2117704,5,0,5,40,22,0,62,183,27,272
2117705,4,0,4,40,12,3,55,214,15,284
2117706,3,0,3,52,9,0,61,167,6,234
2117707,9,3,12,63,45,3,111,300,22,433
2117708,15,0,15,55,31,0,86,189,13,288
2117709,6,0,6,25,13,6,44,127,14,185
2117710,17,3,20,63,21,0,84,247,31,362
2117711,10,5,15,64,37,3,104,188,17,309
2117712,0,0,0,62,11,0,73,172,11,256
2117713,19,3,22,55,35,0,90,204,46,340
2117714,3,3,6,72,19,4,95,168,10,273
2117715,6,0,6,27,14,0,41,152,12,205
2117716,3,0,3,26,12,0,38,130,15,183
2117717,10,0,10,44,28,4,76,223,26,325
2117718,4,0,4,45,9,3,57,164,11,232
2117719,6,0,6,36,12,5,53,102,27,182
2117720,25,0,25,20,24,0,44,142,15,201
2117721,0,0,0,19,18,3,40,132,30,202
2117722,8,0,8,43,23,0,66,245,66,377
2117723,5,0,5,71,23,0,94,276,44,414
2117724,0,3,6,49,19,6,74,186,19,279
2117725,6,0,6,70,15,0,85,185,46,316
2117726,7,0,7,44,24,6,74,192,26,292
2117727,7,0,7,31,22,0,53,148,14,215
2117728,3,0,3,82,17,0,99,182,22,303
2117729,6,0,6,43,17,0,60,167,7,234
2117730,68,39,107,43,22,0,65,329,59,453
2117731,0,4,7,48,42,3,93,168,15,276
2117732,4,0,4,40,14,0,54,125,18,197
2117733,8,3,11,50,18,0,68,169,15,252
2117734,16,0,16,63,21,0,84,179,8,271
2117735,7,0,7,42,25,3,70,165,21,256
2117736,4,4,8,37,32,0,69,211,12,292
2117737,6,0,6,40,21,0,61,160,10,231
2117738,0,4,4,65,26,7,98,192,26,316
2117739,10,4,14,39,28,0,67,135,4,206
2117740,27,5,32,89,61,3,153,341,22,516
2117741,79,0,79,58,10,0,68,328,95,491
2117742,13,6,19,97,56,0,153,283,35,471
2117743,11,0,11,71,13,0,84,195,16,295
2117744,6,0,6,33,33,4,70,151,14,235
2117745,9,0,9,118,25,17,160,213,28,401
2117746,13,3,16,66,28,3,97,166,29,292
2117747,13,6,19,33,23,3,59,195,9,263
2117748,5,0,5,75,18,6,99,117,17,233
2117749,5,5,10,73,40,6,119,216,39,374
2117750,6,0,9,50,38,0,88,138,10,236
2117751,3,3,6,52,12,0,64,130,22,216
2117752,11,7,18,91,47,7,145,324,57,526
2117753,6,3,9,50,31,3,84,160,22,266
2117754,0,0,0,49,19,0,68,86,3,157
2117755,3,3,9,26,18,6,50,131,9,190
2117801,6,0,6,41,15,3,59,132,19,210
2117802,6,3,9,43,12,3,58,115,6,179
2117803,10,3,13,86,11,5,102,175,32,309
2117804,5,0,5,101,14,9,124,177,22,323
2117805,7,0,10,97,31,0,128,282,31,441
2117806,4,0,4,60,22,0,82,158,12,252
2117807,10,0,14,53,15,3,71,119,12,202
2117808,7,6,13,53,9,0,62,162,18,242
2117809,8,0,8,47,27,3,77,184,21,282
2117810,12,0,12,60,19,0,79,154,15,248
2117811,4,4,8,37,26,3,66,167,14,247
2117812,8,3,11,61,15,0,76,155,15,246
2117813,4,3,7,64,0,0,64,140,27,231
2117814,7,0,7,68,12,0,80,160,17,257
2117815,13,0,13,93,17,3,113,323,40,476
2117816,5,0,5,51,10,0,61,120,3,184
2117817,32,0,32,55,27,0,82,324,37,443
2117818,47,42,92,63,26,3,92,319,81,492
2117819,3,0,3,55,18,0,73,148,21,242
2117820,7,0,7,65,26,0,91,141,18,250
2117821,6,0,6,40,14,0,54,178,13,245
2117822,6,0,6,41,16,3,60,166,16,242
2117823,13,0,13,50,32,6,88,157,3,248
2117824,16,6,22,39,27,0,66,259,23,348
2117825,13,3,16,55,32,0,87,210,36,333
2117826,23,8,31,69,33,0,102,251,29,382
2117827,17,0,17,86,52,6,144,232,31,407
2117828,12,6,18,88,27,0,115,288,30,433
2117829,9,3,15,105,16,6,127,290,31,448
2117830,9,0,9,53,10,0,63,124,21,208
2117831,16,0,16,81,24,6,111,284,37,432
2117832,4,0,4,39,32,3,74,158,8,240
2117833,6,6,12,86,35,4,125,306,34,465
2117834,0,0,0,78,26,3,107,250,12,369
2117835,8,0,8,104,26,4,134,219,5,358
2117836,5,0,5,87,31,3,121,244,21,386
2117837,11,0,11,64,16,0,80,223,13,316
2117838,6,0,6,79,18,6,103,236,29,368
2117839,5,3,8,81,50,11,142,233,24,399
2117840,13,5,18,56,31,0,87,235,27,349
2117841,15,0,15,38,13,0,51,123,5,179
2117842,85,0,85,44,27,0,71,245,23,339
2117843,52,12,64,23,18,3,44,215,32,291
2117901,9,0,9,67,14,0,81,238,32,351
2117902,4,0,4,45,15,3,63,118,15,196
2117903,7,0,7,54,25,0,79,125,6,210
2117904,9,7,16,80,19,3,102,233,29,364
2117905,16,8,24,68,18,0,86,191,36,313
2117906,20,3,23,92,23,0,115,274,26,415
2117907,9,4,13,48,19,0,67,223,29,319
2117908,4,0,4,94,16,3,113,175,26,314
2117909,3,6,9,114,26,0,140,189,43,372
2117910,9,0,9,68,19,0,87,310,30,427
2117911,13,4,17,77,18,4,99,257,24,380
2117912,3,3,6,22,6,0,28,85,107,220
2117913,5,3,8,64,12,3,79,134,9,222
2117914,7,0,7,75,27,4,106,221,18,345
2117915,13,4,17,89,30,9,128,313,30,471
2117916,7,0,10,94,32,0,126,251,11,388
2117917,9,3,12,43,16,0,59,199,18,276
2117918,40,20,60,42,29,0,71,243,42,356
2117919,30,0,30,48,20,0,68,229,9,306
2117920,7,0,7,44,21,0,65,207,16,288
2117921,0,0,0,30,9,0,39,60,6,105
2117922,0,0,0,38,8,0,46,161,15,222
2117923,5,0,5,55,22,0,77,377,60,514
2117924,0,0,0,42,12,0,54,106,31,191
2117925,7,3,10,51,27,6,84,166,84,334
2117926,8,3,11,66,25,3,94,242,60,396
2117927,0,0,0,68,10,3,81,174,3,258
2117928,4,0,4,39,16,5,60,132,3,195
2118001,6,0,6,63,13,0,76,148,18,242
2118002,8,3,11,33,22,6,61,174,28,263
2118003,3,3,6,50,23,3,76,284,18,378
2118004,3,0,3,82,19,3,104,342,38,484
2118005,0,0,0,48,24,3,75,198,15,288
2118006,4,0,4,47,13,4,64,220,31,315
2118007,6,0,6,90,14,6,110,316,31,457
2118008,4,0,4,51,19,3,73,184,10,267
2118009,11,0,11,66,26,6,98,160,8,266
2118010,9,0,9,70,19,6,95,210,6,311
2118011,6,0,6,62,13,0,75,227,38,340
2118012,7,0,7,89,19,6,114,230,18,362
2118013,3,0,6,130,27,3,160,240,15,415
2118014,4,3,7,91,19,0,110,333,27,470
2118015,35,0,35,43,9,6,58,192,0,250
2118016,9,0,9,90,33,0,123,240,13,376
2118017,3,4,7,63,12,4,79,198,35,312
2118101,13,6,19,144,34,6,184,281,24,489
2118102,10,0,10,78,24,0,102,221,15,338
2118103,14,0,14,69,15,6,90,195,7,292
2118104,3,3,6,69,16,8,93,181,15,289
2118105,0,0,0,54,16,0,70,117,3,190
2118106,18,3,21,109,40,7,156,282,31,469
2118107,5,0,5,40,16,4,60,350,14,424
2118108,27,3,30,41,9,0,50,254,33,337
2118109,4,3,7,49,11,3,63,201,17,281
2118110,3,0,3,73,25,5,103,278,15,396
2118111,11,0,11,100,19,6,125,380,21,526
2118112,9,3,12,64,26,6,96,225,21,342
2118113,6,0,6,101,18,8,127,179,12,318
2118114,3,0,3,90,19,0,109,206,3,318
2118115,3,0,3,46,24,3,73,228,6,307
2118116,4,0,4,94,15,0,109,280,25,414
2118117,3,0,3,46,17,0,63,315,26,404
2118118,3,3,6,92,16,13,121,274,30,425
2118119,24,8,32,63,18,4,85,166,24,275
2118120,0,0,0,44,21,3,68,206,0,274
2118201,7,0,7,121,22,0,143,236,18,397
2118202,6,5,11,84,21,0,105,208,13,326
2118203,9,3,12,89,26,0,115,430,38,583
2118204,5,0,5,84,13,0,97,534,65,696
2118205,3,3,6,45,0,6,51,147,26,224
2118206,7,0,7,52,15,6,73,188,37,298
2118207,5,0,5,76,13,0,89,476,22,587
2118208,0,0,0,56,20,0,76,236,23,335
2118209,8,0,8,40,0,0,40,211,30,281
2118210,0,0,0,43,23,0,66,179,21,266
2118211,6,0,6,34,9,0,43,193,36,272
2118212,6,0,6,47,8,3,58,246,57,361
2118213,9,4,13,50,34,0,84,268,26,378
2118214,8,0,8,60,14,0,74,315,21,410
2118215,3,0,3,83,19,6,108,157,18,283
2118216,5,0,5,41,31,0,72,281,18,371
2118217,3,4,7,64,14,3,81,197,17,295
2118218,6,0,6,39,15,0,54,274,25,353
2118219,6,0,6,116,22,5,143,341,43,527
2118220,4,0,4,111,17,11,139,232,14,385
2118221,11,6,17,95,30,0,125,277,14,416
2118222,6,0,6,78,21,3,102,197,3,302
2118223,9,0,9,78,17,0,95,174,9,278
2118224,8,0,8,107,25,14,146,315,5,466
2118225,14,3,17,121,19,9,149,364,21,534
2118226,7,6,13,117,20,9,146,259,18,423
2118227,0,0,0,48,12,0,60,253,6,319
2118301,0,0,0,62,24,0,86,162,10,258
2118302,0,0,0,84,15,5,104,157,20,281
2118303,0,0,0,37,12,3,52,113,9,174
2118304,6,3,9,130,25,0,155,220,27,402
2118305,0,0,0,164,40,0,204,388,24,616
2118306,0,0,0,197,34,6,237,341,20,598
2118307,3,0,3,76,17,6,99,245,12,356
2118308,0,0,0,53,18,4,75,134,15,224
2118309,0,0,0,55,17,0,72,119,9,200
2118310,3,0,3,103,29,3,135,250,26,411
2118311,0,0,0,91,18,0,109,165,10,284
2118312,6,0,6,128,26,7,161,305,38,504
2118313,0,0,0,90,14,3,107,226,20,353
2118314,21,6,27,108,77,9,194,429,42,665
2118315,0,0,0,99,21,10,130,185,11,326
2118316,0,0,0,0,0,0,0,0,0,0
2118317,0,0,0,0,0,0,0,0,0,0
2118318,3,0,3,88,27,0,115,156,23,294
2118319,3,0,3,109,23,0,132,220,24,376
2118320,0,0,0,0,0,0,0,0,0,0
2118321,0,0,0,95,22,0,117,255,18,390
2118401,0,0,0,0,0,0,0,6,3,9
2118501,15,3,18,64,27,0,91,213,35,339
2118502,0,0,0,49,14,0,63,142,11,216
2118503,0,0,0,55,19,4,78,158,12,248
2118504,4,3,7,104,36,6,146,249,30,425
2118505,3,0,3,44,15,6,65,142,19,226
2118506,0,0,0,98,32,0,130,285,39,454
2118507,0,0,5,81,5,0,86,187,7,280
2118508,3,0,3,57,23,3,83,264,19,366
2118509,6,0,6,83,50,8,141,314,32,487
2118510,4,3,7,91,33,9,133,213,22,368
2118511,9,0,9,43,33,0,76,176,32,284
2118512,3,3,6,68,29,10,107,188,37,332
2118513,12,4,16,33,15,0,48,167,22,237
2118514,0,0,0,35,12,0,47,133,21,201
2118515,6,0,6,95,36,0,131,328,40,499
2118516,3,0,3,87,22,0,109,221,15,345
2118517,0,0,0,88,24,7,119,197,31,347
2118518,0,0,0,61,19,6,86,143,15,244
2118519,0,0,0,0,0,0,0,0,0,0
2118520,5,0,5,68,43,0,111,315,25,451
2118521,3,0,3,53,17,0,70,156,24,250
2118522,3,0,3,41,23,0,64,132,15,211
2118523,27,6,33,41,13,6,60,162,37,259
2118524,3,3,6,83,59,0,142,405,52,599
2118525,9,3,12,49,24,3,76,255,40,371
2118526,6,5,11,49,35,3,87,218,38,343
2118527,0,0,0,72,18,0,90,126,11,227
2118528,65,14,79,0,6,0,6,188,37,231
2118529,4,0,4,63,16,3,82,143,15,240
2118530,3,0,3,57,5,0,62,99,9,170
2118601,3,0,3,52,36,4,92,196,12,300
2118602,0,0,0,0,0,0,0,0,0,0
2118603,6,3,9,92,24,9,125,194,24,343
2118604,6,5,11,97,32,6,135,317,28,480
2118605,21,7,28,51,24,0,75,288,26,389
2118606,0,0,0,78,27,3,108,182,18,308
2118607,6,6,12,54,27,0,81,175,27,283
2118608,45,3,48,36,16,10,62,244,26,332
2118609,73,3,76,32,9,5,46,252,12,310
2118610,8,3,11,78,27,7,112,303,48,463
2118611,9,7,16,58,13,0,71,160,11,242
2118612,7,3,10,65,23,9,97,220,36,353
2118613,14,3,17,65,30,3,98,262,39,399
2118614,4,0,4,45,7,0,52,105,12,169
2118615,8,4,12,36,19,0,55,161,49,265
2118616,5,0,5,52,27,0,79,256,83,418
2118617,13,4,17,70,27,0,97,259,28,384
2118618,4,3,7,89,31,3,123,273,31,427
2118619,7,4,11,44,17,7,68,232,22,322
2118620,7,3,10,86,32,3,121,202,21,344
2118621,3,27,30,94,26,4,124,257,91,472
2118622,5,0,5,72,15,3,90,252,37,379
2118623,5,0,5,79,35,4,118,359,26,503
2118624,3,3,6,48,20,0,68,170,27,265
2118625,8,3,11,71,17,0,88,301,29,418
2118626,70,0,70,76,28,3,107,361,30,498
2118627,8,0,8,65,13,0,78,241,31,350
2118628,7,3,10,55,24,0,79,274,22,375
2118629,6,0,6,70,24,6,100,214,33,347
2118630,9,7,16,65,26,0,91,326,40,457
2118631,20,3,23,58,25,3,86,315,28,429
2118701,0,4,4,126,30,3,159,291,26,476
2118702,4,0,4,45,9,6,60,87,3,150
2118703,0,0,0,85,21,6,112,272,15,399
2118704,6,0,6,101,21,0,122,301,36,459
2118705,0,0,0,42,0,0,42,106,6,154
2118706,3,0,3,51,16,3,70,170,18,258
2118707,4,0,4,50,17,0,67,137,24,228
2118708,0,0,0,101,18,9,128,276,21,425
2118709,3,0,3,103,30,0,133,274,33,440
2118710,4,0,4,71,32,3,106,215,15,336
2118711,0,0,0,97,26,6,129,215,21,365
2118712,0,0,0,75,9,0,84,152,9,245
2118713,4,0,4,18,3,0,21,147,11,179
2118801,4,0,4,69,27,6,102,157,16,275
2118802,35,9,44,73,20,0,93,230,22,345
2118803,6,0,9,75,52,3,130,303,37,470
2118804,6,0,6,103,21,7,131,257,21,409
2118805,6,0,6,144,38,8,190,271,12,473
2118806,0,0,0,59,12,0,71,191,18,280
2118807,12,4,16,55,21,6,82,175,16,273
2118808,9,0,9,88,29,6,123,237,41,401
2118809,11,0,14,96,26,10,132,269,27,428
2118810,11,3,14,68,26,6,100,240,25,365
2118811,14,0,14,74,17,3,94,291,30,415
2118812,0,3,3,48,16,6,70,230,21,321
2118813,19,3,22,56,26,3,85,287,42,414
2118814,12,6,18,106,25,3,134,305,27,466
2118815,0,0,0,54,23,0,77,114,10,201
2118816,0,0,3,102,53,3,158,318,31,507
2118817,9,0,9,81,33,0,114,268,23,405
2118818,61,6,70,45,34,0,79,220,33,332
2118819,13,4,17,104,35,3,142,283,32,457
2118820,26,12,38,37,16,0,53,196,22,271
2118821,9,4,13,85,31,6,122,250,31,403
2118822,7,0,7,91,34,0,125,209,13,347
2118823,8,3,11,76,33,0,109,273,31,413
2118824,8,5,13,46,35,0,81,208,32,321
2118825,7,0,7,73,12,0,85,225,26,336
2118826,4,3,7,29,10,0,39,128,15,182
2118827,6,0,6,49,17,4,70,159,5,234
2118828,0,3,3,56,25,0,81,172,24,277
2118829,58,24,82,100,43,0,143,333,58,534
2118830,72,6,78,39,22,9,70,257,43,370
2118831,7,7,14,42,18,0,60,230,29,319
2118832,7,0,10,95,18,3,116,252,22,390
2118833,8,3,11,34,9,3,46,149,18,213
2118834,10,7,17,43,23,3,69,238,30,337
2118835,15,0,15,56,17,6,79,185,26,290
2118836,23,7,30,97,28,6,131,302,42,475
2118837,15,0,15,97,45,4,146,328,21,495
2118838,6,3,9,55,15,9,79,173,9,261
2118839,6,0,6,63,9,0,72,152,11,235
2118840,13,3,16,95,18,3,116,191,20,327
2118841,3,0,3,56,10,3,69,256,22,347
2118842,11,0,11,68,18,0,86,185,8,279
2118843,8,26,34,40,30,0,70,197,66,333
2118844,7,0,7,42,13,0,55,134,9,198
2118845,0,0,0,40,22,0,62,168,6,236
2118846,8,0,8,35,25,0,60,151,16,227
2118847,13,0,13,72,17,0,89,222,22,333
2118848,16,0,16,65,15,3,83,174,12,269
2118849,3,0,3,40,10,0,50,117,12,179
2118850,5,4,9,41,12,3,56,156,18,230
2118901,10,3,13,109,41,4,154,274,33,461
2118902,0,0,4,99,36,8,143,284,12,439
2118903,7,3,10,54,25,3,82,212,44,338
2118904,6,0,6,121,24,8,153,193,25,371
2118905,6,0,6,45,36,0,81,211,7,299
2118906,5,5,10,64,33,6,103,264,17,384
2118907,73,5,78,103,15,11,129,341,31,501
2118908,5,0,5,66,22,0,88,167,13,268
2118909,6,3,9,55,21,9,85,209,13,307
2118910,4,5,9,92,19,3,114,231,13,358
2118911,0,0,0,83,18,0,101,127,17,245
2118912,12,0,12,109,19,7,135,274,28,437
2118913,7,3,10,67,33,0,100,298,52,450
2118914,0,0,0,65,13,3,81,144,0,225
2118915,12,0,12,64,42,0,106,204,10,320
2118916,0,3,3,49,19,3,71,190,21,282
2118917,9,0,9,106,21,13,140,187,21,348
2118918,6,0,6,41,19,0,60,143,12,215
2118919,6,0,6,60,24,6,90,209,16,315
2118920,7,6,16,132,34,6,172,272,24,468
2118921,4,0,4,74,22,7,103,175,11,289
2118922,6,0,6,53,23,5,81,132,4,217
2118923,0,0,0,51,21,3,75,124,3,202
2118924,0,0,0,86,15,3,104,113,14,231
2118925,3,3,6,76,18,3,97,129,6,232
2118926,7,0,7,118,38,6,162,259,8,429
2118927,3,0,3,37,14,6,57,178,31,266
2118928,3,0,3,64,20,4,88,120,12,220
2118929,6,6,12,59,29,3,91,167,12,270
2118930,5,0,5,61,24,3,88,166,6,260
2119001,44,4,48,34,16,3,53,222,13,288
2119002,6,0,6,63,14,6,83,199,12,294
2119003,0,3,3,35,16,3,54,149,21,224
2119004,7,0,7,39,20,0,59,194,14,267
2119005,6,4,10,41,18,3,62,170,17,249
2119006,0,0,0,64,20,0,84,227,15,326
2119007,6,0,6,44,19,3,66,193,18,277
2119008,36,3,39,55,20,7,82,238,29,349
2119009,8,0,8,50,12,6,68,165,22,255
2119010,8,4,12,75,19,6,100,232,21,353
2119011,19,10,29,56,24,3,83,312,56,451
2119012,6,0,6,43,12,6,61,155,12,228
2119013,3,0,3,40,18,0,58,153,22,233
2119014,16,3,19,80,45,9,134,349,42,525
2119015,0,0,0,0,0,0,0,3,3,6
2119016,5,0,5,58,21,0,79,180,21,280
2119017,8,3,11,56,40,3,99,190,15,304
2119018,6,0,6,50,25,6,81,189,17,287
2119019,9,0,9,39,37,3,79,286,18,383
2119020,3,0,3,34,23,0,57,136,18,211
2119021,5,0,5,56,21,4,81,143,21,245
2119022,7,3,10,84,33,3,120,210,34,364
2119023,36,3,39,48,26,6,80,293,27,400
2119024,3,0,3,55,35,0,90,233,19,342
2119025,9,0,9,68,18,3,89,191,36,316
2119026,5,0,5,44,26,0,70,193,23,286
2119027,29,0,29,53,20,3,76,211,19,306
2119028,6,0,6,52,25,0,77,223,8,308
2119029,7,0,7,30,20,0,50,162,6,218
2119030,5,0,5,57,32,0,89,189,21,299
2119031,10,0,10,53,24,0,77,166,9,252
2119032,0,0,0,46,15,3,64,139,4,207
2119033,13,3,16,71,49,7,127,266,12,405
2119034,5,3,8,19,4,3,26,120,6,152
2119101,0,0,0,98,18,7,123,127,18,268
2119102,0,0,0,32,5,0,37,129,16,182
2119103,19,10,29,4,0,0,4,84,27,115
2119104,0,0,0,91,18,6,115,129,9,253
2119105,0,0,0,172,23,6,201,229,35,465
2119106,7,0,7,36,6,3,45,140,8,193
2119107,16,0,16,81,25,3,109,224,21,354
2119108,10,0,10,53,4,4,61,201,12,274
2119109,8,3,11,76,34,3,113,266,49,428
2119110,7,0,7,70,20,6,96,223,24,343
2119111,4,3,11,72,10,5,87,229,32,348
2119112,6,0,6,51,16,0,67,214,18,299
2119113,13,6,19,51,30,0,81,307,33,421
2119114,0,6,6,45,11,0,56,149,12,217
2119115,10,6,16,111,26,9,146,301,24,471
2119116,5,5,10,97,25,0,122,247,33,402
2119117,3,0,3,29,6,3,38,132,27,197
2119118,6,0,6,34,24,0,58,150,9,217
2119119,0,0,0,0,0,0,0,13,0,13
2119120,8,3,11,57,22,5,84,188,14,286
2119121,6,0,6,78,18,5,101,135,20,256
2119122,0,0,0,97,12,0,109,132,20,261
2119123,6,3,9,49,10,0,59,134,18,211
2119201,0,0,0,0,0,0,0,0,0,0
2119301,9,0,9,55,16,4,75,156,21,252
2119302,7,0,7,78,22,11,111,168,17,296
2119303,3,0,3,47,14,0,61,158,12,231
2119304,6,0,6,119,20,6,145,260,19,424
2119305,6,0,6,81,22,3,106,200,22,328
2119306,0,0,0,0,0,0,0,11,0,11
2119307,7,3,10,56,8,0,64,204,32,300
2119308,6,0,6,91,11,14,116,162,10,288
2119309,6,4,10,76,16,0,92,262,25,379
2119310,14,0,14,82,39,0,121,226,13,360
2119311,0,9,9,45,12,0,57,223,34,314
2119312,9,0,9,92,18,0,110,190,14,314
2119313,6,0,6,75,21,6,102,223,36,361
2119314,13,3,16,79,41,7,127,310,38,475
2119315,9,0,9,51,22,3,76,160,12,248
2119316,4,0,4,91,29,10,130,227,11,368
2119317,12,0,12,73,16,0,89,210,18,317
2119318,75,0,75,101,20,0,121,314,45,480
2119319,0,6,6,62,18,0,80,181,12,273
2119320,10,0,13,90,22,0,112,230,24,366
2119321,11,3,14,65,25,6,96,258,35,389
2119322,26,0,26,46,18,0,64,221,10,295
2119323,3,3,6,53,8,0,61,157,18,236
2119324,23,3,26,81,32,0,113,323,33,469
2119325,0,0,0,174,33,0,207,215,11,433
2119326,0,0,0,172,24,5,201,192,14,407
2119327,0,0,0,94,32,0,126,351,47,524
2119328,8,0,8,98,21,0,119,174,24,317
2119329,10,0,10,66,28,3,97,228,14,339
2119330,8,0,8,73,25,0,98,288,31,417
2119331,10,0,10,58,31,8,97,212,24,333
2119332,12,7,19,68,24,0,92,266,51,409
2119333,44,0,44,61,27,4,92,286,18,396
2119334,7,0,7,60,34,3,97,262,13,372
2119335,16,0,16,93,38,3,134,326,36,496
2119336,16,0,16,74,39,0,113,327,28,468
2119337,8,0,8,74,27,3,104,173,15,292
2119338,12,0,12,49,29,4,82,287,24,393
2119339,16,3,19,80,38,0,118,234,20,372
2119340,11,0,11,90,24,6,120,198,6,324
2119341,0,0,0,61,15,5,81,160,14,255
2119342,4,0,4,127,24,8,159,235,25,419
2119343,9,0,9,111,20,7,138,217,21,376
2119401,9,0,9,72,38,4,114,211,11,336
2119402,11,4,15,67,20,5,92,354,22,468
2119403,3,0,3,41,21,0,62,284,23,369
2119404,50,45,95,32,22,0,54,309,87,450
2119405,6,0,6,30,16,6,52,288,21,361
2119406,4,0,4,26,10,3,39,184,26,249
2119407,3,3,6,45,6,3,54,131,24,209
2119408,0,3,3,48,16,6,70,163,18,251
2119409,6,0,6,72,9,3,84,182,15,281
2119410,6,0,6,46,14,0,60,240,34,334
2119411,8,0,8,65,19,0,84,378,66,528
2119412,9,3,12,53,26,0,79,166,9,254
2119413,3,3,6,68,25,0,93,194,18,305
2119414,8,0,8,51,15,0,66,165,18,249
2119415,7,0,7,61,17,9,87,232,12,331
2119416,18,3,21,69,16,3,88,243,21,352
2119417,6,0,6,42,45,3,90,235,15,340
2119418,10,0,10,62,24,0,86,184,22,292
2119419,0,0,0,53,26,0,79,460,58,597
2119420,0,0,0,44,24,0,68,114,18,200
2119421,5,3,8,50,31,0,81,189,21,291
2119422,14,3,17,84,43,0,127,283,45,455
2119423,5,0,5,74,20,6,100,208,43,351
2119424,0,0,0,53,31,3,87,282,23,392
2119425,14,0,14,96,22,4,122,328,17,467
2119426,6,0,6,93,6,0,99,252,18,369
2119427,0,0,0,58,12,0,70,106,9,185
2119428,12,0,12,69,18,0,87,155,6,248
2119429,50,8,58,18,11,0,29,231,22,282
2119430,4,0,7,53,24,6,83,163,10,256
2119431,15,3,18,66,34,3,103,295,43,441
2119432,6,0,6,71,20,3,94,211,15,320
2119433,8,0,8,63,19,0,82,164,9,255
2119434,3,3,6,98,27,4,129,209,21,359
2119435,3,0,3,47,31,0,78,245,24,347
2119436,0,3,3,78,30,0,108,183,36,327
2119437,3,0,3,40,21,0,61,91,6,158
2119438,28,17,45,63,45,0,108,303,50,461
2119439,6,3,9,63,21,3,87,167,24,278
2119440,5,0,5,80,24,0,104,332,28,464
2119441,7,0,7,47,12,3,62,144,7,213
2119442,4,0,4,54,34,3,91,197,6,294
2119443,12,0,12,115,27,6,148,381,27,556
2119444,8,0,11,75,28,6,109,199,21,329
2119445,0,0,0,26,9,0,35,179,32,246
2119446,8,0,8,72,26,0,98,171,9,278
2119447,7,3,10,18,19,0,37,192,18,247
2119448,3,0,3,35,21,0,56,160,18,234
2119449,4,0,4,79,26,0,105,176,5,286
2119501,8,4,12,95,22,0,117,256,18,391
2119502,15,0,15,56,16,3,75,203,9,287
2119503,4,3,7,33,29,3,65,136,9,210
2119504,3,0,3,77,20,4,101,222,12,335
2119505,4,3,7,104,36,6,146,279,15,440
2119506,6,0,6,65,11,6,82,205,7,294
2119507,5,0,5,96,26,12,134,273,21,428
2119508,3,0,3,61,13,3,77,165,19,261
2119509,5,3,11,90,35,7,132,216,16,364
2119510,11,0,11,102,27,9,138,238,3,379
2119511,13,0,13,104,25,7,136,243,24,403
2119512,5,0,5,98,20,3,121,170,13,304
2119513,6,3,9,119,45,6,170,311,21,502
2119514,6,0,6,95,24,9,128,312,23,463
2119515,0,3,3,53,27,0,80,434,31,545
2119516,3,0,3,58,15,0,73,383,15,471
2119517,6,21,27,56,18,0,74,137,27,238
2119518,6,0,6,93,23,0,116,244,26,386
2119519,3,0,3,55,22,3,80,200,16,296
2119520,6,0,6,125,35,4,164,298,38,500
2119521,6,3,9,74,18,0,92,225,28,345
2119522,10,0,10,68,23,3,94,252,20,366
2119523,3,0,3,46,12,3,61,185,3,249
2119524,10,4,14,70,16,0,86,204,24,314
2119525,0,0,0,52,12,0,64,155,32,251
2119526,4,0,4,52,18,4,74,216,13,303
2119527,3,3,6,32,17,3,52,239,16,307
2119528,6,0,6,39,12,3,54,167,22,243
2119529,4,0,4,46,23,0,69,161,3,233
2119530,0,3,3,102,10,0,112,229,18,359
2119531,15,6,21,78,29,0,107,197,24,328
2119532,3,0,3,51,27,6,84,216,8,308
2119533,33,3,40,109,28,4,141,299,28,468
2119534,9,15,24,84,30,3,117,208,47,372
2119535,4,0,4,40,21,0,61,348,24,433
2119536,14,3,17,55,14,6,75,226,24,325
2119537,21,3,24,60,20,3,83,289,39,411
2119538,11,3,14,12,9,0,21,261,34,316
2119539,10,0,10,59,15,3,77,144,12,233
2119540,23,3,26,68,23,6,97,300,35,432
2119541,6,3,9,72,14,5,91,211,18,320
2119542,3,0,3,84,10,4,98,196,11,305
2119543,10,0,10,68,24,7,99,237,4,340
2119544,9,0,9,86,19,7,112,243,18,373
2119545,3,0,6,51,18,0,69,99,11,179
2119546,0,0,0,42,6,0,48,167,15,230
2119547,3,0,3,24,11,3,38,73,9,120
2119548,3,0,3,59,5,4,68,107,0,175
2119549,10,0,10,33,20,3,56,137,9,202
2119601,9,0,9,71,32,4,107,241,28,376
2119602,3,3,6,62,28,6,96,208,18,322
2119603,0,0,0,37,18,3,58,123,15,196
2119604,5,4,9,49,32,3,84,222,22,328
2119605,7,3,10,59,27,3,89,325,24,438
2119606,6,6,12,66,41,0,107,238,27,372
2119607,12,3,15,44,31,0,75,302,30,407
2119608,0,6,6,66,46,3,115,286,18,419
2119609,5,0,5,34,52,0,86,204,15,305
2119610,0,0,0,58,52,0,110,217,13,340
2119611,6,0,6,247,25,3,275,423,14,712
2119612,6,0,6,110,26,0,136,286,13,435
2119613,35,14,49,76,21,0,97,334,50,481
2119614,0,0,0,60,18,9,87,160,10,257
2119615,9,0,9,43,25,9,77,232,38,347
2119616,6,0,6,46,19,0,65,232,15,312
2119617,7,0,7,61,36,3,100,330,26,456
2119618,0,0,0,32,18,3,53,269,25,347
2119619,6,3,9,47,30,3,80,215,15,310
2119620,3,3,6,31,19,3,53,149,22,224
2119621,0,0,0,51,48,0,99,144,7,250
2119622,0,6,6,49,21,0,70,194,25,289
2119701,7,0,7,92,49,0,141,277,25,443
2119702,6,0,6,68,24,6,98,197,7,302
2119703,4,0,4,81,42,6,129,317,3,449
2119704,11,0,11,89,51,0,140,260,12,412
2119705,4,6,10,118,49,8,175,301,27,503
2119706,35,0,35,82,27,9,118,252,22,392
2119707,6,0,6,51,20,6,77,194,16,287
2119708,6,0,6,52,22,3,77,118,9,204
2119709,3,3,6,77,19,6,102,146,9,257
2119710,5,0,5,71,44,7,122,249,20,391
2119711,4,0,4,74,24,0,98,177,19,294
2119712,3,0,3,82,23,0,105,168,15,288
2119713,3,0,3,53,25,0,78,204,9,291
2119714,0,3,3,93,22,3,118,153,34,305
2119715,0,6,6,86,59,4,149,324,33,506
2119716,0,0,0,37,24,0,61,142,21,224
2119717,0,0,0,43,29,7,79,194,9,282
2119718,3,0,3,58,21,3,82,199,9,290
2119719,0,0,0,60,28,6,94,197,12,303
2119720,79,6,85,35,21,4,60,312,27,399
2119721,4,0,4,55,29,6,90,226,8,324
2119722,3,0,3,72,20,0,92,195,12,299
2119723,0,0,0,80,47,3,130,246,0,376
2119724,0,0,0,101,18,0,119,247,7,373
2119725,0,0,0,80,30,7,117,252,8,377
2119726,3,3,6,82,30,0,112,205,15,332
2119727,0,0,0,65,28,3,96,177,9,282
2119728,4,0,4,49,22,3,74,175,27,276
2119729,0,3,3,70,20,0,90,195,18,303
2119730,0,3,3,73,28,7,108,237,33,378
2119731,39,3,42,61,31,0,92,237,16,345
2119732,0,0,0,63,18,6,87,149,15,251
2119733,0,0,0,59,27,0,86,170,0,256
2119734,3,0,3,41,17,10,68,181,3,252
2119735,0,0,0,58,10,3,71,189,9,269
2119736,3,0,3,47,14,3,64,138,6,208
2119737,0,0,0,48,17,6,71,163,5,239
2119738,3,0,3,43,12,6,61,132,3,196
2119739,10,5,15,49,31,7,87,231,29,347
2119740,11,3,14,98,25,0,123,265,29,417
2119741,47,0,47,38,16,0,54,245,14,313
2119742,4,0,4,45,24,6,75,113,9,197
2119743,6,7,13,81,23,0,104,224,41,369
2119744,0,0,0,62,27,6,95,175,15,285
2119745,0,3,3,69,31,9,109,149,18,276
2119746,3,0,3,67,16,0,83,181,9,273
2119747,5,0,5,70,21,9,100,165,4,269
2119748,0,0,0,31,21,6,58,129,9,196
2119749,4,0,4,38,31,0,69,216,28,313
2119750,10,3,13,71,24,0,95,206,21,322
2119751,6,0,6,71,30,6,107,185,12,304
2119752,0,0,0,30,23,0,53,137,9,199
2119753,0,0,0,45,25,6,76,199,0,275
2119801,12,0,15,66,15,0,81,215,12,308
2119802,8,3,11,39,17,3,59,160,24,243
2119803,27,3,30,77,27,3,107,354,34,495
2119804,3,3,6,47,24,3,74,214,26,314
2119805,0,0,0,42,6,0,48,146,16,210
2119806,7,6,13,67,23,6,96,202,23,321
2119807,15,5,20,80,28,4,112,287,29,428
2119808,14,0,14,85,48,18,151,296,16,463
2119809,6,3,9,44,22,3,69,150,6,225
2119810,6,3,9,85,21,6,112,379,69,560
2119811,12,0,12,70,44,0,114,209,15,338
2119812,6,6,12,53,14,6,73,110,21,204
2119813,23,3,26,77,27,12,116,236,12,364
2119814,3,6,12,82,24,3,109,250,30,389
2119815,64,17,81,36,27,6,69,259,44,372
2119816,3,0,3,63,41,9,113,168,3,284
2119817,18,0,18,80,9,3,92,197,6,295
2119818,7,3,10,92,21,0,113,235,18,366
2119819,8,0,8,59,34,3,96,197,7,300
2119820,16,3,19,43,31,3,77,253,15,345
2119821,12,3,15,91,23,5,119,212,25,356
2119822,69,4,73,71,16,0,87,281,13,381
2119823,4,0,7,98,30,3,131,233,21,385
2119824,9,6,15,52,36,0,88,231,27,346
2119825,8,0,8,65,44,0,109,215,13,337
2119826,12,5,17,87,16,0,103,242,42,387
2119827,19,0,19,82,23,12,117,292,51,460
2119828,9,3,12,89,27,7,123,224,27,374
2119829,0,0,0,68,23,0,91,226,13,330
2119830,8,4,12,64,15,0,79,184,8,271
2119831,15,0,15,40,12,0,52,124,9,185
2119832,9,0,9,87,38,6,131,238,13,382
2119833,7,0,7,46,24,0,70,165,9,244
2119901,3,4,7,100,21,7,128,241,54,423
2119902,3,4,7,51,22,0,73,271,38,382
2119903,3,4,7,46,15,0,61,181,37,279
2119904,3,3,6,53,12,0,65,247,44,356
2119905,14,5,19,63,9,3,75,319,66,460
2119906,0,0,0,0,0,0,0,4,0,4
2119907,12,0,12,77,12,0,89,284,39,412
2119908,29,5,34,59,14,0,73,201,39,313
2119909,8,0,8,48,8,0,56,224,57,337
2119910,3,0,3,38,24,9,71,241,25,337
2119911,10,4,14,82,18,0,100,359,26,485
2119912,3,3,6,50,23,6,79,199,31,309
2119913,7,0,7,77,27,3,107,295,51,453
2119914,0,3,3,64,29,3,96,265,39,400
2119915,7,0,7,45,13,0,58,210,16,284
2119916,7,0,7,63,34,0,97,321,39,457
2119917,82,0,82,26,6,3,35,204,16,255
2119918,37,3,40,49,15,0,64,268,24,356
2119919,6,0,6,127,15,3,145,238,34,417
2119920,11,3,14,77,25,3,105,299,38,442
2119921,7,4,11,91,13,0,104,228,21,353
2119922,24,3,27,64,12,0,76,204,27,307
2119923,0,0,0,62,33,0,95,183,31,309
2119924,8,3,11,39,13,0,52,227,22,301
2119925,9,4,13,50,18,4,72,244,19,335
2119926,15,0,15,50,19,3,72,277,26,375
2119927,6,0,6,44,11,3,58,226,25,309
2119928,8,0,8,78,18,0,96,227,24,347
2119929,0,3,3,38,4,0,42,187,25,254
2119930,9,0,9,42,23,0,65,247,11,323
2119931,3,3,6,47,22,0,69,215,37,321
2119932,5,0,5,58,19,0,77,238,57,372
2120001,3,0,3,36,11,0,47,152,10,209
2120002,0,0,0,71,29,6,106,165,21,292
2120003,6,3,9,76,29,5,110,227,12,349
2120004,8,0,8,63,15,0,78,258,3,339
2120005,10,0,13,91,39,3,133,315,15,463
2120006,9,0,9,51,15,3,69,142,16,227
2120007,6,0,6,58,34,0,92,155,16,263
2120008,15,5,23,89,37,0,126,388,42,556
2120009,8,0,8,47,15,3,65,189,21,275
2120010,7,3,10,43,16,0,59,245,26,330
2120011,7,4,11,110,26,6,142,261,13,416
2120012,7,0,7,94,34,0,128,249,25,402
2120013,6,0,6,72,18,0,90,187,10,287
2120014,7,6,13,95,28,6,129,286,30,445
2120015,3,3,6,72,24,0,96,250,23,369
2120016,3,0,3,73,10,0,83,149,15,247
2120017,6,0,6,58,32,3,93,248,20,361
2120018,10,0,10,92,34,5,131,346,35,512
2120019,4,0,4,86,38,5,129,213,38,380
2120020,7,0,7,86,31,6,123,318,30,471
2120021,3,6,12,79,21,0,100,149,21,270
2120022,7,0,7,91,15,3,109,219,17,345
2120023,32,0,32,43,20,0,63,158,16,237
2120024,9,0,9,62,21,5,88,261,22,371
2120025,13,3,16,77,33,0,110,324,14,448
2120026,9,0,9,67,9,7,83,134,9,226
2120101,6,6,12,70,21,0,91,202,24,317
2120102,16,9,25,110,44,0,154,212,28,394
2120103,20,3,23,102,46,10,158,280,15,453
2120104,9,0,9,72,16,3,91,217,15,323
2120105,6,0,6,73,24,5,102,224,6,332
2120106,34,0,34,62,24,6,92,234,15,341
2120107,7,0,7,69,15,3,87,162,9,258
2120108,3,0,3,65,32,0,97,135,9,241
2120109,6,0,6,76,29,0,105,284,14,403
2120110,9,4,13,83,32,0,115,290,19,424
2120111,15,0,15,62,36,3,101,188,19,308
2120112,6,3,9,89,22,7,118,242,12,372
2120113,8,0,8,70,45,0,115,280,12,407
2120114,6,0,6,49,37,8,94,205,19,318
2120115,13,0,13,57,28,4,89,217,18,324
2120116,3,0,3,34,20,0,54,152,26,232
2120117,6,5,11,67,11,5,83,167,15,265
2120118,8,0,8,59,27,0,86,225,20,331
2120119,4,3,7,43,9,3,55,137,12,204
2120201,0,0,0,44,22,5,71,122,3,196
2120202,4,0,4,43,19,0,62,144,4,210
2120203,0,0,0,43,20,5,68,121,13,202
2120204,3,0,3,53,28,0,81,164,4,249
2120205,0,0,0,90,26,3,119,222,9,350
2120206,0,0,0,131,44,6,181,256,15,452
2120207,3,0,3,43,15,0,58,119,3,180
2120208,3,4,7,97,46,0,143,264,20,427
2120209,0,0,0,110,42,0,152,260,13,425
2120210,9,0,9,67,33,4,104,257,19,380
2120211,10,0,10,61,16,6,83,160,6,249
2120212,15,0,15,65,31,0,96,216,24,336
2120213,3,0,3,39,25,3,67,201,6,274
2120214,79,6,85,59,31,4,94,304,14,412
2120215,3,0,3,67,21,3,91,222,20,333
2120216,3,0,3,46,35,0,81,170,9,260
2120217,3,3,6,54,26,6,86,180,12,278
2120218,7,0,7,65,42,3,110,250,18,378
2120219,0,0,0,41,18,3,62,103,15,180
2120220,4,0,4,45,13,3,61,125,9,195
2120221,11,4,15,65,51,3,119,253,25,397
2120222,14,3,17,86,44,4,134,255,27,416
2120223,5,0,5,83,41,3,127,347,33,507
2120224,11,0,11,52,25,4,81,246,13,340
2120225,0,0,0,95,25,0,120,271,0,391
2120226,0,0,0,63,43,3,109,170,12,291
2120227,7,0,7,78,32,7,117,250,24,391
2120228,0,0,0,49,10,7,66,134,9,209
2120229,0,0,0,68,36,0,104,224,18,346
2120230,9,4,13,87,53,7,147,287,12,446
2120231,3,0,3,56,23,4,83,152,16,251
2120232,6,4,10,70,39,3,112,238,17,367
2120233,4,0,4,74,31,0,105,284,24,413
2120234,3,0,3,37,11,5,53,137,0,190
2120235,9,0,9,51,38,0,89,187,13,289
2120236,3,0,3,45,19,3,67,156,12,235
2120237,8,0,8,50,23,0,73,159,8,240
2120238,6,0,6,44,37,0,81,182,16,279
2120239,3,4,7,56,23,6,85,174,10,269
2120240,10,4,14,70,43,5,118,286,13,417
2120241,3,0,3,61,13,3,77,138,9,224
2120301,0,3,3,45,12,0,57,135,18,210
2120302,0,0,0,32,21,6,59,87,15,161
2120303,0,0,0,67,21,0,88,156,9,253
2120304,0,3,3,51,17,3,71,155,18,244
2120305,3,0,3,105,48,0,153,306,30,489
2120306,4,0,4,63,34,0,97,296,13,406
2120307,3,4,7,72,42,0,114,245,26,385
2120308,14,0,14,58,31,6,95,323,15,433
2120309,9,0,9,47,36,6,89,242,13,344
2120310,0,0,0,59,31,3,93,257,18,368
2120311,0,4,4,79,17,0,96,188,31,315
2120312,0,3,3,95,34,0,129,255,27,411
2120313,7,0,7,92,24,9,125,244,15,384
2120314,16,3,19,78,27,0,105,257,27,389
2120315,4,0,4,68,34,0,102,186,27,315
2120316,6,0,6,68,28,0,96,237,12,345
2120317,0,3,3,69,33,0,102,170,25,297
2120318,5,0,5,60,27,0,87,134,15,236
2120319,0,0,0,104,28,9,141,269,15,425
2120320,3,0,3,97,19,3,119,178,8,305
2120321,0,0,0,155,23,15,193,247,21,461
2120322,0,4,4,60,28,4,92,148,13,253
2120323,12,4,16,86,39,0,125,241,27,393
2120324,0,0,0,75,37,6,118,169,26,313
2120325,9,3,12,80,15,5,100,231,21,352
2120326,3,0,3,74,15,0,89,146,21,256
2120327,11,8,19,54,24,3,81,236,23,340
2120328,6,0,6,58,15,6,79,230,11,320
2120329,43,3,46,73,22,3,98,272,24,394
2120330,12,0,16,55,19,3,77,197,9,283
2120331,0,0,0,82,31,8,121,229,21,371
2120332,16,40,56,33,32,6,71,257,73,401
2120333,6,3,9,63,31,3,97,233,17,347
2120334,0,0,0,3,6,0,9,230,86,325
2120335,3,3,6,35,14,0,49,160,26,235
2120336,0,0,0,6,0,0,6,3,0,9
2120337,25,6,31,85,49,0,134,260,19,413
2120338,11,6,17,97,49,3,149,321,20,490
2120339,116,6,122,48,15,0,63,341,13,417
2120340,9,0,9,81,35,9,125,219,9,353
2120341,3,4,7,36,16,9,61,159,10,230
2120342,4,0,4,87,26,6,119,233,4,356
2120343,3,0,3,51,20,3,74,154,12,240
2120344,0,0,0,50,14,0,64,104,0,168
2120345,6,0,6,30,6,0,36,132,15,183
2120346,0,3,3,38,23,3,64,187,3,254
2120401,14,6,20,85,36,8,129,304,39,472
2120402,0,0,0,50,29,4,83,207,8,298
2120403,0,0,0,48,22,0,70,175,7,252
2120404,6,0,6,87,37,0,124,312,17,453
2120405,6,4,10,60,32,3,95,249,52,396
2120406,12,3,15,92,25,9,126,302,21,449
2120407,3,0,3,44,20,7,71,121,9,201
2120408,0,0,0,96,27,3,126,248,29,403
2120409,0,0,0,73,38,4,115,203,18,336
2120410,0,0,0,57,38,4,99,223,18,340
2120411,0,3,3,30,6,0,36,135,12,183
2120412,9,9,18,79,17,3,99,269,34,402
2120413,0,0,0,60,21,10,91,213,0,304
2120414,3,0,3,51,39,0,90,331,14,435
2120415,0,0,0,70,16,4,90,194,8,292
2120416,6,0,6,66,36,6,108,204,18,330
2120417,8,6,14,65,0,0,65,243,23,331
2120418,5,0,5,119,25,0,144,273,33,450
2120419,14,4,18,46,10,6,62,137,10,209
2120420,13,0,13,64,22,4,90,175,17,282
2120421,3,0,3,50,10,3,63,156,17,236
2120422,3,0,3,63,27,9,99,187,11,297
2120501,6,0,6,79,20,0,99,282,23,404
2120502,0,0,0,80,18,0,98,124,9,231
2120503,5,0,5,72,16,0,88,216,21,325
2120504,4,0,4,117,27,7,151,389,23,563
2120505,0,0,0,147,35,6,188,236,18,442
2120506,0,0,0,25,53,3,81,865,38,984
2120507,19,0,19,74,19,0,93,316,41,450
2120508,35,74,109,43,6,0,49,296,170,515
2120509,3,3,6,54,14,3,71,358,27,456
2120510,10,0,10,34,16,0,50,222,17,289
2120511,8,0,8,66,32,3,101,361,20,482
2120512,0,0,0,88,15,0,103,248,32,383
2120513,0,0,0,203,34,9,246,378,34,658
2120514,0,0,0,36,24,0,60,291,25,376
2120515,0,0,0,70,21,0,91,362,68,521
2120516,3,0,3,74,16,0,90,201,22,313
2120517,0,0,0,0,0,0,0,0,0,0
2120518,0,0,0,67,13,0,80,361,39,480
2120519,0,0,0,0,0,0,0,0,0,0
2120520,4,4,8,59,39,0,98,377,36,511
2120521,3,0,3,74,16,0,90,218,9,317
2120601,10,0,10,83,7,22,112,220,14,346
2120602,7,0,7,71,23,0,94,180,15,289
2120603,6,0,6,95,21,0,116,268,16,400
2120604,4,4,8,52,15,0,67,229,43,339
2120605,9,3,12,74,15,0,89,299,90,478
2120606,12,6,18,62,16,5,83,224,52,359
2120607,6,6,12,80,18,0,98,178,105,381
2120608,4,0,4,27,12,5,44,183,28,255
2120609,4,0,4,72,20,3,95,256,25,376
2120610,3,0,3,98,24,3,125,319,23,467
2120611,10,0,10,92,27,3,122,276,45,443
2120612,0,0,3,59,26,7,92,269,5,366
2120613,3,4,10,87,45,4,136,280,46,462
2120614,7,3,10,47,15,0,62,228,39,329
2120615,10,0,10,71,40,0,111,273,14,398
2120616,5,0,5,52,14,0,66,225,42,333
2120617,6,3,9,78,27,4,109,252,25,386
2120618,7,0,7,64,18,3,85,226,28,339
2120619,11,0,11,54,16,9,79,210,43,332
2120620,3,3,6,85,23,7,115,335,23,473
2120621,9,0,9,54,18,0,72,268,32,372
2120622,12,3,15,72,15,6,93,266,30,389
2120623,14,3,17,80,31,0,111,307,48,466
2120624,3,0,3,41,7,0,48,183,58,289
2120625,4,0,4,123,26,5,154,222,24,400
2120626,3,4,7,59,13,0,72,280,31,383
2120627,3,0,3,63,12,6,81,204,43,328
2120628,9,6,15,102,18,0,120,279,38,437
2120629,5,3,8,64,23,0,87,190,43,320
2120630,6,3,12,56,27,0,83,289,73,445
2120631,11,0,11,65,9,3,77,201,49,327
2120632,6,3,9,99,28,6,133,331,43,507
2120633,0,4,4,35,6,0,41,176,31,248
2120634,13,0,13,70,24,0,94,341,39,474
2120635,0,0,0,0,0,0,0,3,0,3
2120636,0,0,0,129,37,0,166,290,32,488
2120637,0,0,0,131,30,0,161,267,27,455
2120638,4,0,4,39,12,0,51,244,25,320
2120639,7,0,7,72,23,4,99,216,26,341
2120640,12,3,15,48,14,6,68,217,32,317
2120641,14,0,14,84,24,0,108,336,26,470
2120642,7,3,10,99,31,3,133,312,27,472
2120643,3,0,3,48,9,0,57,152,22,231
2120644,6,0,6,63,19,3,85,233,24,342
2120645,3,0,3,90,29,6,125,368,18,511
2120646,4,0,4,47,19,3,69,413,86,568
2120647,0,0,3,71,19,3,93,251,51,395
2120648,8,0,8,45,4,7,56,225,15,296
2120649,0,3,3,50,26,0,76,475,26,577
2120650,4,42,46,31,9,0,40,159,87,286
2120651,0,3,3,44,10,3,57,186,28,271
2120652,4,0,4,61,24,3,88,276,18,382
2120653,9,0,9,71,26,6,103,295,35,433
2120654,5,0,5,54,6,8,68,183,14,265
2120655,9,3,12,35,24,0,59,236,21,316
2120656,6,0,6,109,33,9,151,256,18,425
2120657,10,0,14,140,47,3,190,327,31,548
2120658,12,4,16,114,22,6,142,292,22,456
2120659,13,3,16,76,18,6,100,345,50,495
2120660,4,0,4,67,28,3,98,226,24,348
2120661,0,3,3,29,9,0,38,300,206,544
2120662,15,0,15,64,19,8,91,279,50,420
2120663,11,0,11,93,24,0,117,280,45,442
2120664,3,4,7,45,10,6,61,167,13,241
2120665,3,3,6,48,20,5,73,166,46,285
2120701,5,0,5,68,10,0,78,159,21,258
2120702,7,3,10,52,18,0,70,192,37,299
2120703,4,3,7,47,11,0,58,252,15,325
2120704,6,0,6,38,19,3,60,261,48,369
2120705,3,0,3,59,23,3,85,236,26,347
2120706,8,0,8,71,25,3,99,285,38,422
2120707,12,0,12,66,19,0,85,250,38,373
2120708,10,0,10,67,26,3,96,207,27,330
2120709,0,0,0,54,29,0,83,212,18,313
2120710,4,0,4,43,25,0,68,253,35,356
2120711,6,0,6,52,12,0,64,173,25,262
2120712,57,6,66,43,15,0,58,302,37,397
2120713,8,0,8,92,20,6,118,298,32,448
2120714,3,3,6,85,18,0,103,318,48,469
2120715,7,5,12,37,28,0,65,290,34,389
2120716,4,0,4,59,45,0,104,318,36,458
2120717,7,0,7,109,28,3,140,287,35,462
2120718,16,0,16,73,16,0,89,251,17,357
2120719,7,4,11,60,27,0,87,225,16,328
2120720,5,0,5,60,24,6,90,214,27,331
2120721,4,15,19,58,13,0,71,205,66,342
2120722,6,0,6,87,9,0,96,160,16,272
2120723,8,0,8,74,13,3,90,250,29,369
2120724,6,6,12,51,12,3,66,256,45,367
2120725,7,4,11,63,25,0,88,301,37,426
2120726,3,0,3,40,17,0,57,268,52,377
2120727,7,4,11,31,17,0,48,292,81,421
2120728,10,6,16,57,27,3,87,294,22,403
2120729,12,0,12,67,12,0,79,278,28,385
2120730,0,0,0,51,15,4,70,181,26,277
2120731,12,0,12,64,21,3,88,258,59,405
2120732,8,3,11,61,20,0,81,180,22,283
2120733,6,0,6,58,18,3,79,229,41,349
2120734,10,4,17,34,7,3,44,292,44,380
2120735,14,3,17,94,33,0,127,328,46,501
2120736,19,0,19,50,20,3,73,252,37,362
2120737,18,4,22,92,21,0,113,328,35,476
2120738,6,0,6,90,20,0,110,271,21,402
2120739,13,3,16,44,24,0,68,185,38,291
2120740,7,0,7,58,31,3,92,208,39,339
2120741,6,3,9,58,26,0,84,294,66,444
2120742,13,3,16,54,24,3,81,311,21,413
2120743,77,9,86,66,13,0,79,362,46,487
2120744,105,19,124,3,7,0,10,285,33,328
2120745,0,0,0,31,18,0,49,155,37,241
2120746,6,0,6,39,35,0,74,190,7,271
2120747,8,0,8,33,49,0,82,244,23,349
2120748,0,0,0,40,14,0,54,151,33,238
2120749,34,12,46,12,21,0,33,232,61,326
2120750,0,3,3,49,18,0,67,201,33,301
2120751,4,0,4,59,16,0,75,139,32,246
2120752,8,3,11,57,12,0,69,215,29,313
2120753,4,0,4,67,31,3,101,269,25,395
2120754,3,0,3,50,14,0,64,230,26,320
2120755,6,0,6,48,20,0,68,245,16,329
2120756,0,0,0,40,28,0,68,163,9,240
2120757,7,0,7,58,20,0,78,301,55,434
2120758,5,3,8,77,20,3,100,324,52,476
2120801,11,6,17,53,6,0,59,247,49,355
2120802,7,41,48,69,22,0,91,348,143,582
2120803,13,3,16,55,18,3,76,303,32,411
2120804,0,0,0,0,0,0,0,0,0,0
2120805,7,6,13,39,27,3,69,256,38,363
2120806,8,4,12,38,27,0,65,220,12,297
2120807,7,3,10,24,53,0,77,303,30,410
2120808,11,3,14,70,31,3,104,325,39,468
2120809,3,0,3,35,19,0,54,204,52,310
2120810,6,0,6,35,17,0,52,162,15,229
2120811,69,0,69,49,29,3,81,346,38,465
2120812,7,3,10,34,17,0,51,168,18,237
2120813,7,5,12,73,18,0,91,253,34,378
2120814,12,0,12,86,25,9,120,245,56,421
2120815,4,0,4,39,29,0,68,212,27,307
2120816,10,3,13,35,33,0,68,312,34,414
2120817,6,0,6,96,34,0,130,329,53,512
2120818,10,6,16,112,27,0,139,236,48,423
2120819,14,3,17,68,17,4,89,174,29,292
2120820,8,0,8,52,3,0,55,138,7,200
2120821,14,0,14,64,18,3,85,252,81,418
2120822,4,0,4,66,18,3,87,188,71,346
2120823,0,0,0,3,0,0,3,18,0,21
2120824,16,0,16,64,25,0,89,243,12,344
2120825,6,3,9,93,20,0,113,214,34,361
2120826,7,0,7,99,10,0,109,273,25,407
2120827,8,7,15,65,15,0,80,205,42,327
2120828,14,7,21,99,32,3,134,333,53,520
2120829,10,0,10,75,13,6,94,184,23,301
2120830,6,0,6,42,54,0,96,222,23,341
2120831,7,3,10,88,29,6,123,273,37,433
2120832,6,6,12,78,27,0,105,317,40,462
2120833,7,3,10,44,28,0,72,313,39,424
2120834,11,4,15,51,10,0,61,178,28,267
2120835,9,8,17,57,12,0,69,224,18,311
2120836,9,0,9,86,28,0,114,279,32,425
2120837,6,0,6,20,6,3,29,69,3,101
2120838,14,0,14,52,31,0,83,308,24,415
2120839,3,0,3,81,19,0,100,228,25,353
2120840,14,3,17,86,25,3,114,347,31,492
2120841,10,0,10,57,13,0,70,173,14,257
2120842,3,0,3,90,39,0,129,320,30,479
2120843,0,0,0,17,21,0,38,91,15,144
2120844,4,0,4,24,31,0,55,239,27,321
2120845,0,0,0,0,0,0,0,6,0,6
2120846,3,0,3,43,39,3,85,242,33,360
2120847,9,3,12,40,29,0,69,218,60,347
2120848,0,0,0,0,0,0,0,0,0,0
2120849,6,0,6,58,9,3,70,263,30,363
2120850,6,0,6,38,15,0,53,161,15,229
2120851,13,0,13,85,20,0,105,281,37,423
2120852,10,4,14,71,20,0,91,330,47,468
2120853,6,0,6,32,11,0,43,146,16,205
2120854,13,0,13,36,15,7,58,162,16,236
2120855,3,0,3,59,11,0,70,166,9,245
2120856,3,3,6,58,15,0,73,229,19,321
2120857,4,3,7,81,11,0,92,280,29,401
2120858,12,4,16,48,16,3,67,174,16,257
2120901,0,0,0,89,36,9,134,271,0,405
2120902,0,0,0,39,21,0,60,137,12,209
2120903,24,0,24,80,32,3,115,258,15,388
2120904,0,0,0,54,20,0,74,150,6,230
2120905,0,0,0,75,7,6,88,152,6,246
2120906,0,0,0,89,21,7,117,209,12,338
2120907,0,0,0,92,16,0,108,186,9,303
2120908,3,0,3,68,28,6,102,238,6,346
2120909,0,0,0,54,25,11,90,157,0,247
2120910,0,0,0,104,27,12,143,232,9,384
2120911,0,0,0,56,12,4,72,163,9,244
2120912,3,3,6,65,19,3,87,162,21,270
2120913,0,0,0,84,51,3,138,228,15,381
2120914,0,0,0,51,23,0,74,133,3,210
2120915,5,0,9,97,34,0,131,281,26,438
2120916,4,0,4,80,26,3,109,212,11,332
2120917,7,0,7,97,26,9,132,228,10,370
2120918,0,0,0,89,27,6,122,197,14,333
2120919,3,0,3,123,39,12,174,225,18,417
2120920,3,0,3,51,29,0,80,139,7,226
2120921,0,0,0,47,32,6,85,208,7,300
2120922,4,0,4,84,41,5,130,202,9,341
2120923,6,0,6,54,22,4,80,186,7,273
2120924,3,0,3,98,49,9,156,289,21,466
2120925,0,0,0,70,9,6,85,178,3,266
2120926,3,0,3,34,16,0,50,102,12,164
2120927,0,0,0,35,9,4,48,152,3,203
2120928,0,0,0,47,23,3,73,89,0,162
2120929,0,0,0,88,31,9,128,238,7,373
2120930,0,0,0,71,25,9,105,165,0,270
2120931,0,0,0,77,24,6,107,206,16,329
2120932,0,0,0,40,8,6,54,120,12,186
2120933,4,0,4,69,22,4,95,193,24,312
2120934,3,0,6,116,33,7,156,240,15,411
2120935,0,0,0,81,21,7,109,178,9,296
2120936,0,0,0,94,31,9,134,273,13,420
2120937,6,0,6,41,32,7,80,182,15,277
2120938,5,0,5,49,35,3,87,247,12,346
2120939,0,0,0,85,35,5,125,186,20,331
2120940,0,0,0,43,19,7,69,129,0,198
2120941,6,0,6,73,24,4,101,153,4,258
2120942,3,0,3,85,27,11,123,204,22,349
2120943,0,0,0,56,12,6,74,184,6,264
2120944,0,0,0,81,26,9,116,181,12,309
2120945,28,77,105,67,18,6,91,195,144,430
2120946,9,0,9,39,9,3,51,182,18,251
2120947,3,0,3,56,16,6,78,187,3,268
2120948,0,0,0,29,9,3,41,126,7,174
2120949,0,0,0,78,29,3,110,186,12,308
2120950,3,0,3,113,33,6,152,244,27,423
2120951,4,0,4,70,14,6,90,196,4,290
2120952,0,0,0,65,9,3,77,191,3,271
2120953,0,0,0,72,28,5,105,161,7,273
2120954,3,0,3,85,36,6,127,198,15,340
2120955,0,0,0,107,19,0,126,167,6,299
2120956,0,0,0,47,28,6,81,190,3,274
2120957,0,0,0,43,30,9,82,114,6,202
2120958,0,0,0,102,33,0,135,239,12,386
2120959,10,4,14,25,23,3,51,126,17,194
2120960,6,3,9,76,25,3,104,179,10,293
2121001,0,0,0,54,15,6,75,148,4,227
2121002,3,3,6,119,22,6,147,187,21,355
2121003,0,0,0,50,22,4,76,97,12,185
2121004,0,0,0,91,30,0,121,204,3,328
2121005,3,0,3,38,11,3,52,119,17,188
2121006,0,3,3,69,44,10,123,229,12,364
2121007,0,0,0,44,12,0,56,121,3,180
2121008,0,0,0,59,22,0,81,193,11,285
2121009,0,0,0,73,32,12,117,148,0,265
2121010,0,3,3,90,22,12,124,236,15,375
2121101,3,0,3,24,18,0,42,87,6,135
2121102,0,0,0,102,20,3,125,179,24,328
2121103,0,0,0,94,32,0,126,153,36,315
2121104,0,3,3,48,14,3,65,115,21,201
2121105,0,0,0,44,14,0,58,120,15,193
2121106,4,0,4,148,39,0,187,223,44,454
2121107,0,0,0,36,15,6,57,111,4,172
2121108,0,0,0,20,12,0,32,53,3,88
2121109,3,3,6,35,22,6,63,177,6,246
2121110,6,3,9,66,19,3,88,167,16,271
2121111,0,0,0,41,18,0,59,87,19,165
2121112,0,0,0,53,19,4,76,138,16,230
2121201,3,0,3,82,27,4,113,176,17,306
2121202,3,0,3,51,23,12,86,124,9,219
2121203,3,0,3,41,13,4,58,105,13,176
2121204,4,0,4,78,15,3,96,196,14,306
2121205,0,0,0,52,21,0,73,106,11,190
2121206,0,0,0,59,30,3,92,109,15,216
2121207,0,0,0,38,22,0,60,90,9,159
2121208,0,0,0,31,10,0,41,66,3,110
2121209,0,0,0,0,0,0,0,0,0,0
2121210,0,0,0,0,0,0,0,0,0,0
2121211,0,0,0,56,49,7,112,169,9,290
2121212,3,0,3,72,13,6,91,159,12,262
2121213,3,0,3,79,21,0,100,153,18,271
2121214,6,3,9,53,24,3,80,169,24,273
2121215,3,0,3,41,28,9,78,210,13,301
2121216,0,0,0,43,34,0,77,142,18,237
2121217,3,0,3,29,25,0,54,136,21,211
2121218,4,0,4,29,13,0,42,120,13,175
2121219,0,0,0,22,15,0,37,73,3,113
2121220,0,0,0,44,6,6,56,119,3,178
2121301,0,0,0,122,31,4,157,265,19,441
2121302,0,0,0,77,20,0,97,146,6,249
2121303,0,0,0,47,18,0,65,106,3,174
2121304,0,0,0,133,23,12,168,239,12,419
2121305,0,3,3,125,23,0,148,284,31,463
2121306,0,0,0,66,15,3,84,94,10,188
2121307,0,0,0,69,23,3,95,166,15,276
2121308,0,0,0,74,29,3,106,224,15,345
2121309,0,0,0,59,25,3,87,185,20,292
2121310,0,0,0,37,15,3,55,126,6,187
2121311,0,0,0,148,36,3,187,395,28,610
2121312,3,0,3,35,6,3,44,117,11,172
2121313,8,3,15,83,36,3,122,199,12,333
2121314,4,0,4,51,27,0,78,182,5,265
2121315,0,0,0,75,18,8,101,216,9,326
2121316,0,0,0,54,22,0,76,240,0,316
2121317,59,3,62,41,11,3,55,213,21,289
2121318,3,3,6,71,26,4,101,220,18,339
2121319,0,0,0,26,19,0,45,159,0,204
2121320,6,0,6,33,20,0,53,134,3,190
2121321,0,0,0,33,10,3,46,91,13,150
2121322,3,3,6,41,7,0,48,95,9,152
2121323,0,0,0,38,21,3,62,215,12,289
2121324,3,0,3,47,8,3,58,143,18,219
2121325,0,0,0,53,18,6,77,129,12,218
2121401,3,0,3,76,22,3,101,219,18,338
2121402,3,0,3,59,21,6,86,216,6,308
2121403,0,3,3,45,16,0,61,154,9,224
2121404,8,0,8,68,32,9,109,224,23,356
2121405,4,0,4,65,30,4,99,174,22,295
2121406,7,0,7,86,47,3,136,247,15,398
2121407,0,0,0,88,38,8,134,169,15,318
2121408,0,0,0,124,36,9,169,223,7,399
2121409,0,0,0,53,29,9,91,120,3,214
2121410,3,0,3,91,31,9,131,190,20,341
2121411,3,0,3,110,39,18,167,216,27,410
2121412,0,0,0,63,30,7,100,164,16,280
2121413,6,0,6,36,17,6,59,145,10,214
2121414,4,0,4,60,28,0,88,214,18,320
2121415,3,0,3,51,22,3,76,217,27,320
2121416,6,0,6,55,28,6,89,180,21,290
2121417,0,0,0,63,21,0,84,133,9,226
2121501,0,0,0,50,15,3,68,118,6,192
2121502,9,3,12,61,25,6,92,243,25,360
2121503,0,0,0,56,31,3,90,137,15,242
2121504,0,0,0,53,13,6,72,146,6,224
2121505,0,0,0,97,18,4,119,208,9,336
2121506,0,0,0,0,0,0,0,0,0,0
2121507,0,0,0,84,42,6,132,238,15,385
2121508,0,0,0,52,23,0,75,161,7,243
2121509,0,3,3,114,31,9,154,289,6,449
2121510,0,0,0,34,12,3,49,102,9,160
2121511,0,0,0,79,30,5,114,219,21,354
2121512,3,0,6,162,45,7,214,307,12,533
2121513,0,0,0,60,12,6,78,328,22,428
2121514,0,0,0,70,16,3,89,213,15,317
2121515,6,0,6,47,40,3,90,215,15,320
2121516,0,0,0,45,28,3,76,147,22,245
2121517,0,3,3,105,39,9,153,309,27,489
2121518,23,3,26,62,42,3,107,240,30,377
2121519,3,0,6,115,13,4,132,164,9,305
2121520,6,0,6,85,12,0,97,242,15,354
2121521,0,0,0,74,36,3,113,235,9,357
2121522,3,0,3,118,29,9,156,249,23,428
2121523,3,0,3,67,29,6,102,270,26,398
2121524,8,3,11,51,17,4,72,189,27,288
2121525,3,0,3,103,40,13,156,301,8,465
2121526,4,3,7,76,26,6,108,122,15,245
2121527,0,0,0,90,15,6,111,139,6,256
2121528,0,0,0,37,16,7,60,95,6,161
2121529,0,0,0,101,20,9,130,194,6,330
2121530,0,0,0,111,24,7,142,166,18,326
2121531,0,0,0,101,10,11,122,143,6,271
2121532,32,3,35,88,24,4,116,266,14,396
2121533,3,0,3,59,18,0,77,98,15,190
2121534,0,0,0,45,14,0,59,110,6,175
2121601,3,0,3,45,15,0,60,285,11,356
2121602,41,9,50,122,51,0,173,639,164,976
2121603,0,0,0,44,14,0,58,262,21,341
2121604,0,3,3,51,31,0,82,247,22,351
2121605,0,0,0,99,21,0,120,408,31,559
2121606,0,0,0,54,7,3,64,142,7,213
2121607,0,0,0,116,21,0,137,137,12,286
2121608,0,0,0,104,13,0,117,148,19,284
2121609,0,0,0,100,28,0,128,280,9,417
2121610,0,0,0,0,0,0,0,0,0,0
2121611,0,0,0,102,7,0,109,196,15,320
2121612,3,0,3,63,12,3,78,193,18,289
2121701,0,0,0,19,23,0,42,135,9,186
2121702,6,0,6,54,19,0,73,278,16,367
2121703,4,0,4,42,14,0,56,161,24,241
2121704,6,0,6,40,25,0,65,201,31,297
2121705,6,3,9,57,11,5,73,226,30,329
2121706,3,0,3,63,22,0,85,230,36,351
2121707,5,0,5,25,22,3,50,157,47,254
2121708,0,0,0,18,8,0,26,117,33,176
2121709,7,0,7,45,16,0,61,318,54,433
2121710,0,0,0,49,23,0,72,107,14,193
2121711,3,0,3,80,48,3,131,354,31,516
2121712,0,0,0,21,37,6,64,130,9,203
2121713,0,0,0,33,42,0,75,325,47,447
2121714,0,0,0,49,30,3,82,117,35,234
2121715,4,0,4,48,42,3,93,240,23,356
2121716,3,0,3,26,13,0,39,137,7,183
2121717,4,3,7,55,25,0,80,164,16,260
2121718,0,0,0,42,22,0,64,172,51,287
2121801,3,0,3,39,12,0,51,153,12,216
2121802,0,0,0,150,11,6,167,248,15,430
2121803,0,0,0,42,12,0,54,117,25,196
2121804,0,34,34,66,22,3,91,275,82,448
2121805,4,0,4,68,27,3,98,289,19,406
2121806,0,0,0,44,20,0,64,232,21,317
2121807,6,0,6,43,24,0,67,198,14,279
2121808,0,0,0,56,12,0,68,79,6,153
2121809,0,0,0,44,13,3,60,134,22,216
2121810,0,0,0,103,17,3,123,238,7,368
2121811,0,0,0,110,21,0,131,225,15,371
2121812,4,0,4,83,10,9,102,247,18,367
2121813,3,0,3,101,29,4,134,321,25,480
2121814,0,0,0,41,9,0,50,94,3,147
2121815,0,0,0,182,19,5,206,390,55,651
2121816,0,0,0,129,21,3,153,260,28,441
2121817,0,0,0,97,30,3,130,255,23,408
2121818,0,0,0,74,14,4,92,155,18,265
2121819,3,0,3,75,29,0,104,271,26,401
2121820,0,0,0,45,0,5,50,106,12,168
2121821,3,0,3,67,43,0,110,301,52,463
2121822,0,0,0,62,35,0,97,265,35,397
2121823,3,0,3,73,22,3,98,251,30,379
2121824,0,0,0,36,19,0,55,137,12,204
2121825,0,0,0,104,21,9,134,289,27,450
2121826,0,3,3,52,6,3,61,68,18,147
2121827,0,0,0,0,0,0,0,11,0,11
2121828,3,0,3,51,16,3,70,204,15,289
2121829,0,0,0,51,21,0,72,166,31,269
2121830,6,0,6,80,40,3,123,254,53,430
2121831,3,3,6,64,20,0,84,211,46,341
2121832,5,0,5,33,26,6,65,258,30,353
2121833,23,0,23,68,29,0,97,253,38,388
2121834,3,0,3,45,17,0,62,185,29,276
2121835,0,0,0,58,14,0,72,188,34,294
2121836,0,0,0,48,9,3,60,141,14,215
2121837,0,0,0,41,22,0,63,281,26,370
2121838,6,6,12,97,41,0,138,351,41,530
2121839,0,0,0,42,15,0,57,100,12,169
2121840,6,0,6,56,14,0,70,184,18,272
2121841,0,0,0,72,37,7,116,293,26,435
2121842,0,0,0,68,15,0,83,223,26,332
2121843,0,3,3,120,18,6,144,204,25,373
2121844,0,0,0,77,15,3,95,150,9,254
2121845,7,0,7,73,30,6,109,299,13,421
2121846,0,0,0,55,23,0,78,208,18,304
2121847,0,0,0,52,14,3,69,123,13,205
2121848,0,0,0,58,11,3,72,140,3,215
2121849,3,0,3,84,9,0,93,144,12,249
2121850,0,0,0,74,3,0,77,108,0,185
2121851,0,0,0,74,12,3,89,139,9,237
2121852,6,0,6,29,15,0,44,165,3,212
2121853,0,0,0,124,18,0,142,217,16,375
2121854,0,0,0,0,0,0,0,0,0,0
2121855,0,0,0,119,22,0,141,254,21,416
2121856,0,0,0,89,13,0,102,178,21,301
2121857,0,0,0,114,15,0,129,168,19,316
2121858,0,0,0,53,8,6,67,110,10,187
2121859,0,0,0,54,14,0,68,195,15,278
2121860,0,0,0,56,3,0,59,151,0,210
2121861,0,0,0,117,18,0,135,255,22,412
2121862,0,0,0,3,0,0,3,18,3,24
2121863,0,0,0,0,0,0,0,0,0,0
2121864,0,3,3,70,39,0,109,265,22,396
2121865,0,0,0,37,16,3,56,127,15,198
2121866,0,0,0,58,15,3,76,170,23,269
2121867,136,13,149,3,13,0,16,425,42,483
2121868,0,0,0,0,0,0,0,0,0,0
2121869,0,0,0,0,0,0,0,6,0,6
2121870,0,0,0,116,33,0,149,308,26,483
2121871,4,0,4,94,15,0,109,271,33,413
2121901,4,0,4,41,29,0,70,241,24,335
2121902,0,0,0,63,32,0,95,242,23,360
2121903,3,3,6,47,35,0,82,230,26,338
2121904,3,0,3,44,19,0,63,237,13,313
2121905,3,0,3,41,18,0,59,276,18,353
2121906,3,0,3,70,16,0,86,248,36,370
2121907,5,0,5,63,39,0,102,352,47,501
2121908,6,0,6,42,19,3,64,157,21,242
2121909,0,0,0,50,13,4,67,171,24,262
2121910,3,0,3,54,14,0,68,192,14,274
2121911,0,0,0,41,29,3,73,174,9,256
2121912,0,0,0,36,23,3,62,178,18,258
2121913,3,0,3,26,22,0,48,193,24,265
2121914,3,0,3,67,22,3,92,228,24,344
2121915,6,0,6,57,38,0,95,328,23,446
2121916,8,0,8,62,32,0,94,251,38,383
2121917,5,3,8,67,31,5,103,308,30,441
2121918,7,3,10,55,28,3,86,349,42,477
2121919,7,0,7,55,22,0,77,312,19,408
2121920,15,3,18,82,17,0,99,294,49,442
2121921,0,0,0,53,21,0,74,210,30,314
2121922,0,0,0,29,12,0,41,190,21,252
2121923,0,0,0,50,40,0,90,207,15,312
2121924,3,0,3,49,20,0,69,241,8,318
2121925,3,0,3,46,20,0,66,203,16,285
2121926,0,0,0,51,18,0,69,167,19,255
2121927,0,0,0,39,15,0,54,160,18,232
2121928,0,3,3,65,14,0,79,287,15,381
2121929,4,0,4,71,37,0,108,242,24,374
2121930,0,0,0,151,19,3,173,301,24,498
2121931,0,0,0,0,0,0,0,0,0,0
2121932,0,0,0,40,21,0,61,213,12,286
2121933,6,0,6,28,21,0,49,134,23,206
2121934,5,0,5,35,38,6,79,205,39,323
2121935,6,0,6,32,18,0,50,171,29,250
2121936,0,0,0,42,9,0,51,156,19,226
2121937,7,0,7,58,27,0,85,232,9,326
2121938,3,0,3,38,25,6,69,200,21,290
2121939,0,0,0,28,16,0,44,109,36,189
2121940,3,0,3,35,24,0,59,214,23,296
2121941,3,0,3,54,26,0,80,324,36,440
2121942,0,0,0,50,25,0,75,181,12,268
2121943,5,4,9,45,12,3,60,179,20,259
2121944,12,3,15,65,28,0,93,230,42,365
2121945,9,0,9,37,18,0,55,199,23,277
2121946,6,0,6,56,17,0,73,247,28,348
2121947,0,0,0,43,20,0,63,165,40,268
2121948,0,0,0,48,25,0,73,187,47,307
2121949,7,0,7,38,16,0,54,207,64,325
2121950,9,0,9,58,29,3,90,276,58,424
2121951,0,0,0,48,27,3,78,257,18,353
2122001,4,0,4,55,15,0,70,144,3,217
2122002,0,0,0,0,0,0,0,0,0,0
2122003,3,0,3,91,28,6,125,303,12,440
2122004,3,3,6,80,21,0,101,321,21,443
2122005,0,0,0,85,26,0,111,229,24,364
2122006,0,0,0,84,38,3,125,254,16,395
2122007,3,0,3,78,12,6,96,255,19,370
2122008,0,0,0,55,10,4,69,144,10,223
2122009,0,0,0,66,14,3,83,203,10,296
2122010,0,0,0,57,17,3,77,212,13,302
2122011,0,3,3,38,18,0,56,257,15,328
2122012,0,0,0,63,25,0,88,204,23,315
2122013,0,0,0,90,21,3,114,206,16,336
2122014,3,3,6,60,9,0,69,204,18,291
2122015,7,0,7,56,19,3,78,235,12,325
2122016,9,0,9,89,27,0,116,302,39,457
2122017,0,3,3,36,14,0,50,178,13,241
2122018,0,0,0,73,18,0,91,213,24,328
2122019,0,0,0,65,30,0,95,239,6,340
2122020,0,0,0,57,18,0,75,184,9,268
2122021,5,0,5,84,20,3,107,239,14,360
2122022,4,0,4,93,17,3,113,282,34,429
2122023,0,0,0,70,18,7,95,234,20,349
2122024,0,0,0,97,22,3,122,292,12,426
2122025,0,0,3,30,9,0,39,92,15,146
2122026,3,0,3,55,18,3,76,259,16,351
2122027,7,0,7,55,15,3,73,179,13,265
2122028,22,62,84,97,27,0,124,301,147,572
2122029,0,0,0,103,24,0,127,237,22,386
2122030,0,0,0,90,22,5,117,163,24,304
2122031,0,0,0,40,19,0,59,125,21,205
2122032,3,0,3,50,36,3,89,203,21,313
2122033,0,0,0,108,9,0,117,258,5,380
2122034,3,0,3,56,20,0,76,188,18,282
2122035,6,0,6,79,15,0,94,271,32,397
2122036,3,0,3,59,18,0,77,174,21,272
2122037,0,0,0,85,24,9,118,328,34,480
2122038,3,0,3,43,30,0,73,277,9,359
2122039,0,0,0,45,13,0,58,142,12,212
2122040,3,0,3,32,7,6,45,114,12,171
2122041,0,0,0,58,23,0,81,185,21,287
2122042,3,0,3,73,13,0,86,215,18,319
2122043,0,0,0,66,12,3,81,186,5,272
2122044,0,0,0,62,27,6,95,186,21,302
2122045,0,0,0,69,12,0,81,190,15,286
2122046,0,0,0,49,17,3,69,172,14,255
2122101,4,0,4,59,36,0,95,211,18,324
2122102,0,0,0,77,24,0,101,211,25,337
2122103,6,0,6,49,28,0,77,240,35,352
2122104,3,0,3,84,21,9,114,309,43,466
2122105,0,0,0,67,27,0,94,278,42,414
2122106,0,0,0,82,25,0,107,275,34,416
2122107,3,0,3,101,19,3,123,320,39,482
2122108,0,0,0,91,21,3,115,239,26,380
2122109,4,0,4,60,15,3,78,174,32,284
2122110,6,0,6,94,34,4,132,319,30,481
2122111,3,0,3,78,18,0,96,211,28,335
2122112,0,0,0,70,24,0,94,232,21,347
2122113,0,0,0,90,30,3,123,298,37,458
2122114,7,0,7,64,24,0,88,292,31,411
2122115,0,0,0,44,14,0,58,161,39,258
2122116,3,0,3,50,19,0,69,162,15,246
2122117,8,0,8,63,30,3,96,279,10,385
2122118,3,6,9,59,37,0,96,311,25,432
2122119,3,0,3,43,25,3,71,181,15,267
2122120,0,3,3,74,18,0,92,236,9,337
2122121,0,0,0,70,30,6,106,265,9,380
2122122,0,0,0,41,12,3,56,152,6,214
2122123,0,0,0,48,9,0,57,164,9,230
2122124,0,0,0,74,17,3,94,285,21,400
2122125,6,0,6,88,44,0,132,367,49,548
2122126,0,0,0,48,6,3,57,106,9,172
2122127,5,0,5,41,18,0,59,179,9,247
2122128,0,0,0,30,20,0,50,122,7,179
2122129,4,0,4,43,22,0,65,185,15,265
2122201,0,0,0,66,11,3,80,153,6,239
2122202,0,0,0,234,49,10,293,429,41,763
2122203,0,0,0,166,37,14,217,327,17,561
2122204,0,0,0,0,0,0,0,0,0,0
2122205,3,0,3,104,30,3,137,229,13,379
2122206,3,0,3,147,33,6,186,309,22,517
2122207,3,0,3,305,54,6,365,553,59,977
2122208,3,0,3,210,32,18,260,163,18,441
2122209,0,0,0,168,32,10,210,234,15,459
2122210,0,0,0,192,32,12,236,259,26,521
2122211,0,0,0,17,6,0,23,63,19,105
2122212,3,0,3,117,35,6,158,314,19,491
2122213,3,0,3,393,86,27,506,556,53,1115
2122214,3,0,3,138,33,3,174,252,20,446
2122215,0,0,0,56,5,0,61,131,10,202
2122216,0,0,0,100,15,0,115,176,12,303
2122217,0,0,0,75,12,0,87,168,15,270
2122218,0,0,0,0,0,0,0,0,0,0
2122219,3,30,33,36,18,0,54,164,90,308
2122220,0,0,0,80,15,4,99,188,20,307
2122221,4,36,40,39,24,0,63,132,78,273
2122222,13,61,74,413,88,9,510,874,186,1570
2122223,0,0,0,102,34,0,136,137,0,273
2122224,0,0,0,101,27,3,131,251,19,401
2122225,3,0,3,97,20,0,117,191,14,322
2122226,0,0,0,50,18,5,73,141,15,229
2122227,0,0,0,83,16,0,99,116,7,222
2122228,0,0,0,86,17,3,106,178,12,296
2122229,0,0,0,79,3,5,87,139,10,236
2122230,0,0,0,67,14,0,81,167,3,251
2122231,0,0,0,141,24,4,169,178,34,381
2122232,6,0,6,195,35,9,239,318,34,591
2122233,0,0,0,150,15,3,168,204,22,394
2122234,0,0,0,110,15,3,128,199,13,340
2122235,3,0,3,161,25,3,189,248,15,452
2122236,0,0,0,145,17,5,167,128,9,304
2122237,0,0,0,125,24,0,149,88,7,244
2122238,0,0,0,143,20,5,168,134,12,314
2122239,3,0,3,123,24,0,147,226,28,401
2122240,0,0,0,82,20,0,102,187,19,308
2122241,0,0,0,95,28,4,127,165,15,307
2122242,4,0,4,9,3,0,12,31,3,46
2122243,44,0,44,11,0,0,11,182,14,207
2122244,0,0,0,301,85,10,396,447,36,879
2122245,0,0,0,260,37,11,308,279,22,609
2122246,3,0,3,445,109,11,565,927,61,1553
2122247,0,0,0,666,120,33,819,1054,82,1955
2122248,4,0,4,744,138,25,907,1216,92,2215
2122249,0,0,0,115,28,0,143,141,12,296
2122250,3,0,6,515,76,20,611,817,64,1492
2122251,5,0,5,130,26,6,162,199,7,368
2122252,3,0,3,131,20,6,157,296,40,493
2122253,0,0,0,177,31,6,214,332,39,585
2122254,0,0,0,117,19,0,136,180,23,339
2122255,0,0,0,123,20,6,149,228,21,398
2122301,3,0,3,38,23,0,61,195,24,280
2122302,13,0,13,73,28,0,101,348,40,489
2122303,0,0,0,40,13,3,56,191,30,277
2122304,15,0,15,80,25,6,111,337,93,541
2122305,15,0,15,63,22,0,85,395,49,529
2122306,10,0,10,29,8,0,37,259,42,338
2122307,11,0,11,49,18,0,67,180,39,286
2122308,6,3,9,66,21,0,87,239,24,350
2122309,7,3,10,55,43,3,101,282,42,425
2122310,0,0,0,41,21,0,62,167,38,267
2122311,0,0,0,47,31,4,82,190,16,288
2122312,9,0,9,56,42,0,98,357,45,500
2122313,3,0,3,42,37,0,79,227,25,331
2122314,0,0,0,60,32,0,92,329,25,446
2122315,0,0,0,41,12,0,53,146,30,229
2122316,4,0,4,29,12,0,41,154,8,203
2122317,3,0,3,31,18,0,49,198,21,268
2122318,0,0,0,57,31,3,91,243,25,359
2122319,3,0,3,55,15,3,73,214,49,336
2122320,0,0,0,79,17,0,96,186,25,307
2122321,0,0,0,63,16,3,82,225,40,347
2122322,9,0,9,37,19,0,56,219,20,295
2122323,0,0,0,65,20,0,85,201,25,311
2122324,0,0,0,3,0,0,3,0,0,3
2122325,0,0,0,0,0,0,0,5,0,5
2122326,0,0,0,69,10,0,79,281,39,399
2122327,0,0,0,28,15,0,43,175,22,240
2122328,3,0,3,54,14,0,68,230,23,321
2122329,3,0,3,36,33,0,69,269,21,359
2122330,6,0,6,46,20,0,66,208,23,297
2122331,12,3,15,40,16,0,56,237,39,332
2122332,9,0,9,32,7,0,39,191,17,247
2122333,24,0,24,79,9,3,91,336,56,483
2122334,10,3,13,51,18,3,72,251,26,349
2122335,0,0,0,0,0,0,0,0,0,0
2122336,6,0,6,56,45,3,104,321,33,458
2122337,3,0,3,51,23,5,79,242,24,345
2122338,6,0,6,48,30,0,78,246,15,339
2122339,8,0,8,33,19,0,52,197,21,270
2122340,0,0,0,67,25,0,92,197,18,307
2122341,3,3,6,64,23,0,87,231,18,336
2122342,5,0,5,62,26,0,88,308,35,431
2122343,5,0,5,55,25,0,80,257,49,386
2122344,0,0,0,0,0,0,0,6,0,6
2122345,6,0,6,51,37,0,88,282,31,401
2122346,3,0,3,61,30,0,91,317,33,441
2122347,6,0,6,65,36,0,101,234,45,380
2122348,6,0,6,39,32,0,71,268,22,361
2122349,3,0,3,34,31,0,65,250,24,339
2122350,0,0,0,0,0,0,0,0,0,0
2122351,3,3,6,40,11,4,55,166,43,264
2122352,0,0,0,24,13,0,37,109,10,156
2122353,3,0,3,63,39,0,102,198,31,331
2122354,10,0,10,54,28,0,82,271,23,376
2122401,0,0,0,93,28,0,121,210,31,362
2122402,0,0,0,97,31,7,135,201,10,346
2122403,0,0,0,101,15,0,116,95,18,229
2122404,0,0,0,162,32,14,208,179,75,462
2122405,3,0,6,68,27,0,95,170,37,302
2122406,3,0,3,132,50,15,197,255,66,518
2122407,3,0,3,78,23,3,104,166,18,288
2122408,0,0,0,54,25,3,82,148,23,253
2122409,0,0,0,65,27,6,98,194,12,304
2122410,0,3,3,164,39,9,212,262,29,503
2122411,0,0,0,64,18,0,82,135,7,224
2122412,0,0,0,173,51,10,234,296,43,573
2122413,0,0,0,73,25,0,98,211,6,315
2122414,0,0,0,104,20,11,135,206,17,358
2122415,6,3,9,81,26,3,110,225,16,351
2122416,3,0,3,58,20,0,78,135,8,221
2122417,0,0,0,118,29,3,150,210,53,413
2122418,4,0,4,70,31,3,104,197,25,326
2122419,3,0,3,51,19,0,70,137,12,219
2122420,0,0,0,40,11,0,51,156,13,220
2122421,0,0,0,103,22,6,131,214,31,376
2122422,0,0,0,118,31,3,152,173,21,346
2122423,0,0,0,20,6,3,29,84,3,116
2122424,0,0,0,28,9,0,37,129,13,179
2122425,6,0,6,72,29,4,105,208,47,360
2122426,0,0,0,83,26,6,115,183,31,329
2122427,4,0,4,114,42,6,162,338,41,541
2122501,0,0,0,62,32,0,94,181,18,293
2122502,3,0,3,124,42,6,172,308,24,504
2122503,4,0,4,48,18,3,69,164,9,242
2122504,4,0,4,95,31,3,129,174,33,336
2122505,0,0,0,54,15,0,69,135,22,226
2122506,3,0,3,41,5,0,46,131,5,182
2122507,12,52,64,58,26,0,84,244,106,434
2122508,0,0,0,17,7,3,27,137,6,170
2122509,0,3,3,138,43,9,190,209,33,432
2122510,3,0,3,100,41,0,141,236,12,389
2122511,0,0,0,40,26,6,72,191,23,286
2122512,4,0,4,48,26,0,74,254,10,338
2122513,0,0,0,0,0,0,0,3,0,3
2122514,0,0,0,78,12,6,96,131,17,244
2122515,0,0,0,0,0,0,0,0,0,0
2122516,0,0,0,112,23,3,138,179,27,344
2122517,12,0,12,33,28,3,64,158,9,231
2122518,32,0,32,34,20,0,54,217,8,279
2122519,0,0,0,93,41,9,143,226,9,378
2122520,3,0,3,46,12,6,64,137,0,201
2122521,3,0,3,130,16,13,159,130,15,304
2122601,10,0,10,57,8,0,65,217,20,302
2122602,18,0,18,79,43,3,125,340,16,481
2122603,18,3,21,79,14,0,93,316,53,462
2122604,13,0,13,79,29,3,111,326,33,470
2122605,7,3,10,80,49,3,132,346,51,529
2122606,13,0,13,66,32,3,101,356,34,491
2122607,10,0,10,54,17,0,71,216,10,297
2122608,12,0,12,85,46,3,134,317,21,472
2122609,3,6,9,72,23,0,95,255,36,386
2122610,3,6,9,31,17,3,51,176,21,248
2122611,0,0,0,36,20,5,61,160,3,224
2122612,3,0,3,70,28,6,104,243,25,372
2122613,7,3,10,64,27,3,94,288,42,424
2122614,6,0,6,60,17,3,80,166,30,276
2122615,0,3,3,60,15,0,75,166,13,254
2122616,0,0,0,0,0,0,0,3,0,3
2122617,6,0,6,28,15,0,43,161,19,223
2122701,0,0,0,0,0,0,0,0,0,0
2122801,3,0,3,89,31,0,120,322,28,470
2122802,0,0,0,56,26,0,82,195,17,294
2122803,46,13,59,10,9,0,19,194,47,260
2122804,0,0,0,0,0,0,0,3,0,3
2122805,0,0,0,4,0,0,4,0,0,4
2122806,6,6,12,45,37,6,88,264,19,371
2122807,3,3,6,56,27,3,86,199,21,306
2122808,3,0,3,53,41,0,94,182,19,295
2122809,0,3,3,66,28,0,94,182,15,291
2122810,7,0,7,42,62,6,110,297,25,432
2122811,0,0,0,80,32,3,115,335,23,473
2122812,8,3,11,70,33,3,106,264,32,402
2122813,3,3,6,30,31,6,67,192,21,280
2122814,0,0,0,57,12,0,69,157,10,236
2122815,0,0,0,24,31,0,55,159,21,235
2122816,3,0,3,24,6,0,30,129,9,168
2122817,6,0,6,84,35,6,125,238,38,401
2122818,0,0,0,0,6,0,6,0,3,9
2122819,7,0,7,63,35,0,98,269,46,413
2122820,7,0,7,78,34,0,112,238,15,365
2122821,0,0,0,75,23,0,98,152,34,284
2122822,6,0,6,80,44,3,127,217,19,363
2122823,7,0,10,94,30,3,127,215,12,354
2122824,0,0,0,15,9,0,24,29,6,59
2122825,0,0,0,3,0,0,3,3,0,6
2122826,3,0,3,26,4,0,30,138,7,175
2122901,3,5,8,67,23,0,90,218,22,330
2122902,9,0,9,52,41,3,96,305,26,427
2122903,6,0,6,52,30,0,82,221,13,316
2122904,3,0,6,54,21,3,78,223,6,307
2122905,0,3,3,25,17,0,42,214,9,265
2122906,13,0,13,47,43,0,90,339,21,450
2122907,46,0,46,48,26,0,74,279,23,376
2122908,12,3,15,95,20,6,121,309,37,467
2122909,15,0,15,74,17,3,94,260,23,377
2122910,8,0,8,50,46,0,96,253,11,360
2122911,0,0,0,73,51,0,124,299,37,460
2122912,12,25,37,44,12,0,56,196,82,334
2122913,0,0,0,59,14,0,73,192,14,279
2122914,0,0,0,51,41,9,101,325,22,448
2122915,0,0,0,41,9,0,50,126,6,182
2122916,4,0,4,36,24,0,60,196,21,277
2122917,7,0,7,49,23,6,78,199,20,297
2122918,6,3,9,50,18,0,68,273,40,381
2122919,4,3,7,36,17,4,57,114,12,183
2122920,4,0,4,58,17,0,75,166,7,248
2122921,11,0,11,70,42,0,112,321,42,475
2122922,4,0,4,72,28,0,100,198,27,325
2122923,11,6,17,66,32,0,98,233,46,377
2122924,9,0,9,90,45,0,135,217,7,359
2122925,0,0,0,26,17,0,43,107,25,175
2122926,8,3,11,61,32,4,97,301,18,416
2122927,4,0,4,79,20,0,99,238,29,366
2122928,6,0,6,50,24,0,74,176,9,259
2122929,4,0,4,55,39,3,97,305,23,425
2122930,8,0,8,79,19,0,98,212,25,335
2122931,8,0,8,33,19,0,52,151,15,218
2122932,6,3,9,13,24,0,37,152,8,197
2122933,0,0,0,40,39,0,79,224,21,324
2122934,0,3,3,37,21,0,58,240,9,307
2122935,12,0,12,80,25,0,105,274,16,395
2122936,17,0,17,31,12,3,46,165,26,237
2122937,3,0,3,47,32,6,85,197,12,294
2122938,23,3,26,76,33,0,109,310,37,456
2122939,37,0,37,57,44,3,104,283,37,424
2122940,3,0,3,62,34,0,96,317,32,445
2122941,11,0,11,32,15,3,50,210,16,276
2122942,0,3,3,22,21,0,43,165,18,226
2122943,0,0,0,96,36,0,132,262,22,416
2122944,0,6,6,44,33,0,77,179,27,283
2122945,0,0,0,56,20,0,76,191,15,282
2122946,4,0,4,60,40,0,100,193,22,315
2122947,0,0,0,63,31,0,94,209,18,321
2122948,3,0,3,35,25,0,60,148,25,233
2122949,3,0,3,70,17,0,87,200,17,304
2122950,27,3,30,53,34,0,87,231,21,339
2122951,4,0,4,70,36,3,109,226,33,368
2122952,0,52,52,69,47,4,120,284,102,506
2122953,6,6,12,61,32,0,93,205,24,322
2122954,8,0,8,80,45,4,129,267,31,427
2122955,5,0,5,46,10,3,59,162,27,248
2122956,4,0,4,98,35,0,133,291,29,453
2122957,0,0,0,26,31,0,57,126,3,186
2122958,3,0,3,31,21,0,52,139,14,205
2122959,0,0,0,57,14,3,74,184,12,270
2122960,8,0,8,54,24,0,78,152,26,256
2122961,9,0,9,38,30,0,68,196,21,285
2122962,3,0,3,80,50,4,134,245,33,412
2123001,12,0,12,63,34,6,103,187,15,305
2123002,0,4,4,81,23,0,104,154,4,262
2123003,16,0,19,42,25,0,67,164,10,241
2123004,10,7,17,31,12,0,43,176,18,237
2123005,5,0,5,68,6,0,74,203,9,286
2123006,11,3,14,88,24,0,112,247,20,379
2123007,6,0,6,59,19,4,82,229,18,329
2123008,29,3,32,60,15,0,75,239,29,343
2123009,6,0,6,93,33,0,126,224,18,368
2123010,13,3,16,81,30,5,116,245,18,379
2123011,10,0,10,60,28,6,94,228,11,333
2123012,6,0,6,95,32,9,136,261,24,421
2123013,8,0,8,68,10,0,78,137,18,233
2123014,0,0,0,60,18,0,78,180,21,279
2123015,13,0,13,73,20,4,97,188,9,294
2123016,12,0,12,48,5,0,53,178,19,250
2123017,9,0,9,14,19,0,33,91,7,131
2123101,0,0,0,70,42,3,115,226,12,353
2123102,3,5,8,103,29,6,138,240,13,391
2123103,4,0,4,59,10,0,69,122,6,197
2123104,9,6,15,103,32,0,135,302,36,473
2123105,0,0,0,45,18,9,72,216,40,328
2123106,14,0,14,62,17,0,79,268,14,361
2123107,14,8,22,80,24,6,110,224,29,363
2123108,15,3,18,64,37,3,104,252,18,374
2123109,10,4,14,85,34,0,119,293,14,426
2123110,5,0,5,40,18,3,61,120,5,186
2123111,0,0,0,70,19,3,92,210,26,328
2123112,3,0,3,53,16,0,69,137,24,230
2123113,0,0,0,76,29,5,110,259,21,390
2123114,9,3,12,47,12,4,63,123,13,199
2123115,7,0,7,65,15,0,80,208,15,303
2123116,0,7,7,62,17,0,79,201,19,299
2123117,17,3,20,83,40,3,126,225,30,381
2123118,8,0,8,74,19,0,93,169,6,268
2123119,6,3,9,69,26,4,99,175,7,281
2123120,12,3,15,96,25,3,124,212,52,388
2123121,3,3,6,43,10,3,56,215,32,303
2123122,8,0,8,108,38,3,149,243,30,422
2123201,0,0,0,94,16,0,110,121,8,239
2123202,0,0,0,117,45,0,162,277,22,461
2123203,3,0,3,59,26,6,91,232,19,342
2123204,3,0,3,59,15,3,77,123,12,212
2123205,0,0,0,76,23,0,99,194,31,324
2123206,0,0,0,39,10,0,49,103,9,161
2123207,0,3,3,155,14,11,180,267,21,468
2123208,0,0,0,23,3,0,26,71,3,100
2123209,6,0,6,68,38,3,109,254,15,378
2123210,4,0,4,140,40,12,192,203,9,404
2123211,38,6,44,96,28,12,136,244,22,402
2123212,0,0,0,52,9,0,61,79,0,140
2123213,0,0,0,117,9,3,129,153,9,291
2123214,10,3,13,43,29,4,76,169,21,266
2123215,6,4,10,122,33,6,161,302,11,474
2123216,3,0,3,59,32,0,91,210,28,329
2123217,0,3,3,52,19,4,75,188,20,283
2123218,3,0,6,107,27,9,143,191,15,349
2123219,3,0,3,91,48,3,142,239,12,393
2123220,3,0,3,73,27,0,100,290,15,405
2123221,0,0,0,100,28,3,131,187,3,321
2123222,4,0,4,88,20,8,116,172,3,291
2123223,0,0,0,128,24,11,163,156,16,335
2123224,0,0,0,67,17,4,88,158,69,315
2123225,0,0,0,0,0,0,0,0,0,0
2123226,0,0,0,0,3,0,3,6,0,9
2123227,5,0,5,59,35,0,94,162,9,265
2123228,3,0,3,76,21,6,103,139,7,249
2123229,0,0,0,26,18,0,44,61,0,105
2123230,58,6,64,12,11,0,23,165,15,203
2123301,3,6,9,45,21,7,73,136,10,219
2123302,6,4,10,76,23,0,99,258,11,368
2123303,7,0,7,38,15,0,53,164,15,232
2123304,0,0,0,31,7,0,38,86,15,139
2123305,3,0,3,45,15,0,60,143,9,212
2123306,0,0,0,20,8,3,31,74,0,105
2123307,3,0,3,64,35,10,109,206,26,341
2123308,3,0,3,60,19,3,82,162,4,248
2123309,0,0,0,111,33,7,151,189,16,356
2123310,6,3,9,74,23,0,97,198,13,308
2123401,3,0,3,81,22,3,106,160,10,276
2123402,3,3,6,131,29,11,171,257,30,458
2123403,6,3,9,83,34,4,121,218,13,352
2123404,4,3,7,66,18,5,89,155,6,250
2123405,6,0,6,91,25,9,125,190,13,328
2123406,6,0,6,69,19,6,94,191,3,288
2123407,0,3,3,72,25,0,97,225,12,334
2123408,0,0,0,73,33,6,112,217,10,339
2123409,7,0,7,60,39,9,108,196,8,312
2123501,6,0,6,58,17,3,78,168,45,291
2123502,3,0,3,60,24,3,87,124,30,241
2123503,3,0,3,72,23,7,102,225,28,355
2123504,0,0,0,67,30,3,100,197,34,331
2123505,6,6,15,78,33,6,117,263,48,428
2123506,3,0,3,66,23,0,89,148,7,244
2123507,3,3,6,129,27,15,171,208,24,403
2123508,0,0,0,46,19,0,65,135,15,215
2123509,5,0,5,141,46,10,197,264,10,471
2123510,5,0,5,73,32,3,108,226,15,349
2123511,0,0,0,96,23,6,125,218,19,362
2123512,0,3,3,66,12,0,78,158,18,254
2123513,4,0,4,117,39,5,161,221,27,409
2123514,7,0,7,59,18,3,80,175,21,276
2123515,3,0,3,64,7,3,74,147,10,231
2123516,3,0,3,77,40,12,129,227,19,375
2123517,3,0,3,84,29,3,116,205,16,337
2123518,0,0,0,38,14,0,52,164,25,241
2123519,0,0,0,68,30,0,98,252,27,377
2123520,0,3,6,47,20,3,70,170,28,268
2123521,0,0,0,62,19,0,81,193,18,292
2123601,40,4,44,106,44,4,154,366,18,538
2123602,3,3,6,93,18,4,115,321,41,477
2123603,9,3,15,83,21,6,110,234,24,368
2123604,18,9,27,97,39,0,136,287,36,459
2123605,0,0,0,0,0,0,0,0,0,0
2123606,4,6,10,45,9,0,54,159,31,244
2123607,6,5,11,62,18,3,83,185,52,320
2123608,3,3,6,28,9,0,37,122,33,192
2123609,4,0,4,26,18,3,47,169,15,231
2123610,9,5,14,79,25,0,104,326,59,489
2123611,7,0,7,39,6,0,45,170,22,237
2123612,25,6,31,31,21,0,52,191,20,263
2123613,15,0,15,50,10,4,64,212,16,292
2123614,8,3,11,56,12,0,68,198,42,308
2123615,21,0,21,99,15,6,120,311,30,461
2123616,0,0,0,34,10,0,44,123,9,176
2123617,11,3,14,26,15,3,44,167,18,229
2123618,6,0,6,26,18,0,44,106,26,176
2123701,0,0,0,0,0,0,0,0,0,0
2123702,8,4,12,64,44,3,111,295,38,444
2123703,11,3,14,94,9,0,103,250,27,380
2123704,11,0,11,64,26,5,95,220,24,339
2123705,7,3,10,57,17,6,80,272,35,387
2123706,50,22,72,116,23,0,139,368,84,591
2123707,13,4,17,55,20,3,78,323,30,431
2123708,4,4,8,71,5,0,76,271,40,387
2123709,11,0,11,32,3,0,35,211,39,285
2123710,0,0,0,66,11,0,77,242,33,352
2123711,0,0,0,0,0,0,0,0,0,0
2123712,10,0,10,66,29,0,95,323,30,448
2123713,0,0,0,0,0,0,0,0,0,0
2123714,10,3,13,39,23,3,65,195,35,295
2123715,21,3,24,73,23,3,99,333,32,464
2123716,17,3,23,60,27,0,87,276,27,390
2123717,25,5,30,48,19,0,67,235,34,336
2123718,14,0,14,74,19,0,93,297,31,421
2123719,0,3,3,42,16,0,58,159,18,235
2123720,12,0,15,39,16,0,55,214,21,290
2123721,12,0,12,54,17,3,74,249,37,360
2123722,9,0,9,83,22,4,109,313,49,471
2123723,12,17,29,41,4,0,45,195,98,338
2123724,5,3,8,43,0,0,43,173,32,248
2123725,7,0,7,67,11,0,78,157,23,258
2123726,7,0,7,64,21,0,85,224,28,337
2123727,3,0,3,88,21,3,112,221,24,357
2123728,11,3,14,69,20,3,92,255,21,368
2123729,9,0,9,44,19,3,66,227,28,321
2123730,7,0,7,52,12,0,64,208,29,301
2123731,9,6,15,30,18,0,48,166,29,243
2123801,3,3,6,58,14,0,72,201,53,326
2123802,10,0,10,79,25,0,104,283,32,419
2123803,8,0,8,71,21,0,92,285,41,418
2123804,0,6,6,49,9,0,58,188,38,284
2123805,0,0,0,38,11,3,52,167,42,261
2123806,8,0,8,85,16,0,101,255,36,392
2123807,6,0,6,47,17,0,64,141,27,232
2123808,0,8,8,50,5,0,55,204,50,309
2123809,0,0,0,41,3,0,44,157,47,248
2123810,3,0,3,38,8,0,46,143,24,213
2123811,6,0,6,36,6,3,45,146,24,215
2123812,9,5,14,51,24,0,75,303,66,444
2123813,6,3,9,29,9,0,38,158,22,218
2123814,7,5,12,58,25,0,83,193,28,304
2123815,6,0,6,40,25,4,69,168,31,268
2123816,5,0,5,66,6,3,75,198,35,308
2123817,5,3,8,52,15,0,67,205,39,311
2123818,6,0,6,50,6,0,56,191,26,273
2123819,8,0,8,57,10,0,67,230,14,311
2123820,8,4,12,31,12,0,43,163,26,232
2123821,6,3,9,54,3,0,57,183,21,261
2123822,9,9,18,62,19,0,81,247,49,377
2123823,9,0,9,67,14,0,81,320,76,477
2123824,6,3,9,29,18,0,47,136,22,205
2123825,10,0,10,34,12,0,46,153,19,218
2123826,20,35,55,47,15,3,65,162,84,311
2123827,9,0,9,40,20,3,63,168,11,242
2123828,10,3,13,73,7,0,80,209,27,316
2123829,6,0,6,29,6,0,35,136,9,180
2123830,6,0,6,56,17,6,79,241,35,355
2123831,4,0,4,53,11,4,68,237,26,331
2123832,7,6,13,34,30,3,67,176,40,283
2123833,3,3,6,58,21,5,84,190,21,295
2123834,6,0,6,42,12,6,60,197,18,275
2123835,3,0,3,58,10,0,68,175,20,263
2123836,3,3,6,52,12,0,64,125,103,292
2123837,0,0,0,52,12,0,64,148,5,217
2123838,10,6,16,66,22,0,88,205,30,323
2123839,6,3,9,38,17,0,55,265,31,351
2123840,0,0,0,24,19,0,43,216,21,280
2123841,3,3,6,28,5,0,33,167,48,248
2123842,64,6,70,6,9,0,15,249,36,300
2123843,3,0,3,45,26,0,71,149,6,226
2123844,8,0,8,67,27,0,94,218,19,331
2123845,11,0,11,78,28,3,109,231,28,368
2123846,6,0,6,29,13,0,42,124,19,185
2123847,9,0,9,33,24,0,57,179,25,261
2123848,4,0,4,82,31,0,113,245,18,376
2123849,10,6,16,66,24,0,90,315,31,436
2123850,10,0,10,65,12,0,77,379,74,530
2123851,13,0,13,35,10,0,45,259,24,328
2123852,14,0,14,79,23,0,102,308,28,438
2123853,68,7,79,53,20,3,76,337,46,459
2123854,5,0,5,55,13,4,72,207,40,319
2123855,3,42,45,85,6,0,91,271,151,513
2123856,3,29,32,53,19,0,72,215,92,379
2123857,3,0,3,52,10,0,62,224,21,307
2123858,8,0,8,33,23,0,56,137,24,217
2123859,3,3,6,50,11,0,61,199,24,284
2123860,6,0,6,58,13,6,77,230,25,332
2123861,0,0,0,0,0,0,0,0,0,0
2123862,0,0,0,0,0,0,0,0,0,0
2123863,0,0,0,0,0,0,0,0,0,0
2123864,0,0,0,113,9,11,133,180,25,338
2123865,21,3,24,85,62,0,147,421,52,620
2123866,9,0,9,79,24,3,106,248,52,406
2123867,3,0,3,50,19,0,69,210,30,309
2123868,6,6,12,71,24,6,101,281,34,416
2123869,0,0,0,161,27,4,192,305,18,515
2123870,3,0,3,118,28,6,152,188,21,361
2123871,4,0,4,79,13,6,98,166,16,280
2123872,6,0,6,67,18,0,85,203,17,305
2123873,6,0,6,36,15,0,51,182,24,257
2123874,18,0,18,50,13,0,63,174,20,257
2123901,13,3,16,82,28,3,113,336,31,480
2123902,6,0,6,102,30,0,132,287,24,443
2123903,6,0,6,73,22,9,104,244,27,375
2123904,6,0,6,43,12,0,55,161,15,231
2123905,11,0,11,53,27,4,84,158,12,254
2123906,10,8,18,68,24,5,97,280,67,444
2123907,16,6,22,89,27,0,116,280,18,414
2123908,10,3,13,59,12,3,74,204,18,296
2123909,138,12,150,45,14,4,63,496,49,608
2123910,11,0,11,70,16,6,92,221,23,336
2123911,7,3,10,79,9,6,94,219,6,319
2123912,14,3,17,55,21,0,76,204,34,314
2123913,6,0,6,55,19,0,74,182,14,270
2123914,3,3,6,60,23,0,83,178,30,291
2123915,3,3,6,106,15,0,121,394,49,564
2123916,24,18,42,77,13,4,94,285,66,445
2123917,24,0,24,102,34,10,146,405,41,592
2123918,9,4,13,68,25,6,99,313,47,459
2123919,18,3,21,52,20,0,72,223,22,317
2123920,6,3,9,50,13,6,69,155,9,233
2123921,5,0,5,49,7,3,59,181,9,249
2123922,0,0,0,73,17,9,99,187,20,306
2123923,14,3,17,99,7,0,106,318,20,444
2123924,13,0,13,70,28,3,101,240,29,370
2123925,6,0,6,83,32,4,119,303,25,447
2123926,16,4,20,100,34,0,134,375,36,545
2123927,8,0,8,97,20,3,120,320,28,468
2123928,3,0,3,47,14,3,64,130,18,212
2123929,7,3,10,112,29,0,141,214,21,376
2123930,10,4,14,45,16,3,64,229,28,321
2123931,3,6,9,90,19,0,109,325,59,493
2123932,8,0,8,54,19,0,73,265,29,367
2123933,6,6,12,92,19,3,114,232,33,379
2123934,8,3,11,66,31,0,97,263,27,387
2123935,6,3,9,48,21,0,69,175,7,251
2123936,11,3,14,47,19,0,66,161,20,247
2123937,7,0,7,60,22,0,82,189,25,296
2123938,17,0,17,79,19,0,98,386,30,514
2123939,0,0,0,52,12,0,64,191,14,269
2123940,9,3,12,52,14,0,66,255,17,338
2123941,17,9,26,62,24,0,86,246,19,351
2123942,21,0,21,23,17,0,40,152,15,207
2123943,6,8,14,42,18,0,60,209,43,312
2123944,9,0,9,63,12,0,75,153,9,237
2123945,20,6,26,84,12,0,96,246,29,371
2123946,14,0,14,72,28,0,100,260,34,394
2123947,0,0,0,40,9,0,49,164,34,247
2124001,0,0,0,47,14,3,64,137,18,219
2124002,0,0,0,99,34,7,140,305,18,463
2124003,7,0,7,114,30,10,154,343,60,557
2124004,0,0,0,139,21,3,163,184,41,388
2124005,0,0,5,71,28,3,102,243,31,376
2124006,6,3,9,50,27,0,77,175,29,281
2124007,0,0,0,0,0,0,0,0,0,0
2124008,0,0,0,61,25,3,89,164,21,274
2124009,6,0,6,54,12,0,66,140,3,209
2124010,5,0,5,40,12,3,55,123,21,199
2124011,5,3,8,45,36,0,81,187,15,283
2124012,3,0,3,31,13,3,47,191,6,244
2124013,0,0,0,81,17,3,101,258,6,365
2124014,0,0,0,112,33,0,145,228,21,394
2124015,3,0,3,172,27,4,203,265,30,498
2124016,3,0,3,167,20,4,191,211,15,417
2124017,0,4,4,34,30,0,64,189,4,257
2124018,3,0,3,156,24,7,187,162,23,372
2124019,0,3,3,98,34,3,135,173,10,318
2124020,0,0,0,76,21,3,100,182,20,302
2124021,3,0,3,76,20,4,100,231,15,346
2124022,35,3,38,97,36,6,139,265,15,419
2124023,0,0,0,43,13,0,56,155,13,224
2124024,3,0,3,32,12,3,47,106,7,160
2124025,0,0,0,45,18,3,66,143,15,224
2124026,0,0,0,131,18,10,159,207,36,402
2124027,0,0,0,66,22,3,91,183,32,306
2124028,3,0,3,39,42,3,84,137,10,231
2124029,0,3,3,59,25,0,84,204,6,294
2124030,4,0,4,60,27,3,90,192,23,305
2124031,0,0,0,67,19,0,86,210,18,314
2124032,0,0,0,26,18,0,44,141,6,191
2124101,3,0,3,95,12,5,112,190,18,320
2124102,0,0,0,103,13,6,122,212,10,344
2124103,0,0,0,82,28,3,113,251,29,393
2124104,3,0,3,77,50,3,130,225,23,378
2124105,0,0,0,157,28,9,194,374,32,600
2124106,0,0,0,58,13,3,74,92,14,180
2124107,0,3,3,52,19,0,71,164,17,252
2124108,8,0,8,74,38,4,116,231,23,370
2124109,11,0,11,77,35,0,112,252,29,393
2124110,0,0,0,66,20,6,92,168,18,278
2124111,6,0,6,57,27,6,90,228,18,336
2124112,0,3,3,109,28,0,137,296,19,452
2124113,18,0,18,43,24,6,73,183,20,276
2124114,3,3,6,51,23,0,74,193,21,288
2124115,3,0,6,70,37,4,111,242,16,369
2124116,3,3,6,46,34,3,83,193,14,290
2124117,3,0,3,43,19,9,71,136,24,231
2124118,3,3,6,58,34,0,92,216,26,334
2124119,3,0,3,99,43,0,142,221,21,384
2124120,0,0,0,78,13,0,91,167,15,273
2124121,0,3,3,138,39,10,187,242,22,451
2124122,0,0,0,150,32,5,187,174,35,396
2124123,0,0,0,56,26,0,82,102,0,184
2124124,0,0,0,113,26,6,145,212,27,384
2124125,0,3,3,109,33,5,147,164,18,329
2124126,0,0,0,86,30,6,122,223,19,364
2124127,4,0,4,104,26,0,130,274,13,417
2124128,6,0,6,76,48,3,127,286,33,446
2124129,0,0,0,59,36,0,95,193,9,297
2124130,5,0,5,96,43,11,150,178,21,349
2124131,0,0,0,153,38,7,198,254,15,467
2124132,0,0,0,162,29,6,197,217,34,448
2124133,0,0,0,263,64,16,343,413,43,799
2124134,7,3,10,38,23,3,64,183,29,276
2124135,13,60,73,23,23,0,46,183,137,366
2124136,17,0,17,69,35,0,104,348,28,480
2124137,8,0,8,45,54,4,103,251,15,369
2124138,3,0,3,34,32,6,72,163,14,249
2124139,0,0,0,67,45,0,112,193,6,311
2124140,4,0,4,86,30,8,124,220,14,358
2124141,0,0,0,66,14,0,80,175,9,264
2124142,0,0,0,43,19,0,62,188,29,279
2124143,0,3,3,69,12,0,81,180,18,279
2124144,0,0,0,79,29,0,108,240,17,365
2124145,3,0,3,142,35,18,195,295,22,512
2124146,0,0,0,111,36,6,153,254,16,423
2124147,0,0,0,30,6,0,36,126,9,171
2124148,3,0,3,33,33,0,66,265,41,372
2124149,0,0,0,35,8,0,43,106,8,157
2124150,0,0,0,38,17,9,64,165,29,258
2124151,0,0,0,37,12,0,49,97,15,161
2124152,9,3,12,28,26,4,58,244,21,323
2124153,7,0,7,50,57,6,113,262,20,395
2124154,45,8,53,45,45,4,94,394,62,550
2124155,0,0,3,99,22,4,125,167,26,318
2124201,6,7,13,61,24,3,88,332,87,507
2124202,0,0,0,55,25,3,83,223,38,344
2124203,0,0,0,67,33,0,100,298,49,447
2124204,9,0,9,75,19,0,94,359,74,527
2124205,4,0,4,97,19,0,116,313,101,530
2124206,4,3,11,62,15,0,77,258,51,386
2124207,4,0,4,63,16,3,82,191,33,306
2124208,0,0,0,64,13,0,77,269,81,427
2124209,6,3,9,55,17,0,72,222,61,355
2124210,3,0,3,62,17,0,79,187,56,322
2124211,4,0,4,35,9,6,50,178,52,280
2124212,5,7,12,86,12,3,101,396,56,553
2124213,0,0,0,64,10,0,74,262,32,368
2124214,3,4,7,30,15,0,45,184,27,256
2124215,8,3,11,97,21,3,121,335,65,521
2124216,0,0,0,22,0,0,22,63,42,127
2124217,10,0,10,33,0,3,36,108,47,191
2124218,6,0,6,72,15,6,93,261,111,465
2124219,0,0,0,41,9,0,50,121,85,256
2124220,3,3,6,55,14,6,75,237,41,353
2124221,0,0,0,45,6,6,57,168,40,265
2124222,0,0,0,80,29,0,109,226,48,383
2124223,0,0,0,11,3,0,14,20,8,42
2124224,7,4,11,41,25,3,69,238,67,374
2124225,0,0,3,67,21,0,88,235,59,382
2124226,0,0,0,0,0,0,0,0,0,0
2124227,3,0,3,22,10,0,32,119,33,184
2124301,3,0,3,55,15,0,70,195,25,290
2124302,0,0,0,33,14,3,50,141,26,217
2124303,0,0,0,0,0,0,0,3,0,3
2124304,0,0,0,3,0,0,3,0,0,3
2124305,0,0,0,10,6,0,16,160,25,201
2124306,3,0,3,60,27,0,87,241,42,370
2124307,0,3,3,31,4,0,35,120,3,158
2124308,7,0,7,25,12,0,37,144,47,228
2124309,0,0,0,47,21,0,68,211,37,316
2124310,0,0,0,54,16,3,73,192,29,294
2124311,3,0,3,33,14,0,47,176,35,258
2124312,6,0,6,50,15,0,65,260,86,411
2124313,0,0,0,27,12,0,39,126,28,193
2124314,0,0,0,73,6,4,83,249,64,396
2124315,8,0,8,33,6,0,39,163,34,236
2124316,3,0,3,25,12,0,37,131,25,193
2124317,0,0,0,55,15,3,73,227,58,358
2124318,3,0,3,75,24,0,99,278,52,429
2124319,0,0,0,70,15,0,85,238,32,355
2124320,0,0,0,82,14,3,99,327,69,495
2124321,9,0,9,44,38,0,82,262,42,386
2124322,0,0,0,0,0,0,0,0,0,0
2124323,4,5,9,51,35,0,86,240,51,377
2124324,0,4,4,65,9,0,74,115,37,226
2124325,3,3,6,24,10,0,34,166,38,238
2124326,0,0,0,43,12,0,55,195,38,288
2124327,29,0,29,76,18,0,94,352,55,501
2124328,3,0,3,55,12,0,67,240,51,358
2124329,3,0,3,52,13,3,68,259,51,378
2124330,4,0,4,46,10,0,56,202,48,306
2124331,7,0,7,37,0,3,40,150,26,216
2124332,0,0,0,25,15,0,40,132,18,190
2124333,0,0,0,61,24,3,88,212,38,338
2124334,0,0,0,63,17,0,80,172,16,268
2124335,6,0,6,56,34,0,90,213,43,346
2124336,3,3,6,54,24,0,78,219,49,346
2124337,0,0,0,44,23,0,67,203,25,295
2124338,0,0,0,21,18,0,39,137,40,216
2124339,3,0,3,52,15,0,67,206,12,285
2124340,0,0,0,78,22,3,103,184,58,345
2124341,4,0,4,51,6,0,57,179,35,271
2124342,0,0,0,40,8,0,48,126,20,194
2124343,0,6,6,52,8,0,60,240,39,339
2124344,0,3,3,33,16,0,49,167,25,241
2124401,0,0,0,104,10,0,114,202,12,328
2124402,3,0,3,65,17,0,82,175,4,261
2124403,3,0,3,51,32,6,89,257,28,374
2124404,3,0,3,92,28,0,120,271,21,412
2124405,0,0,0,58,15,0,73,136,30,239
2124406,0,0,0,45,8,5,58,89,10,157
2124407,0,0,0,181,29,7,217,298,46,561
2124408,0,0,0,111,18,6,135,242,25,402
2124409,0,0,0,48,22,0,70,239,9,318
2124410,0,0,0,152,15,3,170,264,6,440
2124411,0,0,0,348,44,9,401,574,70,1045
2124412,0,0,0,101,15,3,119,164,10,293
2124413,0,0,0,27,15,0,42,84,18,144
2124414,3,3,9,100,26,6,132,295,29,456
2124415,0,0,0,116,14,7,137,278,27,442
2124416,0,0,0,82,37,0,119,292,23,434
2124417,0,0,0,39,12,3,54,149,18,221
2124418,3,0,3,77,18,0,95,193,30,318
2124419,0,0,0,48,10,0,58,138,36,232
2124420,0,0,0,134,20,3,157,161,28,346
2124421,6,3,9,54,14,7,75,182,30,287
2124422,4,0,4,35,22,6,63,185,24,272
2124423,3,0,3,66,26,3,95,277,21,393
2124424,0,0,0,73,22,0,95,258,29,382
2124425,0,0,0,47,9,0,56,149,28,233
2124426,0,0,0,84,15,0,99,133,3,235
2124427,0,0,0,42,25,0,67,158,14,239
2124428,3,0,3,66,28,0,94,214,27,335
2124429,3,3,6,105,25,0,130,253,39,422
2124430,0,0,0,53,22,0,75,166,12,253
2124431,0,0,0,96,21,3,120,182,29,331
2124432,0,0,0,169,23,0,192,248,21,461
2124433,3,0,3,88,24,3,115,257,13,385
2124434,0,0,0,101,15,9,125,254,18,397
2124435,0,0,0,70,19,0,89,188,6,283
2124436,0,0,0,106,18,3,127,199,36,362
2124437,0,0,0,116,24,18,158,206,13,377
2124438,0,0,0,185,24,0,209,274,40,523
2124439,0,0,0,86,10,4,100,161,19,280
2124440,0,0,0,177,15,9,201,271,26,498
2124441,0,0,0,122,16,4,142,208,21,371
2124442,0,0,0,115,21,3,139,262,31,432
2124443,0,0,0,203,41,4,248,352,61,661
2124444,3,0,3,100,21,0,121,259,32,412
2124445,0,0,0,99,15,3,117,231,23,371
2124446,0,3,3,66,9,3,78,134,18,230
2124447,0,0,0,50,15,3,68,153,13,234
2124448,0,0,0,62,12,0,74,130,19,223
2124449,4,0,4,1412,205,39,1656,2821,267,4744
2124450,0,0,0,173,23,3,199,255,31,485
2124451,0,0,0,159,30,3,192,249,14,455
2124452,0,0,0,37,18,3,58,150,24,232
2124453,7,3,10,44,18,6,68,203,33,304
2124454,3,3,6,32,21,0,53,150,17,220
2124455,4,0,4,52,26,0,78,207,18,303
2124456,3,0,3,40,18,3,61,148,9,218
2124457,6,0,6,48,15,3,66,188,12,266
2124458,0,0,0,87,19,4,110,165,17,292
2124459,0,0,0,37,9,0,46,113,24,183
2124460,0,0,0,69,17,0,86,132,7,225
2124461,0,0,0,59,18,3,80,103,16,199
2124462,0,0,0,45,9,6,60,134,12,206
2124501,4,0,4,45,40,0,85,308,40,433
2124502,3,0,3,45,30,3,78,271,21,370
2124503,0,0,0,47,9,3,59,193,5,257
2124504,0,0,0,49,22,3,74,144,30,248
2124505,0,0,0,69,22,0,91,225,30,346
2124506,3,0,3,39,42,0,81,231,9,321
2124507,6,0,6,49,15,0,64,196,43,303
2124508,0,6,6,62,29,3,94,259,48,401
2124509,0,0,0,23,9,0,32,162,29,223
2124510,5,0,5,44,22,0,66,198,15,279
2124511,0,0,0,35,22,0,57,155,27,239
2124512,16,0,16,38,15,3,56,152,35,243
2124513,4,0,4,38,36,0,74,239,22,335
2124514,6,3,9,47,34,3,84,305,40,429
2124515,3,0,3,45,19,6,70,197,28,295
2124516,0,0,0,40,27,0,67,160,11,238
2124517,3,0,3,41,21,0,62,174,18,254
2124518,5,0,5,43,58,0,101,240,27,368
2124519,0,0,0,59,25,0,84,198,15,297
2124520,3,0,3,23,15,3,41,120,9,170
2124521,4,0,4,35,9,0,44,153,6,203
2124522,4,0,4,39,13,4,56,101,0,157
2124523,11,3,14,81,43,0,124,327,12,463
2124524,4,0,4,43,24,0,67,208,25,300
2124525,38,0,38,26,21,3,50,193,15,258
2124526,3,3,6,91,16,6,113,310,32,455
2124527,0,0,0,24,28,3,55,141,11,207
2124528,5,0,5,77,32,4,113,347,47,507
2124529,3,3,6,45,31,0,76,225,24,325
2124530,0,0,0,144,33,3,180,309,15,504
2124531,0,0,0,71,31,0,102,318,32,452
2124532,0,0,0,50,34,3,87,284,32,403
2124533,0,0,0,51,23,0,74,175,26,275
2124534,0,0,0,0,0,0,0,0,0,0
2124535,0,0,0,0,0,0,0,0,0,0
2124536,0,0,0,0,0,0,0,0,0,0
2124537,0,0,0,0,0,0,0,0,0,0
2124538,3,0,3,47,26,5,78,186,29,293
2124539,0,3,3,57,31,6,94,310,17,421
2124540,3,0,3,75,21,3,99,277,28,404
2124541,10,0,10,72,25,0,97,290,31,418
2124542,0,0,0,122,28,3,153,234,9,396
2124543,0,0,0,95,36,4,135,247,20,402
2124544,0,0,0,28,11,0,39,102,8,149
2124545,3,0,3,45,6,0,51,124,21,196
2124546,0,0,0,97,35,0,132,288,21,441
2124547,0,0,0,28,22,3,53,155,16,224
2124548,6,0,6,51,28,0,79,267,11,357
2124601,0,0,0,85,18,3,106,316,21,443
2124602,3,0,3,101,24,0,125,326,9,460
2124603,0,0,0,60,17,0,77,267,17,361
2124604,0,0,0,44,16,0,60,228,18,306
2124605,3,3,6,59,16,4,79,206,18,303
2124606,0,0,0,71,23,0,94,248,22,364
2124607,0,6,6,77,19,0,96,201,12,309
2124608,0,0,0,43,14,3,60,178,20,258
2124609,3,3,6,53,29,0,82,278,11,371
2124610,0,0,0,77,24,0,101,305,9,415
2124611,0,0,0,77,21,3,101,254,3,358
2124612,0,0,0,84,15,0,99,226,16,341
2124613,0,0,0,41,8,3,52,139,17,208
2124614,0,0,0,84,20,0,104,256,18,378
2124615,3,3,6,76,32,3,111,308,27,446
2124616,3,0,3,47,19,3,69,166,12,247
2124617,0,0,0,93,25,0,118,313,12,443
2124618,3,0,3,56,13,0,69,154,9,232
2124619,0,0,0,80,20,0,100,166,5,271
2124620,0,0,0,55,17,0,72,192,22,286
2124621,4,0,4,40,18,0,58,161,24,243
2124622,6,0,6,31,9,0,40,194,6,240
2124623,10,0,10,40,15,0,55,180,21,256
2124624,0,0,0,57,24,0,81,184,10,275
2124625,0,0,0,130,18,6,154,280,27,461
2124626,0,0,0,204,25,7,236,370,14,620
2124627,0,0,0,70,10,0,80,189,7,276
2124628,0,0,0,59,16,0,75,209,8,292
2124629,0,0,0,52,15,3,70,152,6,228
2124701,0,0,0,105,18,0,123,222,39,384
2124702,0,0,0,65,16,3,84,186,21,291
2124703,0,0,0,72,34,0,106,269,30,405
2124704,0,0,0,83,23,3,109,311,55,475
2124705,0,0,0,55,16,9,80,208,56,344
2124706,3,0,3,79,29,9,117,306,43,466
2124707,0,0,0,43,9,0,52,144,6,202
2124708,0,0,0,124,9,0,133,225,22,380
2124709,0,0,0,86,18,0,104,227,43,374
2124710,3,0,3,53,25,3,81,235,21,337
2124711,6,0,6,97,27,3,127,273,18,418
2124712,0,0,0,95,9,0,104,199,15,318
2124713,0,4,4,99,24,4,127,279,35,441
2124714,0,0,0,70,16,0,86,287,35,408
2124715,0,0,0,105,22,0,127,293,42,462
2124716,0,0,0,71,24,0,95,211,48,354
2124717,3,0,3,66,9,3,78,216,40,334
2124718,0,0,0,84,18,0,102,218,30,350
2124719,0,0,0,54,21,3,78,190,15,283
2124720,0,0,0,92,12,4,108,195,30,333
2124721,0,0,0,70,15,0,85,281,25,391
2124722,0,0,0,64,26,3,93,314,32,439
2124723,0,0,0,109,15,3,127,270,22,419
2124724,0,0,0,109,36,0,145,307,45,497
2124725,3,0,3,107,30,3,140,308,44,492
2124726,0,0,0,87,13,4,104,221,17,342
2124727,0,0,0,73,28,0,101,253,27,381
2124728,15,0,15,69,12,5,86,215,15,316
2124729,3,0,3,24,12,0,36,115,13,164
2124730,0,0,0,32,3,0,35,126,9,170
2124801,0,0,0,20,10,3,33,40,45,118
2124901,3,0,3,100,17,5,122,224,6,352
2124902,3,0,3,79,8,0,87,227,33,347
2124903,0,0,0,127,18,0,145,282,17,444
2124904,0,0,0,74,16,0,90,209,19,318
2124905,0,0,0,76,9,3,88,210,19,317
2124906,3,0,3,79,13,0,92,185,42,319
2124907,0,0,0,112,4,0,116,246,34,396
2124908,0,0,0,154,12,0,166,339,51,556
2124909,0,0,0,7,4,0,11,9,0,20
2124910,0,0,0,71,14,0,85,205,20,310
2124911,0,0,0,85,16,3,104,208,23,335
2124912,0,0,0,178,25,0,203,324,26,553
2124913,0,0,0,92,16,4,112,204,6,322
2124914,0,0,0,77,14,3,94,137,18,249
2124915,0,0,0,77,18,0,95,161,17,273
2124916,3,0,3,93,22,0,115,183,25,323
2124917,0,0,0,35,9,0,44,135,15,194
2124918,0,0,0,93,9,6,108,271,64,443
2124919,0,0,0,60,6,0,66,125,40,231
2124920,0,0,0,102,20,0,122,226,57,405
2124921,4,0,4,116,18,3,137,231,20,388
2124922,0,0,0,76,7,3,86,161,34,281
2124923,3,0,3,89,25,0,114,171,39,324
2124924,0,0,0,83,12,3,98,182,27,307
2124925,23,6,29,52,18,0,70,206,26,302
2124926,6,0,6,103,22,3,128,214,25,367
2124927,0,0,0,76,0,0,76,210,18,304
2124928,0,0,0,114,13,3,130,219,30,379
2124929,4,0,4,79,15,0,94,158,14,266
2124930,0,0,0,72,3,4,79,125,7,211
2124931,0,0,0,61,15,0,76,101,0,177
2124932,0,0,0,86,10,3,99,212,39,350
2124933,0,0,0,92,15,3,110,250,24,384
2124934,0,0,0,76,12,6,94,210,22,326
2124935,0,0,0,0,0,0,0,0,3,3
2124936,0,0,0,63,15,3,81,105,17,203
2124937,0,0,0,58,6,3,67,133,13,213
2124938,3,0,3,58,8,3,69,188,22,279
2124939,0,0,0,82,16,0,98,199,21,318
2124940,4,0,4,75,17,0,92,139,40,271
2124941,0,0,0,80,14,0,94,146,18,258
2124942,0,0,0,61,9,3,73,147,9,229
2124943,0,0,0,77,21,3,101,230,10,341
2124944,0,0,0,85,6,0,91,204,33,328
2124945,0,0,0,75,19,6,100,199,16,315
2124946,0,0,0,52,10,0,62,110,8,180
2124947,0,0,0,71,11,0,82,149,10,241
2125001,7,0,7,53,22,0,75,276,16,367
2125002,5,0,5,65,20,0,85,201,24,310
2125003,9,4,13,80,16,3,99,257,35,391
2125004,3,6,9,69,30,3,102,292,30,424
2125005,6,0,6,64,19,4,87,231,30,348
2125006,5,0,5,43,11,3,57,243,36,336
2125007,3,0,3,51,34,0,85,350,50,485
2125008,0,0,0,0,0,0,0,12,0,12
2125009,3,0,3,52,29,0,81,333,20,434
2125010,3,0,3,59,31,0,90,248,25,363
2125011,3,0,3,44,28,0,72,284,28,384
2125012,0,0,0,42,12,0,54,156,32,242
2125013,3,0,3,36,23,4,63,204,14,281
2125014,0,0,0,46,23,0,69,263,9,341
2125015,0,0,0,25,13,0,38,119,18,175
2125016,0,0,0,45,19,6,70,131,12,213
2125017,0,0,0,3,3,0,6,0,6,12
2125018,3,0,3,25,24,3,52,185,30,267
2125019,0,0,0,0,0,0,0,0,0,0
2125101,0,0,0,46,12,3,61,97,0,158
2125102,3,0,3,61,32,3,96,225,21,342
2125103,3,0,3,63,31,9,103,190,5,298
2125104,0,0,0,66,27,0,93,215,12,320
2125105,7,0,7,104,45,3,152,325,26,503
2125106,0,0,0,89,26,3,118,310,41,469
2125107,12,3,15,82,27,12,121,359,42,522
2125108,3,0,3,30,32,3,65,123,5,193
2125109,3,0,3,109,34,3,146,293,20,459
2125110,3,0,3,46,17,0,63,192,49,304
2125111,8,0,8,58,18,0,76,186,37,299
2125112,0,0,0,115,51,11,177,366,24,567
2125113,0,0,0,69,14,6,89,232,10,331
2125114,6,3,9,87,29,9,125,348,41,514
2125115,3,0,3,65,27,0,92,209,15,316
2125116,7,0,7,59,37,4,100,215,25,340
2125117,0,0,0,50,25,3,78,143,3,224
2125118,9,0,9,96,39,0,135,333,24,492
2125119,0,3,3,54,11,4,69,165,10,244
2125120,5,0,5,106,41,9,156,371,29,556
2125121,3,5,8,41,10,0,51,191,8,250
2125122,0,0,0,3,0,0,3,4,0,7
2125123,5,0,5,39,19,3,61,149,18,228
2125124,25,3,28,57,19,0,76,231,33,340
2125125,85,3,88,34,5,0,39,240,20,299
2125126,0,0,0,35,21,3,59,139,13,211
2125127,0,0,0,45,23,3,71,153,15,239
2125128,9,0,9,40,15,6,61,204,9,274
2125201,0,0,0,0,0,0,0,7,0,7
2125202,6,0,6,115,35,3,153,245,16,414
2125203,4,0,4,39,28,4,71,177,10,258
2125204,3,3,6,65,42,6,113,301,29,443
2125205,0,4,4,43,23,3,69,161,14,244
2125206,3,0,3,51,26,3,80,186,18,284
2125207,3,0,3,38,39,9,86,198,9,293
2125208,14,0,14,83,42,6,131,331,35,497
2125209,7,0,7,49,19,0,68,199,0,267
2125210,4,0,4,70,48,9,127,268,27,422
2125211,6,3,9,68,37,4,109,205,10,324
2125212,0,0,0,77,44,12,133,254,21,408
2125213,0,0,0,107,34,7,148,248,11,407
2125214,3,0,3,119,18,6,143,275,17,435
2125215,3,0,3,82,42,6,130,219,22,371
2125216,7,0,7,118,39,8,165,315,33,513
2125217,4,0,4,100,42,12,154,311,23,488
2125218,0,0,0,69,43,9,121,206,12,339
2125219,6,0,6,46,46,6,98,266,36,400
2125220,25,61,86,72,33,8,113,268,120,501
2125221,47,0,47,47,24,0,71,262,9,342
2125222,0,0,0,96,36,9,141,222,9,372
2125223,6,0,6,53,27,0,80,201,15,296
2125224,3,3,6,81,23,0,104,246,24,374
2125225,8,6,14,55,45,0,100,255,25,380
2125226,7,0,7,76,26,0,102,246,14,362
2125227,0,0,0,75,32,6,113,207,15,335
2125228,8,0,8,83,26,7,116,259,21,396
2125229,7,6,13,101,47,3,151,290,24,465
2125230,3,0,3,32,11,0,43,189,31,263
2125231,5,18,23,87,57,0,144,369,79,592
2125232,10,0,10,52,28,0,80,213,22,315
2125233,3,3,6,57,31,3,91,234,18,343
2125234,6,3,9,35,35,0,70,169,15,254
2125235,6,6,12,66,34,14,114,217,36,367
2125236,4,0,4,60,32,9,101,169,4,274
2125237,8,24,32,65,24,3,92,238,84,414
2125238,3,3,6,90,15,4,109,305,35,449
2125239,45,0,45,61,31,6,98,311,14,423
2125240,9,0,9,63,39,5,107,272,35,414
2125241,6,0,6,37,24,6,67,123,13,203
2125242,4,0,4,67,35,12,114,220,19,353
2125243,0,0,0,112,43,6,161,263,37,461
2125244,3,0,3,68,23,0,91,230,6,327
2125245,6,0,6,116,62,5,183,418,22,623
2125246,0,0,0,59,8,0,67,198,18,283
2125247,3,3,6,39,16,8,63,143,23,229
2125248,0,0,0,82,38,0,120,233,12,365
2125249,3,0,3,39,32,0,71,132,17,220
2125250,0,0,0,97,25,0,122,246,18,386
2125251,0,0,0,0,0,0,0,0,0,0
2125252,3,0,3,36,13,0,49,106,12,167
2125253,6,0,6,48,24,3,75,166,25,266
2125254,0,0,0,52,19,3,74,154,4,232
2125255,6,4,10,65,22,0,87,241,33,361
2125256,9,3,12,50,15,0,65,170,20,255
2125257,0,0,0,62,19,0,81,194,5,280
2125258,3,0,3,40,12,6,58,124,22,204
2125259,3,0,3,58,21,0,79,192,21,292
2125260,0,0,0,55,18,3,76,135,9,220
2125261,0,0,0,27,22,0,49,127,0,176
2125301,6,0,6,80,23,0,103,161,18,282
2125302,0,0,0,86,17,0,103,213,12,328
2125303,3,0,3,70,28,7,105,197,13,315
2125304,0,0,0,144,28,9,181,266,9,456
2125305,0,0,0,61,14,0,75,153,9,237
2125306,0,0,0,67,18,6,91,268,9,368
2125307,0,0,0,111,37,5,153,272,9,434
2125308,24,7,31,75,36,7,118,262,29,409
2125309,36,0,36,90,20,3,113,329,21,463
2125310,23,0,23,67,11,6,84,185,12,281
2125311,11,0,11,87,29,9,125,276,27,428
2125312,3,0,3,80,17,0,97,198,6,301
2125313,3,0,3,40,32,3,75,249,15,339
2125314,3,3,6,67,21,0,88,234,19,341
2125315,8,3,11,85,40,8,133,338,25,496
2125316,9,4,13,82,30,9,121,286,21,428
2125317,0,0,0,81,28,3,112,209,21,342
2125318,9,0,9,36,11,0,47,165,15,227
2125319,3,0,3,95,45,8,148,270,26,444
2125320,3,3,6,68,49,0,117,267,23,407
2125321,3,0,3,49,22,0,71,225,21,317
2125322,3,3,6,113,43,6,162,258,26,446
2125323,6,0,6,126,46,6,178,311,25,514
2125324,5,0,5,49,18,0,67,146,19,232
2125325,3,0,3,105,37,9,151,317,32,500
2125326,4,0,4,40,22,0,62,217,13,292
2125327,3,0,3,117,41,6,164,285,24,473
2125328,0,0,0,47,24,3,74,150,23,247
2125329,4,0,7,49,26,9,84,199,10,293
2125330,3,0,3,85,27,0,112,208,12,332
2125331,0,0,0,85,11,7,103,241,18,362
2125332,63,0,63,62,27,0,89,317,24,430
2125333,0,0,0,83,44,9,136,244,30,410
2125334,3,0,3,46,29,4,79,256,15,350
2125335,0,0,0,67,38,6,111,232,14,357
2125336,0,3,3,82,33,4,119,247,21,387
2125337,0,0,0,62,34,6,102,187,9,298
2125338,5,0,5,61,36,6,103,224,21,348
2125339,3,0,3,56,23,3,82,130,9,221
2125340,0,0,0,54,17,6,77,152,15,244
2125341,0,0,0,121,38,7,166,266,13,445
2125342,4,0,4,106,25,6,137,262,21,420
2125343,8,0,8,65,44,3,112,310,25,447
2125344,6,0,6,50,26,5,81,245,9,335
2125345,6,3,9,85,28,3,116,269,24,409
2125346,5,3,8,78,30,3,111,321,38,470
2125347,0,0,0,36,20,3,59,140,12,211
2125348,5,0,5,54,14,3,71,196,11,278
2125349,3,0,3,41,11,4,56,132,22,210
2125350,0,0,0,63,32,0,95,193,15,303
2125351,6,0,6,61,27,6,94,329,36,459
2125352,6,0,6,61,19,0,80,204,15,299
2125353,4,0,4,62,35,0,97,222,27,346
2125354,4,0,7,85,37,6,128,270,11,409
2125355,3,0,3,67,24,0,91,308,33,432
2125356,3,3,6,44,21,0,65,129,9,203
2125357,0,0,0,41,21,3,65,137,10,212
2125358,4,10,14,121,25,10,156,305,45,506
2125359,7,8,15,37,20,3,60,188,16,264
2125360,85,11,96,58,32,6,96,407,38,541
2125361,3,0,3,89,17,5,111,215,7,333
2125362,0,3,3,106,23,12,141,207,15,363
2125363,0,0,0,97,42,3,142,268,17,427
2125364,0,0,0,56,24,4,84,146,8,238
2125365,0,0,0,0,0,0,0,0,0,0
2125401,6,0,9,61,40,0,101,212,15,328
2125402,0,3,6,78,34,3,115,244,24,383
2125403,0,3,3,118,37,0,155,288,28,471
2125404,0,3,3,45,15,6,66,166,21,253
2125405,3,3,6,59,36,3,98,219,21,338
2125406,3,0,3,94,35,0,129,247,23,399
2125407,0,0,0,0,0,0,0,0,0,0
2125408,0,0,0,60,22,5,87,290,14,391
2125409,3,0,3,76,27,9,112,255,3,370
2125410,3,3,6,63,25,6,94,237,9,340
2125411,6,0,6,93,30,0,123,218,15,356
2125412,0,0,0,35,9,0,44,146,7,197
2125413,21,3,27,98,47,3,148,330,22,500
2125414,0,0,0,93,20,0,113,261,20,394
2125415,5,0,5,72,24,6,102,209,27,338
2125416,3,0,3,125,40,6,171,332,17,520
2125417,3,0,3,48,38,0,86,175,18,279
2125418,0,0,0,3,0,0,3,3,3,9
2125419,3,3,6,85,29,9,123,305,15,443
2125420,0,0,0,87,28,0,115,235,17,367
2125421,3,0,3,89,37,3,129,217,15,361
2125422,3,3,6,97,37,10,144,276,24,444
2125423,0,0,0,56,12,0,68,175,4,247
2125424,3,0,3,72,34,0,106,235,9,350
2125425,3,3,6,67,21,6,94,245,13,352
2125426,0,0,0,0,0,0,0,0,0,0
2125427,0,0,0,0,0,0,0,0,0,0
2125428,0,0,0,52,27,3,82,153,6,241
2125429,0,3,3,78,19,4,101,283,15,399
2125430,6,3,9,78,42,0,120,251,31,402
2125431,6,0,6,96,45,0,141,289,23,453
2125432,4,0,7,3,42,0,45,177,9,231
2125433,0,0,0,63,9,6,78,115,6,199
2125434,3,0,3,68,4,6,78,165,15,258
2125501,0,0,0,91,16,0,107,208,12,327
2125502,0,0,0,90,6,10,106,140,15,261
2125503,0,0,0,81,17,4,102,266,12,380
2125504,0,3,3,194,49,8,251,413,28,692
2125505,4,0,4,92,20,3,115,222,20,357
2125506,14,0,14,118,21,3,142,247,18,407
2125507,0,0,0,126,19,0,145,210,0,355
2125508,5,0,5,69,20,7,96,137,3,236
2125509,0,0,0,46,20,0,66,104,11,181
2125510,0,0,0,94,13,9,116,189,6,311
2125511,3,0,3,17,9,0,26,129,9,164
2125512,3,0,3,118,22,3,143,326,36,505
2125513,0,0,0,81,25,6,112,198,15,325
2125514,0,0,0,85,6,9,100,186,6,292
2125515,0,0,0,57,9,3,69,193,12,274
2125601,3,0,3,36,18,0,54,150,3,207
2125602,0,0,0,79,16,0,95,142,27,264
2125603,0,0,0,77,3,0,80,210,15,305
2125604,0,0,0,66,18,3,87,134,9,230
2125605,0,0,0,108,28,6,142,269,27,438
2125606,0,0,0,82,16,0,98,190,3,291
2125607,0,0,0,0,0,0,0,0,0,0
2125608,3,0,3,99,19,3,121,328,13,462
2125609,0,0,0,55,32,3,90,246,13,349
2125610,0,0,0,70,7,0,77,160,0,237
2125611,3,0,3,81,16,6,103,169,3,275
2125612,4,0,4,83,15,0,98,248,9,355
2125613,0,0,0,81,17,0,98,202,25,325
2125614,0,0,0,57,6,3,66,166,6,238
2125615,0,0,0,36,11,3,50,116,9,175
2125616,3,0,3,81,31,0,112,318,8,438
2125617,3,0,3,29,9,3,41,136,0,177
2125618,4,0,4,49,22,6,77,250,9,336
2125619,0,0,0,107,25,5,137,286,24,447
2125620,0,0,0,89,20,4,113,238,14,365
2125621,6,0,6,96,27,9,132,309,3,444
2125622,0,0,0,59,39,3,101,361,15,477
2125623,66,17,83,0,14,0,14,219,32,265
2125624,0,0,0,103,26,6,135,256,25,416
2125625,0,0,0,78,27,4,109,219,11,339
2125626,0,0,0,85,18,9,112,296,13,421
2125627,0,0,0,117,25,3,145,265,15,425
2125628,3,0,3,27,24,0,51,131,9,191
2125629,6,0,6,96,26,0,122,322,22,466
2125630,0,0,0,96,27,6,129,256,10,395
2125631,3,0,3,54,9,0,63,168,0,231
2125632,5,0,5,99,15,4,118,265,23,406
2125633,0,0,0,100,20,4,124,217,30,371
2125634,0,0,0,51,13,3,67,137,9,213
2125635,6,3,9,59,24,0,83,305,17,405
2125636,0,0,0,61,16,0,77,121,3,201
2125637,3,0,3,43,13,3,59,196,12,267
2125638,3,0,3,46,9,0,55,205,9,269
2125639,0,0,0,41,13,0,54,127,6,187
2125701,0,0,0,0,0,0,0,0,0,0
2125702,0,0,3,104,28,12,144,217,6,367
2125703,0,0,0,184,37,12,233,229,26,488
2125704,0,0,0,138,15,0,153,283,12,448
2125705,0,0,0,91,19,4,114,181,21,316
2125706,0,0,0,96,24,6,126,203,12,341
2125707,6,0,6,109,24,3,136,169,3,308
2125708,0,0,0,110,15,3,128,244,0,372
2125709,0,0,0,94,18,12,124,155,3,282
2125710,0,0,0,139,27,0,166,162,10,338
2125711,4,0,4,97,16,0,113,226,15,354
2125712,0,0,0,102,23,7,132,235,9,376
2125713,0,0,0,52,13,0,65,88,16,169
2125714,0,4,4,119,20,8,147,264,18,429
2125715,0,0,0,103,15,9,127,126,3,256
2125716,3,0,3,89,23,12,124,168,9,301
2125717,29,6,35,4,16,0,20,244,25,289
2125718,3,0,3,87,18,0,105,243,13,361
2125719,0,0,0,60,14,4,78,173,26,277
2125801,0,0,0,0,0,0,0,0,0,0
2125802,0,0,0,0,0,0,0,10,0,10
2125803,3,0,3,73,19,0,92,293,16,401
2125804,0,0,0,66,28,0,94,160,12,266
2125805,0,0,0,95,34,7,136,283,23,442
2125806,3,0,3,92,21,0,113,203,18,334
2125807,0,0,0,117,28,0,145,301,9,455
2125808,0,0,0,0,0,0,0,0,0,0
2125809,11,0,11,49,21,5,75,221,28,324
2125810,0,0,0,83,19,6,108,207,19,334
2125811,3,0,3,46,9,3,58,176,18,252
2125812,0,0,0,97,16,0,113,211,16,340
2125813,0,3,3,119,15,3,137,242,17,396
2125814,0,0,0,108,15,0,123,222,4,349
2125815,0,0,0,92,34,0,126,216,16,358
2125816,0,0,0,110,28,3,141,217,17,375
2125817,0,0,0,105,26,0,131,187,19,337
2125818,0,0,0,55,10,0,65,124,0,189
2125819,0,0,0,96,19,6,121,227,12,360
2125820,0,0,0,59,18,0,77,116,4,197
2125821,4,0,4,95,17,3,115,124,11,250
2125822,0,0,0,106,27,4,137,218,12,367
2125823,4,0,4,109,15,0,124,174,21,319
2125824,4,0,4,119,31,8,158,292,15,465
2125825,0,0,0,59,14,0,73,140,19,232
2125826,3,0,3,87,36,6,129,233,15,377
2125827,0,0,0,51,25,0,76,196,12,284
2125828,0,0,0,80,24,3,107,188,22,317
2125901,0,0,0,92,23,0,115,242,16,373
2125902,0,3,3,44,5,0,49,126,15,190
2125903,11,0,11,52,24,4,80,203,6,289
2125904,3,0,3,46,20,6,72,190,5,267
2125905,6,0,6,47,37,0,84,186,12,282
2125906,8,0,8,76,38,0,114,266,15,395
2125907,0,0,0,81,30,0,111,254,9,374
2125908,0,0,0,58,48,0,106,218,21,345
2125909,3,3,6,94,34,7,135,292,22,449
2125910,3,0,3,50,12,0,62,198,9,269
2125911,6,0,6,55,25,3,83,264,4,351
2125912,6,0,6,63,28,3,94,336,3,433
2125913,3,0,3,63,31,0,94,331,13,438
2125914,3,0,3,34,27,6,67,221,9,297
2125915,8,0,8,57,39,3,99,238,28,365
2125916,0,0,0,0,0,0,0,0,0,0
2125917,0,0,0,26,27,0,53,97,4,154
2125918,3,0,3,41,16,7,64,208,12,284
2125919,3,0,3,50,11,5,66,193,3,262
2125920,39,3,42,31,16,0,47,195,15,257
2125921,0,0,0,52,12,3,67,144,17,228
2125922,0,6,6,82,43,0,125,242,12,379
2125923,3,6,9,91,30,3,124,237,24,385
2125924,157,14,171,0,11,0,11,286,35,332
2125925,8,3,11,41,17,0,58,201,18,277
2125926,7,0,7,46,27,0,73,183,15,271
2125927,0,0,0,68,33,3,104,263,28,395
2125928,0,0,0,12,7,0,19,163,17,199
2125929,0,0,0,100,21,5,126,309,14,449
2125930,3,0,3,73,19,3,95,279,9,383
2125931,0,0,0,52,23,0,75,268,11,354
2125932,3,0,3,35,20,3,58,185,11,254
2125933,26,3,29,46,22,0,68,224,16,308
2125934,0,0,0,33,18,0,51,137,7,195
2125935,6,4,10,59,26,3,88,194,16,298
2125936,7,0,7,81,34,6,121,279,3,403
2125937,7,0,7,44,23,0,67,168,9,244
2125938,0,0,0,28,18,3,49,121,6,176
2126001,0,0,0,0,0,0,0,0,0,0
2126002,3,0,3,37,12,0,49,205,10,264
2126003,0,0,0,3,0,0,3,6,0,9
2126004,4,0,4,43,41,0,84,209,16,309
2126005,0,0,0,57,32,0,89,253,33,375
2126006,0,0,0,4,0,0,4,21,0,25
2126007,0,0,0,75,32,0,107,367,7,481
2126008,0,0,0,56,33,6,95,199,0,294
2126009,0,0,0,44,27,0,71,214,6,291
2126010,5,0,5,52,24,0,76,257,11,344
2126011,3,0,3,52,27,0,79,254,9,342
2126012,0,0,0,35,0,0,35,148,5,188
2126013,0,0,0,76,40,6,122,333,15,470
2126014,5,0,5,69,51,9,129,245,11,385
2126015,5,3,8,70,23,4,97,221,28,346
2126016,3,0,3,78,26,6,110,250,21,381
2126017,0,0,0,52,20,3,75,163,9,247
2126018,0,7,7,64,22,0,86,230,16,332
2126019,6,0,6,58,21,0,79,277,18,374
2126020,0,0,0,31,9,0,40,192,15,247
2126021,68,15,83,37,23,3,63,358,33,454
2126022,3,0,3,98,28,3,129,234,18,381
2126023,7,0,7,81,31,0,112,279,19,410
2126024,54,13,67,0,9,0,9,178,35,222
2126025,6,0,6,51,20,6,77,170,6,253
2126026,73,6,79,52,22,0,74,342,27,443
2126027,3,0,3,51,26,3,80,250,4,334
2126028,5,0,5,61,10,4,75,200,3,278
2126029,4,0,4,64,33,5,102,249,8,359
2126030,3,0,3,46,22,3,71,203,9,283
2126031,0,4,4,82,20,0,102,187,10,299
2126032,3,0,3,54,18,0,72,208,9,289
2126033,34,0,34,60,28,0,88,241,11,340
2126034,0,0,0,78,19,3,100,243,0,343
2126035,4,0,4,52,29,0,81,303,21,405
2126036,0,0,0,50,23,0,73,211,11,295
2126037,0,0,0,33,18,3,54,159,15,228
2126038,0,0,0,71,26,0,97,301,24,422
2126039,106,18,127,39,15,3,57,402,34,493
2126040,12,0,12,55,12,4,71,185,17,273
2126041,10,3,13,46,27,3,76,258,25,359
2126042,3,3,6,56,29,6,91,283,6,380
2126043,6,0,6,44,30,6,80,197,3,280
2126044,3,0,3,50,22,3,75,286,15,376
2126045,0,0,0,47,15,4,66,211,12,289
2126046,0,0,0,54,23,0,77,214,24,315
2126047,0,0,0,60,14,0,74,201,3,278
2126101,3,0,3,79,40,0,119,253,14,386
2126102,3,0,3,94,44,6,144,268,25,437
2126103,7,0,7,130,45,0,175,352,33,560
2126104,0,0,0,98,44,10,152,262,14,428
2126105,3,0,3,73,40,7,120,174,15,309
2126106,8,3,11,65,36,3,104,225,16,345
2126107,7,0,7,47,19,0,66,153,6,225
2126108,3,6,9,94,50,6,150,342,38,530
2126109,105,15,120,47,28,0,75,357,38,470
2126110,0,0,0,59,16,0,75,146,8,229
2126111,6,0,6,72,39,0,111,214,6,331
2126112,4,0,4,67,32,3,102,244,18,364
2126113,3,0,3,57,20,6,83,137,0,220
2126114,7,0,7,56,33,3,92,173,20,285
2126115,3,0,3,36,18,0,54,136,19,209
2126116,0,0,0,87,49,0,136,276,15,427
2126117,3,0,3,68,26,0,94,186,6,286
2126118,60,11,71,48,18,3,69,247,24,340
2126119,0,0,0,73,30,0,103,175,15,293
2126120,0,0,0,47,10,5,62,122,7,191
2126121,0,0,0,88,31,11,130,258,13,401
2126122,3,0,3,38,19,0,57,109,6,172
2126123,0,0,0,29,8,0,37,126,0,163
2126124,0,0,0,54,30,3,87,143,5,235
2126125,0,0,0,77,53,6,136,274,14,424
2126126,3,0,3,74,28,8,110,173,9,292
2126127,4,0,4,85,41,0,126,319,10,455
2126128,0,0,0,70,23,3,96,172,16,284
2126129,6,0,6,66,37,5,108,228,42,378
2126130,0,0,0,76,55,6,137,232,12,381
2126131,3,0,6,63,33,4,100,234,9,343
2126132,0,0,0,79,20,4,103,163,6,272
2126133,8,0,8,108,32,9,149,281,33,463
2126134,0,0,0,54,25,6,85,165,20,270
2126135,3,0,3,42,18,3,63,168,11,242
2126136,3,3,6,39,18,3,60,88,15,163
2126137,3,4,7,45,19,0,64,138,13,215
2126138,18,0,22,52,26,0,78,201,9,288
2126139,3,0,3,55,32,0,87,198,20,305
2126201,0,0,0,53,9,7,69,135,10,214
2126202,0,0,0,29,19,3,51,131,9,191
2126203,0,0,0,60,31,6,97,183,0,280
2126204,6,0,6,96,30,0,126,209,19,354
2126205,0,0,0,78,27,6,111,171,24,306
2126206,6,0,6,47,8,0,55,126,3,184
2126207,0,0,0,50,18,3,71,134,4,209
2126208,3,0,3,73,17,0,90,213,10,313
2126209,0,0,0,49,12,6,67,111,19,197
2126210,6,0,6,90,38,9,137,274,6,417
2126211,40,0,40,33,22,0,55,245,14,314
2126212,0,0,0,30,15,0,45,96,7,148
2126213,3,0,3,62,16,7,85,192,12,289
2126214,4,3,7,66,19,0,85,162,12,259
2126215,3,0,3,54,32,0,86,172,0,258
2126216,3,0,3,67,14,9,90,139,9,238
2126217,0,0,0,59,14,0,73,154,5,232
2126218,3,3,6,36,20,0,56,108,6,170
2126219,0,0,0,31,12,0,43,128,0,171
2126220,0,0,0,83,23,9,115,119,9,243
2126221,0,0,0,94,21,6,121,152,0,273
2126222,3,0,3,57,15,4,76,101,3,180
2126223,3,0,3,51,16,0,67,112,6,185
2126224,0,0,0,79,38,10,127,182,12,321
2126225,3,0,6,60,21,0,81,157,18,256
2126226,0,0,0,44,8,3,55,128,0,183
2126227,3,0,3,79,22,3,104,203,21,328
2126228,4,0,4,49,32,6,87,191,16,294
2126229,0,0,0,55,22,0,77,135,11,223
2126230,0,0,0,39,21,0,60,149,9,218
2126231,3,0,3,42,24,0,66,159,9,234
2126232,4,0,4,63,29,6,98,138,15,251
2126301,7,4,11,85,27,4,116,281,17,414
2126302,0,6,6,66,29,3,98,299,23,420
2126303,14,3,17,36,13,3,52,272,19,343
2126304,0,0,0,47,12,0,59,109,4,172
2126305,3,0,3,44,20,4,68,149,27,244
2126306,5,0,5,75,19,0,94,207,9,310
2126307,0,0,3,72,28,6,106,190,23,319
2126308,3,0,3,61,33,0,94,141,13,248
2126309,56,3,59,36,27,0,63,240,13,316
2126310,0,0,0,52,10,3,65,127,7,199
2126311,0,0,0,95,41,7,143,259,24,426
2126312,0,3,3,78,14,0,92,179,12,283
2126313,0,0,0,70,10,5,85,100,3,188
2126314,0,0,0,79,21,5,105,132,0,237
2126315,0,0,0,63,17,0,80,183,18,281
2126316,0,0,0,53,11,0,64,158,15,237
2126317,0,0,0,118,40,6,164,268,11,443
2126318,6,0,6,109,27,0,136,266,21,423
2126319,0,3,3,133,31,7,171,309,27,507
2126320,0,0,0,77,26,0,103,216,26,345
2126321,3,4,7,22,9,0,31,175,16,222
2126322,0,0,0,59,22,4,85,170,3,258
2126323,0,0,0,126,28,9,163,257,17,437
2126324,3,0,3,64,21,0,85,209,21,315
2126325,5,0,5,90,21,5,116,224,24,364
2126326,6,64,70,81,28,6,115,211,135,461
2126327,0,0,0,0,0,0,0,3,0,3
2126328,0,0,0,0,0,0,0,0,0,0
2126329,0,0,0,106,18,9,133,162,15,310
2126330,0,0,0,121,43,6,170,220,24,414
2126401,5,0,5,45,21,0,66,145,21,232
2126402,0,0,0,0,0,0,0,0,0,0
2126403,10,0,10,66,39,6,111,219,26,356
2126404,8,3,11,64,21,0,85,221,17,323
2126405,6,0,6,114,21,0,135,187,6,328
2126406,7,0,7,72,26,0,98,190,12,300
2126407,11,0,11,71,34,6,111,271,29,411
2126408,6,0,6,50,24,0,74,150,7,231
2126409,6,4,10,86,43,3,132,288,14,434
2126410,8,0,8,72,22,6,100,253,12,365
2126411,15,4,19,34,20,0,54,194,16,264
2126412,0,0,0,58,11,3,72,137,9,218
2126413,6,0,6,85,28,7,120,242,15,377
2126414,6,3,9,53,28,0,81,229,10,320
2126415,7,0,7,95,34,6,135,209,15,359
2126416,0,0,0,37,16,0,53,99,9,161
2126417,6,4,13,86,48,3,137,356,21,514
2126418,0,0,0,53,13,0,66,146,7,219
2126419,6,0,6,93,36,9,138,250,20,408
2126420,6,0,9,97,54,9,160,287,12,459
2126421,4,0,4,44,14,3,61,108,12,181
2126422,6,0,6,53,13,8,74,157,11,242
2126423,6,3,9,74,20,9,103,258,43,404
2126424,6,0,6,62,60,7,129,244,15,388
2126425,3,0,3,69,42,4,115,211,24,350
2126426,0,0,0,41,15,0,56,199,11,266
2126427,0,0,0,102,33,0,135,317,12,464
2126428,6,0,6,56,8,0,64,179,8,251
2126429,3,3,6,49,27,7,83,200,15,298
2126430,0,0,0,0,0,0,0,0,0,0
2126431,6,6,12,72,43,4,119,285,27,431
2126432,12,4,16,92,19,7,118,238,27,383
2126433,12,3,15,78,24,0,102,193,38,333
2126434,16,3,19,86,35,0,121,378,24,523
2126435,6,0,6,121,37,16,174,361,38,573
2126436,7,3,10,60,20,0,80,173,27,280
2126437,10,3,13,48,22,0,70,299,26,395
2126438,62,4,66,38,13,3,54,283,21,358
2126439,0,5,5,43,13,0,56,166,13,235
2126440,3,0,3,59,9,3,71,163,15,249
2126441,15,0,15,46,30,0,76,275,31,382
2126442,7,3,10,36,6,0,42,132,6,180
2126443,0,0,0,38,16,0,54,118,3,175
2126444,5,0,5,43,33,0,76,167,18,261
2126445,4,3,7,36,15,0,51,130,29,210
2126446,5,0,5,73,35,5,113,226,13,352
2126447,65,3,68,65,26,0,91,370,27,488
2126448,0,0,0,79,31,0,110,188,6,304
2126449,36,3,39,75,36,9,120,322,18,460
2126450,0,0,0,55,32,0,87,161,10,258
2126451,0,3,3,30,22,3,55,144,16,215
2126452,3,0,3,87,24,4,115,177,4,296
2126453,3,0,3,54,31,0,85,165,18,268
2126454,0,0,0,59,28,3,90,161,19,270
2126455,0,0,0,90,6,0,96,160,24,280
2126456,3,0,3,40,23,0,63,165,12,240
2126457,129,22,151,0,19,0,19,373,48,440
2126458,7,0,7,61,36,3,100,205,14,319
2126459,3,3,6,93,33,5,131,307,35,473
2126460,4,3,7,66,18,0,84,196,26,306
2126461,5,0,5,96,29,0,125,213,21,359
2126462,6,4,10,74,25,4,103,239,13,355
2126463,58,8,66,26,35,0,61,256,27,344
2126464,0,0,0,50,26,3,79,177,3,259
2126465,11,0,11,28,16,3,47,154,5,206
2126466,0,41,41,43,14,7,64,109,96,269
2126467,3,0,3,28,21,3,52,177,14,243
2126468,3,0,3,59,27,3,89,153,15,257
2126469,0,0,0,86,29,0,115,208,12,335
2126470,0,0,0,60,9,3,72,148,9,229
2126471,11,0,11,75,34,3,112,353,46,511
2126472,10,0,10,53,25,5,83,117,9,209
2126473,10,4,14,79,38,3,120,278,14,412
2126474,7,3,10,54,15,3,72,266,29,367
2126475,8,0,8,72,34,0,106,218,6,330
2126476,6,3,9,85,30,4,119,194,37,350
2126477,0,0,0,64,34,0,98,236,9,343
2126501,7,3,10,69,32,3,104,260,25,389
2126502,28,3,31,41,22,6,69,274,21,364
2126503,0,0,0,65,6,4,75,189,3,267
2126504,0,0,0,50,29,12,91,196,9,296
2126505,25,0,25,60,22,0,82,240,9,331
2126506,0,0,0,71,29,6,106,251,14,371
2126507,3,0,3,62,30,0,92,216,18,326
2126508,0,0,0,99,19,4,122,218,28,368
2126509,0,0,0,93,20,0,113,271,21,405
2126510,0,0,0,77,31,9,117,199,11,327
2126511,0,0,0,78,29,9,116,267,12,395
2126512,6,3,9,95,50,9,154,264,21,439
2126513,3,3,6,110,37,7,154,302,19,475
2126514,3,0,3,120,26,6,152,235,11,398
2126515,3,0,3,101,31,11,143,278,24,445
2126516,3,0,3,56,27,0,83,118,6,207
2126517,4,0,4,75,17,0,92,245,18,355
2126518,6,0,6,67,22,9,98,178,9,285
2126519,0,0,0,87,33,7,127,278,19,424
2126520,0,4,4,98,37,3,138,283,24,445
2126521,0,3,3,50,9,6,65,132,9,206
2126522,0,0,0,26,9,0,35,128,12,175
2126523,0,0,0,101,51,0,152,267,0,419
2126524,0,0,0,102,28,3,133,217,23,373
2126525,3,0,3,119,25,4,148,166,13,327
2126526,0,0,0,67,11,0,78,141,15,234
2126527,6,0,6,70,11,0,81,164,14,259
2126528,0,0,0,64,14,10,88,178,15,281
2126529,0,0,0,114,13,9,136,252,8,396
2126530,0,0,0,59,30,9,98,145,6,249
2126531,0,0,0,144,23,6,173,192,7,372
2126532,0,0,0,120,15,9,144,159,7,310
2126533,0,0,0,76,18,6,100,197,22,319
2126534,0,0,0,55,19,6,80,181,18,279
2126535,3,0,3,78,39,4,121,212,0,333
2126536,0,0,0,38,16,8,62,150,9,221
2126537,0,0,0,58,11,3,72,201,7,280
2126538,0,0,0,43,20,0,63,103,12,178
2126539,0,0,0,92,16,6,114,192,10,316
2126540,8,0,8,36,11,0,47,108,10,165
2126541,64,6,70,54,7,0,61,266,37,364
2126542,0,0,0,64,13,3,80,97,17,194
2126543,3,3,6,56,17,3,76,167,18,261
2126544,4,4,8,83,34,9,126,278,13,417
2126601,6,0,6,37,24,3,64,133,12,209
2126602,9,0,9,44,19,0,63,153,6,222
2126603,0,0,0,0,0,0,0,3,0,3
2126604,0,0,0,0,0,0,0,5,0,5
2126605,0,0,0,0,0,0,0,0,0,0
2126606,56,0,56,53,23,6,82,346,25,453
2126607,6,0,6,70,27,0,97,292,30,419
2126608,6,3,9,56,39,3,98,243,28,369
2126609,10,0,10,52,22,4,78,127,3,208
2126610,0,0,0,0,0,0,0,0,0,0
2126611,6,7,13,71,20,0,91,139,19,249
2126612,90,8,98,14,12,3,29,252,19,300
2126613,5,0,5,45,12,3,60,131,6,197
2126614,11,3,14,77,25,3,105,253,22,380
2126615,12,3,15,53,12,6,71,191,21,283
2126616,0,0,0,8,0,0,8,36,4,48
2126617,6,0,6,76,18,3,97,259,20,376
2126618,12,7,19,75,22,6,103,260,26,389
2126619,16,0,16,39,15,0,54,247,24,325
2126620,6,6,12,54,10,0,64,141,18,223
2126621,3,0,3,37,15,3,55,231,9,295
2126622,13,3,16,46,18,6,70,267,36,373
2126623,10,4,14,75,31,4,110,214,14,338
2126624,8,0,8,46,15,0,61,135,3,199
2126625,6,6,12,91,24,6,121,200,15,336
2126626,0,0,0,75,14,0,89,123,6,218
2126627,3,0,3,62,19,0,81,175,9,265
2126628,0,0,0,13,6,0,19,74,5,98
2126629,0,0,0,0,0,0,0,0,0,0
2126630,0,0,0,60,28,0,88,187,13,288
2126631,4,0,4,60,33,0,93,187,7,287
2126632,55,0,58,74,32,6,112,359,13,484
2126633,3,0,3,51,17,0,68,152,18,238
2126634,4,0,4,42,10,10,62,155,11,228
2126635,11,3,14,83,25,3,111,290,12,413
2126636,0,0,0,40,19,3,62,199,24,285
2126637,3,0,3,53,18,0,71,194,18,283
2126638,5,0,5,82,38,7,127,328,25,480
2126639,11,0,11,59,33,0,92,146,4,242
2126640,4,3,7,81,35,0,116,202,19,337
2126641,15,3,18,90,37,0,127,257,19,403
2126642,3,3,6,76,29,0,105,145,19,269
2126643,7,0,7,95,29,6,130,293,22,445
2126644,13,0,13,78,34,0,112,306,28,446
2126645,0,3,3,57,19,3,79,211,12,302
2126646,5,0,8,86,43,9,138,284,16,438
2126647,0,0,0,37,9,0,46,162,18,226
2126648,4,0,4,72,23,6,101,203,7,311
2126701,8,0,8,74,19,0,93,222,10,325
2126702,8,3,11,91,40,7,138,267,21,426
2126703,0,0,3,87,44,0,131,234,25,390
2126704,8,3,11,75,29,9,113,201,15,329
2126705,4,0,4,76,21,3,100,183,5,288
2126706,6,4,10,101,22,4,127,224,21,372
2126707,4,3,7,107,35,7,149,290,22,461
2126708,0,0,0,54,15,11,80,164,12,256
2126709,10,0,10,106,22,0,128,304,18,450
2126710,6,0,6,63,21,0,84,157,18,259
2126711,7,4,11,92,30,11,133,256,26,415
2126712,0,4,4,63,50,3,116,259,22,397
2126713,3,0,3,78,40,3,121,195,15,331
2126714,8,3,11,79,34,14,127,246,11,384
2126715,3,3,6,54,24,3,81,157,7,245
2126716,6,6,12,47,19,6,72,189,18,279
2126717,35,4,39,20,10,0,30,168,16,214
2126718,5,0,5,100,39,7,146,266,13,425
2126719,9,7,16,76,22,3,101,265,26,392
2126720,7,5,12,51,20,3,74,252,20,346
2126721,24,3,27,60,16,4,80,303,19,402
2126722,0,0,0,54,38,12,104,170,9,283
2126723,0,0,0,31,12,5,48,95,0,143
2126724,12,10,22,100,16,0,116,208,50,374
2126725,12,0,12,70,30,3,103,204,21,328
2126726,7,6,13,51,28,6,85,215,36,336
2126727,13,0,13,107,26,9,142,272,30,444
2126728,10,0,10,27,18,3,48,157,18,223
2126729,3,3,6,65,29,0,94,171,12,277
2126730,0,0,0,49,15,0,64,197,5,266
2126731,0,0,0,62,40,5,107,145,12,264
2126732,18,0,18,78,37,3,118,318,20,456
2126733,8,0,8,84,57,3,144,243,26,413
2126734,11,0,11,71,22,3,96,180,16,292
2126735,0,6,6,75,33,4,112,243,30,385
2126736,6,3,9,86,35,9,130,213,15,358
2126737,8,0,8,89,34,3,126,293,12,431
2126738,3,3,6,33,11,3,47,135,21,203
2126739,31,0,31,85,14,0,99,260,19,378
2126740,3,0,3,68,16,9,93,215,12,320
2126741,0,0,0,32,18,3,53,148,19,220
2126742,42,13,55,26,12,0,38,205,29,272
2126743,9,3,12,71,27,4,102,363,30,495
2126744,6,3,9,74,13,0,87,178,19,284
2126745,3,0,3,51,22,6,79,174,10,263
2126746,0,3,3,47,23,5,75,108,6,189
2126747,6,0,6,60,23,4,87,148,0,235
2126801,29,0,29,26,22,0,48,173,15,236
2126802,6,0,6,62,36,5,103,162,11,276
2126803,8,3,11,44,25,6,75,164,24,263
2126804,6,0,6,51,33,6,90,242,15,347
2126805,4,3,7,69,37,6,112,324,9,445
2126806,3,0,3,65,18,9,92,252,15,359
2126807,3,0,3,57,24,7,88,300,0,388
2126808,6,3,9,143,46,7,196,309,21,526
2126809,4,0,4,81,24,7,112,223,21,356
2126810,3,0,3,66,25,8,99,184,10,293
2126811,3,6,9,81,23,3,107,221,16,344
2126812,0,0,0,74,29,3,106,182,20,308
2126813,6,0,6,75,15,3,93,140,12,245
2126814,6,0,6,48,20,6,74,147,6,227
2126815,3,18,21,80,35,6,121,243,34,398
2126816,12,0,12,95,51,0,146,297,16,459
2126817,6,0,9,94,51,0,145,269,21,435
2126818,0,0,0,91,33,4,128,238,15,381
2126819,0,0,0,76,12,3,91,160,0,251
2126820,6,0,6,76,19,4,99,195,9,303
2126821,6,0,6,93,34,4,131,187,4,322
2126822,3,0,3,34,4,0,38,129,9,176
2126823,0,0,0,66,7,0,73,74,5,152
2126901,52,3,55,57,29,3,89,310,28,427
2126902,3,3,6,77,40,6,123,239,16,378
2126903,3,3,6,54,18,3,75,250,18,343
2126904,16,6,22,56,29,0,85,194,21,300
2126905,9,0,9,67,30,0,97,241,9,347
2126906,8,3,11,84,35,0,119,298,30,447
2126907,9,0,9,90,42,0,132,288,19,439
2126908,8,4,12,60,38,0,98,286,25,409
2126909,3,3,6,47,19,0,66,194,14,274
2126910,9,0,9,53,19,0,72,218,22,312
2126911,16,6,22,98,42,4,144,362,24,530
2126912,4,3,7,56,32,4,92,239,24,355
2126913,0,0,0,32,15,0,47,148,6,201
2126914,9,0,9,58,27,3,88,218,10,316
2126915,28,103,131,35,12,0,47,149,165,361
2126916,12,0,12,87,35,0,122,234,21,377
2126917,7,0,7,107,29,7,143,298,27,468
2126918,3,0,3,67,25,3,95,184,10,289
2126919,11,3,14,66,18,0,84,231,20,335
2126920,11,0,11,90,18,3,111,299,18,428
2126921,13,0,13,123,47,7,177,313,25,515
2126922,17,4,21,82,28,4,114,328,25,467
2127001,10,0,10,86,44,5,135,299,21,455
2127002,10,0,10,101,41,8,150,273,21,444
2127003,3,0,3,56,21,3,80,161,6,247
2127004,6,0,6,115,42,12,169,281,15,465
2127005,8,0,8,64,37,9,110,240,15,365
2127006,8,5,13,63,38,6,107,206,21,334
2127007,4,0,4,64,18,7,89,257,11,357
2127008,8,0,8,63,20,4,87,178,17,282
2127009,4,0,4,80,20,6,106,247,22,375
2127010,11,3,18,116,42,8,166,264,27,457
2127011,11,0,11,108,26,4,138,285,16,439
2127012,14,0,14,114,46,15,175,284,14,473
2127013,7,0,7,56,29,0,85,257,4,346
2127014,5,0,5,104,20,0,124,247,19,390
2127015,6,0,6,64,16,0,80,170,20,270
2127016,4,6,10,78,20,3,101,238,16,355
2127017,3,3,6,58,17,3,78,173,23,274
2127018,6,3,9,52,27,4,83,197,15,295
2127019,11,3,14,67,14,9,90,226,30,346
2127020,3,3,6,76,11,9,96,156,18,270
2127021,3,0,3,36,0,0,36,130,3,169
2127022,6,0,6,37,9,9,55,165,12,232
2127023,0,3,3,51,34,0,85,268,18,371
2127024,7,0,7,112,48,3,163,248,25,436
2127025,0,3,3,120,37,5,162,243,23,428
2127026,7,3,10,71,19,3,93,216,29,338
2127027,0,7,7,60,12,5,77,195,12,284
2127028,7,4,11,32,26,3,61,182,9,252
2127029,5,0,5,65,21,0,86,192,15,293
2127030,3,3,6,39,25,0,64,94,15,173
2127031,4,0,4,32,14,0,46,152,13,211
2127032,12,3,15,78,27,0,105,208,12,325
2127033,0,0,0,58,21,3,82,101,12,195
2127034,8,0,8,95,16,4,115,194,14,323
2127035,11,0,11,33,14,0,47,184,21,252
2127036,0,0,0,0,0,0,0,0,0,0
2127037,9,6,15,36,15,6,57,186,24,267
2127038,0,0,0,45,14,0,59,138,0,197
2127039,0,0,0,0,0,0,0,0,0,0
2127040,0,0,0,0,0,0,0,0,0,0
2127101,0,0,0,0,0,0,0,0,0,0
2127102,28,4,32,71,20,6,97,226,14,337
2127103,11,3,14,97,32,12,141,286,15,442
2127104,7,0,7,36,18,0,54,163,24,241
2127105,6,0,6,78,30,0,108,339,16,463
2127106,12,3,15,86,16,5,107,246,19,372
2127107,9,0,9,71,11,0,82,164,12,258
2127108,4,0,4,60,26,12,98,206,13,317
2127109,11,3,14,86,34,5,125,297,12,434
2127110,4,0,4,49,22,6,77,191,21,289
2127111,6,0,6,77,14,5,96,223,27,346
2127112,3,0,3,79,18,4,101,154,5,260
2127113,3,3,9,97,31,10,138,245,30,413
2127114,0,0,0,44,6,6,56,106,12,174
2127115,3,0,3,50,8,3,61,163,18,242
2127116,6,0,6,143,29,5,177,293,16,486
2127117,4,3,7,92,26,4,122,213,13,348
2127118,3,0,3,80,0,0,80,175,18,273
2127119,6,3,9,74,22,0,96,199,34,329
2127120,10,3,13,46,17,5,68,127,10,205
2127121,12,0,12,73,33,3,109,299,12,420
2127122,0,0,0,88,26,5,119,162,16,297
2127123,5,0,5,93,24,5,122,349,50,521
2127124,6,6,12,70,16,0,86,192,44,322
2127125,0,0,0,27,9,0,36,98,20,154
2127126,107,8,115,58,16,0,74,380,21,475
2127127,3,0,3,57,17,0,74,159,0,233
2127128,9,3,12,23,13,0,36,140,30,206
2127129,0,0,0,3,0,0,3,0,0,3
2127201,8,0,8,57,19,0,76,176,4,256
2127202,0,4,4,56,24,0,80,165,16,261
2127203,0,0,0,42,34,0,76,189,5,270
2127204,5,3,8,91,30,10,131,269,31,431
2127205,14,0,14,85,54,3,142,338,17,497
2127206,6,0,6,58,32,3,93,239,12,344
2127207,3,0,3,83,15,3,101,159,12,272
2127208,3,0,3,50,18,3,71,173,15,259
2127209,3,0,3,77,26,3,106,200,13,319
2127210,3,3,6,52,33,6,91,166,14,271
2127211,6,0,6,106,29,0,135,207,6,348
2127212,3,3,6,74,18,5,97,182,9,288
2127213,7,0,7,85,52,6,143,254,21,418
2127214,42,3,45,67,20,6,93,286,18,397
2127215,7,0,7,109,43,3,155,278,18,451
2127216,6,0,9,78,33,6,117,258,13,388
2127217,9,0,9,64,31,6,101,255,0,356
2127218,0,3,3,79,32,4,115,199,18,332
2127219,3,0,3,85,26,5,116,251,6,373
2127220,0,3,3,52,17,4,73,154,18,245
2127221,12,0,12,76,23,7,106,192,8,306
2127222,3,3,6,51,25,0,76,155,15,246
2127223,9,0,9,51,24,0,75,212,12,299
2127224,3,0,3,42,20,0,62,166,15,243
2127225,0,0,0,17,15,0,32,65,6,103
2127301,6,0,9,53,23,0,76,184,6,266
2127302,0,3,3,48,27,0,75,197,15,287
2127303,0,0,0,54,16,3,73,179,16,268
2127304,0,0,0,59,27,0,86,208,15,309
2127305,42,11,53,51,15,0,66,291,25,382
2127306,0,0,0,53,42,0,95,237,14,346
2127307,7,3,10,69,39,6,114,290,21,425
2127308,6,6,12,36,34,3,73,114,27,214
2127309,3,0,3,56,27,4,87,182,12,281
2127310,3,0,3,61,21,0,82,207,18,307
2127311,3,0,3,56,19,0,75,137,12,224
2127312,0,14,14,61,42,0,103,183,32,318
2127313,6,0,6,68,48,0,116,261,17,394
2127314,6,0,6,64,34,7,105,251,15,371
2127315,3,3,6,62,27,0,89,184,21,294
2127316,8,3,11,60,43,0,103,236,12,351
2127317,0,0,0,46,27,0,73,200,21,294
2127318,0,0,0,34,19,0,53,162,22,237
2127319,3,3,6,63,36,3,102,175,18,295
2127320,4,3,7,69,39,0,108,179,9,296
2127321,3,0,3,82,43,7,132,254,12,398
2127322,3,0,3,77,42,7,126,214,0,340
2127323,66,0,66,48,37,0,85,345,14,444
2127324,3,3,6,53,41,6,100,286,27,413
2127325,3,0,3,64,39,3,106,206,9,321
2127326,3,0,3,50,21,6,77,208,12,297
2127327,3,0,3,31,28,3,62,141,0,203
2127328,0,0,0,77,38,3,118,212,15,345
2127329,4,0,4,70,40,0,110,276,7,393
2127330,3,3,6,50,31,3,84,221,6,311
2127401,0,0,0,47,23,0,70,120,15,205
2127402,6,0,6,69,36,3,108,209,20,337
2127403,0,0,0,55,16,3,74,148,7,229
2127404,5,0,5,60,9,12,81,225,14,320
2127405,0,0,0,92,37,12,141,202,28,371
2127406,0,0,0,122,25,5,152,220,14,386
2127407,0,0,0,58,15,7,80,129,9,218
2127408,0,0,0,69,27,3,99,168,8,275
2127409,0,0,0,43,17,3,63,151,14,228
2127410,0,0,0,57,5,9,71,96,9,176
2127411,0,0,0,43,20,9,72,132,10,214
2127412,3,0,3,119,39,5,163,235,28,426
2127413,3,0,3,35,28,3,66,105,15,186
2127414,3,3,6,88,19,7,114,154,18,286
2127415,0,3,3,30,20,0,50,88,21,159
2127416,4,0,4,99,24,5,128,226,15,369
2127417,0,0,0,42,12,0,54,86,9,149
2127418,3,0,3,72,27,0,99,194,23,316
2127419,0,0,0,33,21,3,57,112,15,184
2127420,3,0,3,60,18,0,78,183,15,276
2127421,0,3,3,56,3,0,59,176,25,260
2127422,3,0,3,85,23,7,115,176,15,306
2127423,0,0,0,61,18,3,82,127,7,216
2127424,0,0,0,49,12,3,64,107,14,185
2127425,0,0,0,56,18,4,78,159,5,242
2127426,3,0,3,28,6,0,34,91,10,135
2127427,0,0,0,42,14,0,56,132,8,196
2127428,0,0,0,51,21,4,76,149,6,231
2127429,3,0,3,68,19,0,87,165,4,256
2127430,4,0,4,104,36,6,146,254,21,421
2127431,0,0,0,33,22,0,55,130,6,191
2127501,0,4,4,65,33,3,101,226,18,345
2127502,5,0,5,77,29,4,110,263,15,388
2127503,9,0,9,60,41,0,101,249,15,365
2127504,3,0,3,68,32,6,106,189,15,310
2127505,0,3,3,97,58,3,158,277,27,462
2127506,6,0,6,102,29,7,138,234,19,391
2127507,0,0,0,75,40,3,118,199,6,323
2127508,0,0,0,41,18,0,59,99,6,164
2127509,0,0,0,0,0,0,0,0,0,0
2127510,6,3,9,70,30,6,106,283,28,417
2127511,6,0,6,77,38,0,115,208,12,335
2127512,0,0,0,65,23,0,88,195,9,292
2127513,6,0,6,60,32,3,95,259,44,398
2127514,7,0,7,71,33,5,109,165,17,291
2127515,4,0,4,94,40,7,141,265,34,440
2127516,0,0,0,0,0,0,0,0,0,0
2127517,0,0,0,69,33,3,105,241,17,363
2127518,9,0,9,69,57,0,126,252,24,402
2127519,3,6,9,39,30,3,72,215,43,330
2127520,0,0,0,64,11,8,83,176,10,269
2127521,0,0,0,24,46,0,70,200,6,276
2127522,0,0,0,59,22,7,88,143,7,238
2127523,3,0,3,61,19,3,83,120,4,207
2127524,6,0,6,42,15,0,57,120,24,201
2127525,6,3,9,57,20,3,80,155,12,247
2127601,0,0,0,46,22,0,68,83,10,161
2127602,3,3,6,52,14,6,72,187,9,268
2127603,0,7,7,79,33,9,121,293,28,442
2127604,5,0,5,66,26,6,98,198,14,310
2127605,3,0,3,60,27,0,87,159,21,267
2127606,5,0,5,60,31,0,91,218,17,326
2127607,6,0,6,73,26,4,103,225,36,364
2127608,12,0,12,53,11,0,64,190,17,271
2127609,29,3,32,61,28,6,95,254,26,375
2127610,4,5,9,79,46,12,137,315,32,484
2127611,3,3,6,45,21,3,69,152,30,251
2127612,0,0,0,50,18,7,75,139,42,256
2127613,3,0,3,116,32,10,158,224,39,421
2127614,3,0,3,107,37,0,144,262,30,436
2127615,0,0,0,0,0,0,0,0,0,0
2127616,4,0,4,69,35,9,113,259,0,372
2127617,0,0,0,58,26,0,84,150,7,241
2127618,20,3,23,46,13,0,59,219,25,303
2127619,7,0,7,46,15,3,64,177,28,269
2127620,6,0,6,89,42,5,136,300,19,455
2127621,0,0,0,42,16,3,61,127,10,198
2127622,3,0,3,57,13,6,76,145,17,238
2127623,0,0,0,39,17,4,60,125,12,197
2127624,0,0,0,77,16,4,97,96,12,205
2127625,6,0,6,91,30,7,128,182,24,334
2127626,8,0,8,77,30,3,110,209,26,345
2127627,6,0,6,95,34,3,132,277,17,426
2127628,7,0,7,55,32,0,87,172,23,282
2127629,0,0,0,22,15,6,43,112,12,167
2127630,6,0,6,27,9,3,39,107,13,159
2127631,3,0,3,52,29,3,84,183,9,276
2127632,6,0,6,86,40,6,132,215,35,382
2127633,3,0,6,55,24,0,79,152,21,252
2127634,0,0,0,79,12,4,95,142,7,244
2127635,0,0,0,58,23,0,81,221,35,337
2127701,3,0,3,71,16,0,87,169,3,259
2127702,6,0,6,88,47,6,141,275,15,431
2127703,8,4,12,58,40,3,101,303,31,435
2127704,8,0,8,80,46,0,126,286,36,448
2127705,0,0,0,125,38,0,163,249,15,427
2127706,0,0,0,68,27,6,101,221,4,326
2127707,0,0,0,58,27,4,89,155,3,247
2127708,63,7,70,87,47,7,141,342,31,514
2127709,0,0,0,60,20,0,80,179,9,268
2127710,0,0,0,35,24,3,62,212,27,301
2127711,3,0,3,37,13,3,53,136,3,192
2127712,6,3,9,56,26,3,85,252,27,364
2127713,6,0,6,76,49,6,131,308,35,474
2127714,0,0,0,75,35,6,116,260,23,399
2127715,0,0,0,0,0,0,0,0,0,0
2127716,17,14,31,90,33,0,123,329,51,503
2127717,8,0,8,60,18,0,78,185,33,296
2127718,3,0,3,74,30,6,110,223,29,362
2127719,152,15,167,50,27,0,77,421,48,546
2127720,0,0,0,69,28,0,97,180,19,296
2127801,3,0,3,47,12,4,63,108,9,180
2127802,0,0,0,0,0,0,0,60,6,66
2127803,3,0,3,57,13,8,78,178,12,268
2127804,6,0,6,52,24,0,76,186,12,274
2127805,5,0,5,31,22,0,53,151,23,227
2127806,0,0,0,75,35,6,116,245,9,370
2127807,0,0,0,93,24,6,123,194,22,339
2127808,0,0,0,30,26,0,56,143,16,215
2127809,3,3,6,100,33,6,139,268,29,436
2127810,3,0,3,47,26,0,73,189,15,277
2127811,3,0,3,27,12,0,39,123,3,165
2127812,0,0,0,60,17,0,77,100,3,180
2127813,0,0,0,66,22,0,88,145,15,248
2127814,0,0,0,71,27,6,104,138,7,249
2127815,17,0,17,62,34,4,100,267,18,385
2127816,0,0,0,74,15,3,92,215,12,319
2127817,0,0,0,51,18,3,72,138,11,221
2127818,6,0,6,83,39,7,129,307,18,454
2127819,0,3,3,103,22,4,129,180,6,315
2127820,0,0,0,103,40,5,148,268,12,428
2127821,0,0,0,3,0,0,3,12,0,15
2127822,3,0,3,118,21,4,143,292,43,478
2127823,13,5,18,69,38,0,107,243,35,385
2127824,10,0,10,49,36,0,85,190,13,288
2127825,39,6,45,76,29,7,112,294,31,437
2127826,0,0,0,70,25,0,95,272,9,376
2127827,4,0,4,78,22,0,100,195,18,313
2127828,4,5,9,45,22,3,70,210,21,301
2127829,3,0,3,72,27,0,99,263,15,377
2127830,6,3,9,82,35,9,126,314,44,484
2127831,7,0,7,78,31,6,115,279,24,418
2127832,3,3,6,73,42,3,118,203,21,342
2127833,3,0,3,107,24,0,131,190,18,339
2127834,3,3,6,121,38,3,162,277,33,472
2127835,4,0,4,89,35,12,136,198,0,334
2127836,0,0,0,67,19,5,91,167,12,270
2127837,49,16,65,13,17,0,30,248,54,332
2127838,0,0,0,3,0,0,3,0,0,3
2127839,4,0,4,60,16,0,76,258,14,348
2127840,3,0,3,67,22,3,92,150,22,264
2127841,0,0,0,76,26,6,108,203,3,314
2127842,0,0,0,60,30,4,94,159,3,256
2127843,0,0,0,44,16,0,60,183,11,254
2127844,3,0,3,44,24,0,68,117,6,191
2127845,3,0,3,55,20,6,81,145,7,233
2127846,0,0,0,185,25,8,218,263,38,519
2127847,3,0,3,104,41,9,154,261,16,431
2127901,8,0,8,109,32,6,147,245,28,420
2127902,0,0,0,28,12,0,40,136,3,179
2127903,3,0,3,68,22,12,102,189,15,306
2127904,3,0,3,89,41,7,137,302,25,464
2127905,6,3,9,99,46,4,149,292,41,482
2127906,0,3,3,71,23,5,99,167,21,287
2127907,6,0,6,72,44,0,116,215,13,344
2127908,6,3,9,30,19,3,52,171,9,232
2127909,11,0,11,74,25,9,108,238,18,364
2127910,6,0,6,71,20,6,97,183,12,292
2127911,3,0,3,64,30,4,98,180,12,290
2127912,3,0,3,30,22,7,59,142,6,207
2127913,8,7,15,82,36,7,125,232,30,387
2127914,0,0,0,52,13,0,65,139,9,213
2128001,3,0,3,84,30,8,122,204,9,335
2128002,3,0,3,89,35,6,130,184,31,345
2128003,0,0,0,63,28,0,91,145,22,258
2128004,0,0,0,70,28,3,101,186,9,296
2128005,9,0,9,52,26,6,84,152,14,250
2128006,0,0,0,63,19,8,90,173,17,280
2128007,3,69,72,64,24,4,92,212,109,413
2128008,27,73,100,48,20,0,68,205,134,407
2128009,3,0,3,64,27,7,98,217,18,333
2128010,0,0,0,60,18,4,82,177,14,273
2128011,6,0,6,50,21,7,78,115,6,199
2128012,0,3,3,104,53,8,165,319,32,516
2128013,0,0,0,89,26,6,121,217,24,362
2128014,0,0,0,60,27,0,87,197,7,291
2128015,0,0,0,56,15,3,74,127,3,204
2128016,11,9,20,61,26,3,90,196,16,302
2128017,3,0,3,46,14,0,60,137,9,206
2128018,0,0,0,49,27,0,76,81,12,169
2128101,6,3,9,84,30,10,124,320,24,468
2128102,0,0,0,47,31,4,82,174,24,280
2128103,6,6,12,27,15,0,42,91,15,148
2128104,6,5,11,69,34,0,103,203,5,311
2128105,4,3,7,60,36,3,99,175,25,299
2128106,5,0,5,73,31,0,104,277,35,416
2128107,6,0,6,55,16,0,71,146,31,248
2128108,0,0,0,89,13,3,105,197,3,305
2128109,0,0,0,133,19,4,156,148,4,308
2128110,6,0,6,105,39,12,156,297,21,474
2128111,4,0,4,69,43,0,112,244,12,368
2128112,0,0,0,67,19,8,94,227,8,329
2128113,0,0,0,185,38,14,237,204,27,468
2128114,4,0,4,56,27,3,86,208,6,300
2128115,3,0,3,121,23,9,153,249,12,414
2128116,6,0,6,96,29,10,135,238,7,380
2128117,0,0,0,105,43,4,152,294,15,461
2128118,5,0,5,84,31,3,118,255,33,406
2128119,3,0,3,75,35,0,110,243,15,368
2128120,4,0,4,109,26,8,143,281,6,430
2128121,8,4,12,87,20,6,113,260,17,390
2128122,0,0,0,62,14,6,82,114,11,207
2128123,29,7,40,88,39,7,134,288,25,447
2128124,9,4,13,71,32,11,114,295,31,440
2128125,0,0,0,83,29,0,112,195,10,317
2128126,0,0,0,80,38,3,121,222,12,355
2128127,0,0,0,91,43,9,143,263,9,415
2128128,3,0,3,86,55,4,145,272,21,438
2128129,4,0,4,75,25,6,106,263,15,384
2128130,3,0,3,93,34,7,134,237,9,380
2128131,7,3,10,71,54,0,125,286,18,429
2128132,0,0,0,90,29,0,119,275,15,409
2128133,4,0,4,71,28,6,105,214,16,335
2128134,7,0,7,83,15,6,104,201,21,326
2128135,0,0,0,33,13,3,49,109,6,164
2128136,0,0,0,59,51,0,110,173,15,298
2128137,5,0,5,51,23,0,74,128,3,205
2128138,5,0,5,84,20,0,104,243,12,359
2128139,0,0,0,39,22,3,64,159,11,234
2128140,0,0,0,56,22,0,78,200,9,287
2128141,0,0,0,82,46,3,131,258,20,409
2128142,7,3,10,61,21,4,86,330,11,427
2128143,0,0,0,52,17,9,78,117,5,200
2128144,3,0,3,70,29,5,104,259,21,384
2128145,22,6,28,99,29,10,138,326,43,507
2128146,3,0,3,56,38,3,97,234,21,352
2128147,5,0,5,53,15,6,74,133,21,228
2128201,5,0,5,64,32,9,105,259,21,385
2128202,3,0,3,45,18,7,70,144,15,229
2128203,3,3,6,62,29,3,94,209,12,315
2128204,0,0,0,57,25,0,82,124,9,215
2128205,0,0,0,58,35,3,96,214,10,320
2128206,0,0,0,44,9,0,53,110,3,166
2128207,3,0,3,29,12,6,47,128,3,178
2128208,5,0,5,57,19,3,79,131,15,225
2128209,3,0,3,80,3,6,89,213,0,302
2128210,3,0,3,38,19,0,57,151,21,229
2128211,6,3,9,56,33,3,92,180,7,279
2128212,0,0,0,61,31,6,98,207,18,323
2128213,0,0,0,61,26,0,87,152,16,255
2128214,0,0,0,76,23,4,103,196,15,314
2128215,4,0,4,73,29,12,114,262,27,403
2128216,4,0,4,43,20,5,68,210,10,288
2128217,0,0,0,7,0,0,7,9,0,16
2128218,9,0,9,77,31,7,115,208,17,340
2128219,3,3,6,68,36,3,107,201,15,323
2128220,3,0,3,105,39,0,144,302,24,470
2128221,0,0,0,30,15,6,51,73,15,139
2128222,5,3,8,88,28,10,126,251,6,383
2128223,4,0,4,81,27,5,113,264,29,406
2128224,0,0,0,68,28,0,96,173,11,280
2128225,3,0,3,50,10,6,66,113,6,185
2128226,3,3,6,34,9,3,46,126,12,184
2128227,0,0,0,0,0,0,0,0,0,0
2128228,0,0,0,59,13,8,80,156,20,256
2128229,0,0,0,0,0,0,0,0,0,0
2128230,0,0,0,4,0,0,4,5,0,9
2128231,0,0,0,3,0,0,3,0,0,3
2128232,0,0,0,94,32,4,130,253,9,392
2128301,4,0,4,87,23,0,110,132,9,251
2128302,0,3,3,93,41,3,137,193,18,348
2128303,0,0,0,50,13,3,66,124,12,202
2128304,4,0,4,41,28,3,72,172,19,263
2128305,6,3,9,60,15,0,75,201,12,288
2128306,3,3,9,107,49,3,159,308,30,497
2128307,0,0,0,54,18,0,72,144,12,228
2128308,3,0,3,72,26,0,98,137,7,242
2128309,0,0,0,111,20,3,134,211,15,360
2128310,3,0,3,49,24,3,76,172,7,255
2128311,0,0,0,106,34,6,146,245,15,406
2128312,3,0,3,81,37,0,118,144,0,262
2128313,3,0,6,75,32,8,115,183,24,322
2128314,0,0,0,59,36,5,100,172,12,284
2128315,0,0,0,95,10,7,112,129,6,247
2128316,0,0,0,59,30,4,93,171,19,283
2128317,0,0,0,90,29,0,119,227,15,361
2128318,0,0,0,67,16,3,86,115,7,208
2128319,3,0,3,92,21,0,113,169,10,292
2128320,0,5,5,70,25,3,98,180,15,293
2128321,3,0,3,71,16,0,87,155,5,247
2128322,0,0,0,45,7,6,58,149,6,213
2128323,0,0,0,44,20,4,68,138,13,219
2128324,3,0,3,72,22,4,98,173,10,281
2128325,0,0,0,72,25,3,100,147,13,260
2128326,0,0,0,39,8,3,50,102,3,155
2128401,0,0,0,42,21,6,69,149,21,239
2128402,6,0,6,75,22,0,97,193,12,302
2128403,0,0,0,85,21,7,113,190,30,333
2128404,3,3,6,65,26,6,97,208,27,332
2128405,0,0,0,69,26,6,101,200,15,316
2128406,0,0,0,62,6,3,71,121,9,201
2128407,0,0,0,33,11,3,47,120,12,179
2128408,3,0,3,72,30,3,105,181,31,317
2128409,0,0,0,34,24,0,58,138,3,199
2128410,0,0,0,74,31,6,111,206,30,347
2128411,0,3,3,69,30,3,102,209,21,332
2128412,0,0,0,78,17,6,101,159,3,263
2128413,3,0,3,77,29,12,118,259,7,384
2128414,4,0,4,49,13,3,65,121,9,195
2128415,6,0,6,52,33,0,85,195,13,293
2128416,3,0,3,63,23,13,99,214,10,323
2128417,5,3,8,77,31,6,114,205,21,340
2128418,5,6,11,38,9,0,47,113,12,172
2128419,0,0,0,75,28,3,106,212,30,348
2128420,3,0,3,129,47,4,180,353,53,586
2128421,6,5,11,57,24,0,81,190,25,296
2128422,0,0,0,66,20,3,89,179,12,280
2128423,0,0,0,119,36,0,155,216,33,404
2128424,0,3,3,60,24,6,90,169,12,271
2128425,0,0,0,44,12,3,59,98,12,169
2128426,0,0,0,55,16,0,71,181,19,271
2128427,3,0,3,42,12,0,54,104,17,175
2128501,0,0,0,37,18,3,58,85,9,152
2128502,0,0,0,42,4,6,52,80,3,135
2128503,0,0,0,53,18,4,75,127,7,209
2128504,6,0,6,61,18,4,83,170,14,267
2128505,0,0,0,44,22,0,66,160,11,237
2128506,0,3,3,47,21,0,68,115,18,201
2128507,0,0,0,61,10,5,76,166,18,260
2128508,0,0,0,56,16,3,75,110,16,201
2128509,6,0,6,68,24,0,92,218,8,318
2128510,3,3,6,31,13,0,44,100,15,159
2128511,3,0,3,75,29,5,109,155,21,285
2128512,6,0,6,25,16,0,41,78,3,122
2128513,0,0,0,22,0,3,25,96,9,130
2128514,4,0,4,30,9,0,39,127,3,169
2128515,0,0,0,53,6,6,65,124,22,211
2128516,0,0,0,95,18,4,117,159,24,300
2128517,4,3,7,30,6,10,46,144,18,208
2128518,0,0,0,34,18,3,55,114,12,181
2128519,4,0,4,53,9,0,62,151,9,222
2128520,3,3,6,37,32,3,72,152,20,244
2128521,0,0,0,61,15,0,76,129,23,228
2128522,0,0,0,73,17,10,100,141,7,248
2128523,4,0,4,48,19,4,71,98,4,173
2128524,0,0,0,112,20,5,137,205,10,352
2128525,0,4,4,85,30,7,122,176,16,314
2128526,4,0,4,59,26,0,85,148,4,237
2128601,0,0,0,22,3,3,28,85,5,118
2128602,6,0,6,40,18,6,64,173,13,250
2128603,3,0,3,62,28,3,93,189,21,303
2128604,3,0,3,93,28,6,127,177,18,322
2128605,0,0,0,66,21,3,90,168,36,294
2128606,3,0,3,72,25,4,101,105,28,234
2128607,3,3,6,39,16,0,55,130,27,212
2128608,3,3,6,42,14,6,62,135,24,221
2128609,0,0,0,0,0,0,0,0,0,0
2128610,3,0,3,52,27,5,84,178,29,291
2128611,0,0,0,70,38,6,114,220,24,358
2128612,6,3,9,66,29,7,102,138,16,256
2128613,0,0,0,45,6,4,55,177,21,253
2128614,4,0,4,65,28,3,96,220,33,349
2128615,0,0,0,92,26,0,118,210,22,350
2128616,3,0,3,84,26,0,110,153,10,273
2128617,20,0,20,56,28,9,93,200,22,315
2128618,5,0,5,82,30,3,115,251,27,393
2128619,5,0,5,33,5,4,42,102,3,147
2128620,3,0,3,53,28,5,86,148,15,249
2128621,7,3,10,48,18,0,66,190,15,271
2128622,3,0,3,44,13,3,60,131,18,209
2128623,0,0,0,34,15,9,58,132,16,206
2128624,4,3,7,109,32,11,152,294,36,482
2128625,0,3,3,42,6,3,51,105,12,168
2128626,0,0,0,29,14,0,43,129,15,187
2128627,0,0,0,68,22,0,90,197,45,332
2128628,6,3,9,61,26,4,91,166,35,292
2128629,53,3,56,65,18,6,89,298,46,433
2128630,0,0,0,77,24,0,101,184,14,299
2128631,3,0,3,67,33,7,107,213,25,345
2128632,3,0,3,45,15,3,63,118,21,202
2128633,0,0,0,34,19,0,53,119,5,177
2128634,7,0,7,58,30,0,88,195,34,317
2128635,3,0,3,26,9,0,35,102,39,176
2128636,8,0,8,28,21,0,49,106,3,158
2128637,0,0,0,38,9,0,47,95,6,148
2128638,0,0,0,52,12,0,64,136,24,224
2128639,3,3,9,49,16,3,68,157,6,231
2128640,0,0,0,35,18,0,53,125,15,193
2128641,3,3,6,19,15,0,34,67,9,110
2128642,0,4,4,65,33,6,104,253,36,393
2128643,3,0,3,47,32,0,79,187,24,290
2128644,0,0,0,47,26,9,82,149,11,242
2128645,0,0,0,0,0,0,0,0,0,0
2128646,7,0,7,31,12,3,46,115,17,178
2128647,3,0,3,34,21,4,59,144,6,209
2128648,0,0,0,41,10,3,54,109,15,178
2128649,0,0,0,49,22,0,71,165,43,279
2128650,0,0,0,46,11,3,60,123,0,183
2128651,0,5,5,36,7,0,43,128,36,207
2128652,3,0,3,46,18,6,70,143,19,232
2128653,0,0,0,0,0,0,0,0,0,0
2128701,4,0,4,73,41,0,114,277,19,410
2128702,0,0,0,111,17,17,145,165,12,322
2128703,3,0,3,48,32,0,80,240,25,345
2128704,3,0,3,236,58,14,308,531,42,881
2128705,3,0,3,148,19,9,176,157,16,349
2128706,0,0,0,66,11,9,86,191,9,286
2128707,0,0,0,154,29,0,183,239,8,430
2128708,3,0,3,53,23,4,80,242,28,350
2128709,0,0,0,163,43,6,212,254,27,493
2128710,0,0,0,25,23,3,51,136,6,193
2128711,4,0,4,94,25,0,119,228,10,357
2128712,0,0,0,106,27,0,133,218,16,367
2128713,0,0,0,77,11,0,88,183,20,291
2128714,6,3,9,83,18,6,107,262,60,429
2128715,0,0,0,70,4,4,78,87,0,165
2128716,3,3,6,29,12,3,44,102,19,165
2128717,0,0,0,124,17,3,144,150,18,312
2128801,4,0,4,61,18,0,79,179,29,287
2128802,3,0,3,32,19,3,54,126,16,196
2128803,6,0,6,41,16,0,57,105,3,165
2128804,0,0,0,54,24,8,86,157,6,249
2128805,7,0,7,48,31,0,79,165,12,256
2128806,3,0,3,40,17,0,57,124,9,190
2128807,6,0,6,47,22,0,69,184,21,274
2128808,3,0,3,94,42,6,142,274,19,435
2128809,4,0,4,79,28,3,110,245,13,368
2128810,0,0,0,69,26,3,98,146,6,250
2128811,6,0,6,66,37,5,108,247,17,372
2128812,6,0,6,69,29,4,102,209,24,335
2128813,3,0,3,130,50,12,192,286,31,509
2128814,6,0,6,85,27,0,112,211,27,350
2128815,6,0,6,36,25,3,64,178,17,259
2128816,6,0,6,102,30,7,139,244,24,407
2128817,3,0,3,49,28,0,77,153,17,247
2128818,0,0,0,62,28,6,96,125,14,235
2128819,26,0,26,47,13,3,63,147,12,222
2128820,3,0,3,49,18,0,67,168,25,260
2128821,3,0,3,48,8,0,56,100,4,160
2128822,5,0,5,47,28,5,80,137,5,222
2128823,0,0,0,43,16,3,62,103,6,171
2128901,0,0,0,8,3,0,11,11,4,26
2128902,3,0,3,76,16,4,96,209,8,313
2128903,3,3,6,39,14,6,59,115,9,183
2128904,40,0,40,71,21,7,99,307,8,414
2128905,6,0,6,82,43,11,136,257,6,399
2128906,0,0,0,66,13,0,79,163,0,242
2128907,0,0,0,58,11,3,72,120,33,225
2128908,0,0,0,61,31,6,98,171,12,281
2128909,7,0,7,99,31,6,136,269,31,436
2128910,7,5,12,87,27,5,119,263,35,417
2128911,0,0,0,53,25,0,78,182,14,274
2128912,6,0,6,73,23,5,101,199,6,306
2128913,3,0,3,29,15,3,47,82,21,150
2128914,4,0,4,96,20,9,125,245,30,400
2128915,5,0,5,7,10,0,17,48,0,65
2128916,3,0,3,86,22,4,112,160,22,294
2128917,0,0,0,51,12,6,69,171,15,255
2128918,0,0,0,84,29,6,119,290,18,427
2128919,3,0,3,15,13,5,33,85,0,118
2128920,0,0,0,72,15,3,90,160,21,271
2128921,0,0,0,65,25,0,90,231,8,329
2128922,0,0,0,56,18,0,74,156,24,254
2128923,0,0,0,38,16,0,54,133,9,196
2128924,0,0,0,40,10,6,56,86,4,146
2128925,0,0,0,96,27,12,135,210,24,369
2128926,0,4,4,85,17,0,102,186,39,327
2128927,0,0,0,83,25,10,118,168,22,308
2128928,3,0,3,83,20,0,103,202,24,329
2128929,0,0,0,98,19,9,126,216,19,361
2128930,21,6,27,48,8,6,62,127,24,213
2128931,0,0,0,60,36,0,96,109,9,214
2128932,0,0,0,104,22,11,137,178,14,329
2128933,0,0,0,33,10,0,43,99,14,156
2128934,6,0,6,85,46,0,131,210,17,358
2128935,0,0,0,68,21,12,101,165,21,287
2128936,3,0,3,83,25,0,108,231,41,380
2128937,6,0,6,73,35,0,108,219,26,353
2128938,6,3,9,78,20,8,106,172,25,303
2128939,0,0,0,6,0,0,6,3,0,9
2128940,3,0,3,37,11,3,51,101,9,161
2128941,0,0,0,37,15,3,55,85,9,149
2128942,0,0,0,61,0,6,67,169,29,265
2128943,4,0,4,61,23,3,87,164,21,272
2128944,0,0,0,59,8,0,67,139,6,212
2128945,3,0,3,99,14,3,116,211,19,346
2128946,0,0,0,0,0,0,0,0,0,0
2128947,6,0,6,48,13,0,61,135,29,225
2128948,3,4,7,57,28,3,88,165,9,262
2128949,0,3,3,29,12,0,41,85,6,132
2128950,3,0,3,43,13,0,56,117,9,182
2128951,0,0,0,63,20,6,89,159,15,263
2128952,3,0,3,33,15,3,51,142,23,216
2128953,0,0,0,84,37,0,121,264,34,419
2129001,33,6,39,137,41,15,193,371,33,597
2129002,3,0,3,125,23,6,154,207,19,380
2129003,0,3,3,31,14,6,51,109,9,169
2129004,0,0,0,35,22,3,60,172,23,255
2129005,0,0,0,92,28,5,125,290,26,441
2129006,0,0,0,35,9,0,44,143,6,193
2129007,5,0,5,79,37,6,122,239,19,380
2129008,6,0,6,40,10,4,54,129,5,188
2129009,9,0,9,50,31,0,81,213,27,321
2129010,6,3,9,61,19,3,83,155,19,257
2129011,6,0,6,83,30,0,113,232,22,367
2129012,4,0,4,42,17,4,63,191,18,272
2129013,0,0,0,44,10,0,54,138,13,205
2129014,4,0,4,34,16,0,50,121,23,194
2129015,3,4,7,95,18,7,120,230,43,393
2129016,0,0,0,44,6,0,50,93,12,155
2129017,3,0,3,70,37,0,107,242,19,368
2129101,0,0,0,311,71,15,397,485,44,926
2129102,0,0,0,229,41,8,278,422,46,746
2129103,0,0,0,166,28,13,207,313,27,547
2129104,3,0,3,94,38,6,138,224,15,377
2129105,0,0,0,155,25,12,192,242,12,446
2129106,0,0,0,241,56,6,303,378,21,702
2129107,6,0,6,92,41,9,142,259,28,429
2129108,0,0,0,37,24,0,61,170,32,263
2129109,5,0,5,74,19,7,100,242,32,374
2129110,6,0,6,89,28,9,126,206,19,351
2129111,4,3,7,93,12,3,108,177,24,309
2129112,0,0,0,0,0,0,0,9,0,9
2129113,6,0,6,60,7,0,67,127,27,221
2129114,54,3,57,63,15,0,78,265,27,370
2129115,55,14,69,39,18,0,57,263,41,361
2129116,0,0,0,87,25,6,118,217,20,355
2129117,3,0,3,80,26,0,106,237,27,370
2129118,0,0,0,74,37,6,117,213,11,341
2129119,4,0,4,46,13,0,59,152,6,217
2129120,3,0,3,458,74,25,557,820,62,1439
2129121,0,0,0,97,32,3,132,203,26,361
2129201,0,0,0,125,34,8,167,242,23,432
2129202,3,0,3,352,65,12,429,443,62,934
2129203,0,0,0,383,56,13,452,587,71,1110
2129204,0,0,0,143,37,9,189,308,32,529
2129205,6,0,6,180,69,12,261,409,66,736
2129206,3,3,6,61,18,3,82,160,30,272
2129207,76,0,76,24,17,0,41,285,46,372
2129208,16,11,27,46,22,3,71,224,36,331
2129209,15,3,18,44,31,6,81,202,44,327
2129210,3,0,3,167,32,6,205,223,32,460
2129211,0,0,0,87,30,5,122,298,31,451
2129212,4,0,4,103,29,6,138,236,33,407
2129213,0,0,0,30,11,0,41,131,17,189
2129214,3,0,3,94,27,3,124,164,21,309
2129215,3,0,3,105,16,4,125,239,37,401
2129216,0,0,0,129,19,13,161,231,66,458
2129217,3,0,3,107,15,12,134,231,16,381
2129218,3,0,3,80,20,4,104,211,27,342
2129219,0,0,0,124,41,10,175,274,40,489
2129220,0,0,0,106,31,6,143,166,23,332
2129221,6,0,9,72,37,0,109,198,17,324
2129222,0,3,3,89,36,0,125,230,23,378
2129223,3,0,3,59,12,6,77,167,10,254
2129224,0,4,4,61,46,0,107,452,35,594
2129225,0,0,0,83,13,8,104,176,0,280
2129226,0,0,0,213,51,16,280,377,35,692
2129227,14,7,21,48,28,6,82,317,49,448
2129228,0,0,0,156,31,13,200,287,47,534
2129229,0,0,0,73,12,0,85,101,9,195
2129230,3,0,3,65,20,0,85,132,30,247
2129231,4,0,4,103,31,20,154,154,10,318
2129232,3,0,3,31,20,0,51,99,6,156
2129233,0,0,0,122,6,6,134,141,24,299
2129234,3,0,3,543,102,20,665,812,62,1539
2129235,0,0,0,102,14,0,116,105,19,240
2129236,0,0,0,44,12,0,56,78,9,143
2129301,3,0,3,123,31,4,158,271,18,447
2129302,3,0,3,119,18,3,140,187,21,348
2129303,0,0,0,38,23,0,61,158,25,244
2129304,0,0,0,90,24,3,117,185,25,327
2129305,0,0,0,61,15,0,76,119,9,204
2129306,4,0,4,115,22,3,140,208,15,363
2129307,3,0,3,196,42,4,242,340,22,604
2129308,3,0,3,116,16,4,136,194,28,358
2129309,80,21,104,54,30,3,87,355,97,539
2129310,9,0,9,55,18,0,73,225,33,331
2129311,26,9,35,53,36,9,98,284,24,406
2129312,0,8,8,85,20,3,108,322,54,484
2129313,0,4,4,45,15,3,63,137,30,230
2129314,3,0,3,106,35,8,149,365,13,527
2129315,3,0,3,46,30,9,85,167,41,293
2129316,6,0,6,61,36,6,103,276,24,403
2129317,3,0,3,72,21,6,99,256,20,375
2129318,10,3,13,79,50,6,135,281,31,447
2129319,3,3,6,80,24,6,110,266,27,403
2129320,0,0,0,72,28,0,100,283,6,389
2129321,0,0,0,65,23,0,88,196,16,300
2129322,0,0,0,34,22,3,59,136,7,202
2129323,3,0,3,62,23,6,91,178,12,281
2129324,59,16,75,53,35,0,88,370,34,492
2129325,31,0,31,83,19,12,114,214,15,343
2129326,0,3,3,67,43,10,120,216,18,354
2129327,0,0,0,85,26,9,120,278,30,428
2129328,12,3,15,52,32,0,84,206,44,334
2129329,4,0,4,143,26,9,178,212,17,407
2129330,0,0,0,169,37,9,215,324,27,566
2129331,6,0,6,91,32,11,134,180,15,329
2129332,6,0,6,77,37,3,117,334,35,486
2129333,6,0,6,53,40,6,99,166,16,281
2129334,15,7,22,53,34,0,87,317,23,427
2129335,6,0,6,110,35,6,151,321,0,472
2129336,3,0,3,52,18,6,76,191,6,273
2129337,0,0,0,29,7,3,39,95,6,140
2129338,0,0,0,80,15,3,98,166,25,289
2129339,0,0,0,50,18,0,68,121,15,204
2129340,65,0,65,57,27,3,87,283,9,379
2129341,3,0,3,64,21,0,85,197,21,303
2129342,9,0,12,113,23,7,143,291,22,456
2129343,4,0,4,77,32,3,112,236,26,374
2129344,3,0,6,48,10,0,58,198,17,273
2129345,18,12,30,24,13,0,37,107,51,195
2129346,9,3,12,61,38,3,102,182,18,302
2129347,4,0,4,64,12,0,76,138,3,217
2129348,9,0,9,37,17,0,54,130,21,205
2129349,3,0,3,30,12,3,45,111,6,162
2129350,0,0,0,42,17,3,62,141,21,224
2129351,48,0,48,24,23,6,53,290,30,373
2129352,0,0,0,40,17,0,57,100,25,182
2129401,0,0,0,138,31,13,182,253,4,439
2129402,3,0,3,191,36,8,235,286,25,546
2129403,3,0,3,266,55,8,329,443,38,810
2129404,0,0,0,108,26,0,134,121,15,270
2129405,0,0,0,146,14,5,165,236,20,421
2129406,0,0,0,284,56,7,347,378,30,755
2129407,0,0,0,867,108,41,1016,959,70,2045
2129408,0,0,0,88,30,6,124,215,21,360
2129409,3,0,3,135,15,8,158,195,10,363
2129410,5,4,9,154,37,4,195,386,46,627
2129411,0,0,0,171,33,0,204,216,21,441
2129412,0,0,0,81,13,7,101,139,12,252
2129413,0,0,0,71,15,0,86,111,7,204
2129414,0,0,0,113,41,0,154,254,19,427
2129415,0,0,0,77,16,3,96,131,7,234
2129416,0,0,0,84,27,10,121,184,15,320
2129417,0,0,0,100,17,0,117,227,39,383
2129418,3,0,3,121,24,6,151,190,14,355
2129419,0,0,0,101,16,12,129,158,18,305
2129420,0,0,0,105,15,6,126,166,18,310
2129421,3,0,3,87,27,10,124,176,22,322
2129422,0,0,0,166,27,9,202,242,25,469
2129423,4,0,4,197,31,13,241,262,20,523
2129424,0,0,0,45,19,4,68,156,16,240
2129425,0,0,0,50,18,0,68,177,6,251
2129426,4,0,4,102,20,7,129,212,14,355
2129427,0,3,3,82,21,0,103,135,15,253
2129428,0,0,0,91,11,9,111,114,6,231
2129429,0,0,0,44,7,6,57,86,6,149
2129430,0,0,0,375,96,15,486,598,60,1144
2129431,0,0,0,177,32,12,221,243,24,488
2129432,0,0,0,152,21,10,183,220,17,420
2129433,0,0,0,64,4,4,72,118,3,193
2129434,0,0,0,60,18,0,78,161,6,245
2129435,0,0,0,69,6,4,79,98,7,184
2129436,3,0,3,203,51,9,263,313,15,591
2129437,0,0,0,0,0,0,0,0,0,0
2129438,6,0,6,135,43,6,184,323,31,538
2129501,0,0,0,35,3,0,38,118,19,175
2129502,0,0,0,0,0,0,0,0,0,0
2129503,0,0,0,0,0,0,0,0,0,0
2129504,0,0,4,27,23,6,56,181,21,258
2129505,4,0,7,74,19,4,97,250,18,365
2129506,3,0,3,108,35,6,149,328,49,526
2129507,9,3,12,38,6,4,48,166,20,234
2129508,6,6,12,55,34,0,89,266,44,399
2129509,0,0,0,0,0,0,0,3,3,6
2129510,0,0,0,98,35,3,136,359,57,552
2129511,4,0,4,36,9,4,49,180,38,267
2129512,31,3,34,65,15,0,80,329,54,463
2129513,6,3,9,75,21,0,96,268,38,402
2129514,3,0,3,52,10,0,62,158,17,237
2129515,0,0,0,83,23,0,106,276,39,421
2129516,0,0,0,55,22,3,80,159,50,289
2129517,4,0,4,45,7,0,52,192,52,296
2129518,0,0,0,71,3,0,74,242,60,376
2129519,3,0,3,53,21,0,74,215,46,335
2129520,3,0,3,45,18,3,66,211,42,319
2129521,0,8,8,65,9,3,77,230,54,361
2129522,0,0,0,30,13,0,43,205,34,282
2129523,9,6,15,45,5,0,50,204,45,299
2129524,0,0,0,65,27,3,95,235,33,363
2129525,11,0,11,89,35,3,127,316,68,511
2129526,9,6,15,54,29,3,86,268,104,458
2129601,0,0,0,61,35,0,96,184,15,295
2129602,0,0,0,25,7,0,32,102,31,165
2129603,3,0,3,40,8,0,48,140,12,200
2129604,3,0,3,74,14,3,91,153,11,255
2129605,3,3,6,50,6,6,62,226,25,313
2129606,0,0,0,50,12,0,62,150,11,223
2129607,0,0,0,93,20,10,123,247,3,373
2129608,0,0,0,0,0,0,0,0,0,0
2129609,0,0,0,0,0,0,0,0,0,0
2129610,0,0,0,58,18,0,76,168,8,252
2129611,5,0,5,79,25,6,110,378,9,497
2129612,3,0,3,58,24,3,85,260,9,354
2129613,3,0,3,25,12,0,37,125,7,169
2129614,3,0,3,28,15,6,49,139,4,192
2129615,6,0,6,61,15,0,76,238,21,335
2129616,3,3,6,68,25,3,96,237,27,360
2129617,3,0,3,92,28,3,123,317,15,455
2129618,0,0,0,93,23,0,116,276,23,415
2129619,0,0,0,23,14,0,37,107,21,165
2129620,0,0,3,94,20,3,117,248,12,377
2129621,4,0,4,61,25,0,86,226,24,336
2129622,6,0,6,63,26,0,89,279,9,377
2129623,0,0,0,51,10,0,61,153,5,219
2129624,64,0,64,93,21,0,114,384,18,516
2129625,3,3,6,82,36,0,118,300,31,449
2129626,0,0,0,57,22,3,82,248,26,356
2129627,3,0,3,92,27,3,122,252,21,395
2129628,3,0,3,50,36,0,86,239,18,343
2129629,0,0,0,57,11,6,74,158,25,257
2129630,0,0,0,53,13,0,66,112,15,193
2129631,0,0,0,37,9,3,49,197,24,270
2129632,0,0,0,40,9,3,52,179,16,247
2129633,0,0,0,49,19,3,71,181,25,277
2129634,3,0,3,57,8,0,65,233,13,311
2129635,0,0,0,40,10,6,56,191,10,257
2129636,0,0,0,75,28,0,103,252,18,373
2129637,0,0,0,60,13,0,73,229,19,321
2129638,4,0,4,73,22,0,95,229,27,351
2129639,3,0,3,79,11,0,90,273,31,394
2129640,0,0,0,83,18,0,101,233,18,352
2129641,0,0,0,64,9,0,73,260,12,345
2129642,6,0,6,67,30,4,101,256,27,384
2129643,0,3,3,79,34,0,113,251,35,399
2129644,11,3,14,77,40,6,123,283,39,445
2129645,5,0,5,68,35,3,106,360,23,489
2129646,0,0,0,31,10,0,41,144,30,215
2129647,3,0,3,97,25,0,122,300,64,486
2129648,4,0,4,60,31,0,91,295,3,389
2129649,0,0,0,36,7,0,43,105,12,160
2129650,3,0,3,35,16,0,51,202,9,262
2129651,0,0,0,53,38,6,97,225,7,329
2129652,5,0,5,52,21,0,73,192,23,288
2129653,0,3,3,32,21,3,56,120,16,192
2129654,0,3,3,47,24,3,74,179,13,266
2129655,0,0,0,56,21,3,80,167,35,282
2129656,6,0,6,58,15,4,77,210,10,297
2129657,0,0,0,61,25,6,92,210,17,319
2129658,0,0,0,62,23,3,88,187,6,281
2129659,3,3,6,78,38,3,119,218,3,340
2129660,0,0,3,55,15,0,70,198,9,277
2129661,3,0,3,50,20,0,70,170,10,250
2129662,0,0,0,19,15,0,34,175,5,214
2129663,0,0,0,27,13,0,40,170,22,232
2129664,3,0,3,66,9,6,81,208,14,303
2129665,0,0,0,67,10,0,77,165,15,257
2129666,3,0,3,44,12,0,56,92,6,154
2129667,6,0,6,50,31,0,81,216,15,312
2129668,0,0,0,38,9,6,53,137,30,220
2129669,3,0,3,64,0,0,64,213,24,301
2129701,3,0,3,55,21,0,76,254,18,348
2129702,0,0,0,59,21,0,80,154,6,240
2129703,0,0,0,85,29,0,114,204,8,326
2129704,3,0,3,97,17,0,114,262,15,391
2129705,0,0,0,98,22,3,123,339,11,473
2129706,11,3,14,64,15,0,79,230,18,327
2129707,0,0,0,53,16,0,69,158,11,238
2129708,62,0,62,64,7,0,71,281,22,374
2129709,0,0,5,105,28,4,137,328,38,503
2129710,0,4,4,78,18,3,99,192,28,319
2129711,3,0,3,58,19,0,77,178,9,264
2129712,0,0,0,60,16,3,79,189,9,277
2129713,26,0,26,48,22,3,73,287,23,383
2129714,3,0,3,64,29,0,93,276,9,378
2129715,3,3,6,72,9,0,81,231,30,342
2129716,4,3,7,66,34,0,100,238,31,369
2129717,3,3,6,72,31,3,106,169,35,310
2129718,10,0,10,48,20,0,68,254,26,348
2129719,0,0,0,67,18,0,85,223,24,332
2129720,0,0,0,3,0,0,3,3,0,6
2129721,4,0,4,56,25,3,84,242,41,367
2129722,6,0,6,52,20,0,72,235,28,335
2129723,0,0,0,34,21,6,61,177,9,247
2129724,3,0,3,37,14,3,54,183,4,241
2129725,0,0,0,47,7,6,60,151,23,234
2129726,3,0,3,37,18,0,55,136,12,203
2129801,0,0,0,65,37,3,105,169,33,307
2129802,3,3,6,99,26,0,125,180,24,329
2129803,0,0,0,74,20,0,94,178,27,299
2129804,0,0,0,70,25,0,95,195,30,320
2129805,3,0,3,97,23,4,124,183,16,323
2129806,5,0,5,54,15,0,69,160,18,247
2129807,0,0,0,66,13,0,79,124,10,213
2129808,6,0,6,73,34,3,110,305,29,444
2129809,0,0,0,80,11,0,91,157,6,254
2129810,0,0,0,92,19,5,116,240,24,380
2129811,3,0,3,79,10,3,92,240,18,350
2129812,0,0,0,123,21,0,144,278,13,435
2129813,7,0,7,52,12,6,70,160,16,246
2129814,3,0,3,102,34,0,136,232,18,386
2129815,0,0,0,118,23,6,147,235,19,401
2129816,0,0,0,60,9,6,75,181,8,264
2129817,6,0,6,46,13,6,65,92,9,166
2129818,0,0,0,93,26,3,122,280,24,426
2129819,0,3,3,23,7,4,34,106,12,152
2129820,0,0,0,47,12,0,59,155,6,220
2129821,3,3,6,76,28,0,104,306,52,462
2129822,3,0,3,57,34,3,94,191,18,303
2129823,0,0,0,0,0,0,0,0,0,0
2129824,3,0,3,104,23,3,130,230,15,375
2129825,3,0,3,117,21,3,141,204,18,363
2129826,0,0,0,81,20,6,107,233,27,367
2129827,3,0,3,82,33,0,115,223,18,356
2129828,3,3,6,76,26,6,108,184,21,313
2129829,6,0,6,131,34,6,171,224,12,407
2129830,0,0,3,89,16,3,108,151,15,274
2129831,0,0,0,88,12,7,107,187,25,319
2129832,0,0,0,0,0,0,0,0,0,0
2129833,7,0,7,40,23,3,66,192,19,277
2129834,3,0,3,78,20,0,98,235,29,362
2129835,3,0,3,75,17,0,92,237,12,341
2129836,4,3,7,66,26,0,92,246,31,369
2129837,7,0,7,74,43,10,127,316,28,471
2129838,0,0,0,72,18,6,96,168,31,295
2129839,0,0,0,148,30,3,181,244,28,453
2129840,3,0,3,124,26,7,157,294,31,482
2129841,0,3,3,77,19,5,101,167,18,286
2129842,0,0,0,75,9,6,90,135,9,234
2129843,0,0,0,114,13,5,132,242,7,381
2129844,4,0,4,81,20,0,101,223,24,348
2129845,0,0,0,85,26,0,111,241,33,385
2129846,3,0,3,97,15,0,112,268,21,401
2129847,0,0,0,0,0,0,0,0,0,0
2129848,0,0,0,111,22,3,136,221,22,379
2129849,5,0,5,110,33,0,143,273,6,422
2129850,73,6,79,123,28,4,155,318,24,497
2129851,0,0,0,59,15,3,77,187,28,292
2129852,0,4,4,70,22,3,95,173,10,278
2129853,12,0,12,29,15,7,51,148,54,253
2129854,3,3,6,63,35,0,98,207,28,333
2129855,3,0,3,48,22,3,73,142,16,231
2129856,0,0,0,40,25,6,71,160,17,248
2129857,0,0,0,102,6,0,108,217,16,341
2129858,0,0,0,43,13,3,59,109,9,177
2129859,3,0,3,63,16,4,83,122,15,220
2129860,6,3,9,66,43,4,113,317,28,458
2129861,3,0,3,26,12,0,38,118,9,165
2129862,0,0,0,66,14,4,84,146,27,257
2129863,3,0,3,36,9,0,45,145,6,196
2129864,0,0,0,50,16,0,66,172,9,247
2129865,3,0,3,52,16,0,68,160,17,245
2129901,3,0,3,72,17,6,95,197,17,309
2129902,3,0,3,51,14,7,72,109,15,196
2129903,0,0,0,60,25,3,88,194,12,294
2129904,3,3,6,45,45,0,90,191,18,299
2129905,0,0,0,29,22,0,51,134,9,194
2129906,4,0,4,53,25,0,78,190,14,282
2129907,7,0,7,74,28,0,102,266,30,398
2129908,6,0,6,40,29,0,69,176,41,286
2129909,6,0,6,58,30,3,91,205,18,314
2129910,4,0,4,104,24,3,131,242,0,373
2129911,3,0,3,90,40,0,130,321,21,472
2129912,3,0,3,76,15,3,94,191,4,289
2129913,0,0,0,98,14,4,116,217,20,353
2129914,0,0,0,127,31,4,162,287,14,463
2129915,92,11,103,59,22,0,81,332,30,443
2129916,0,0,0,22,15,0,37,155,15,207
2129917,0,0,0,35,6,0,41,133,12,186
2129918,0,0,0,58,22,3,83,125,9,217
2130001,0,0,0,37,24,3,64,160,6,230
2130002,3,0,3,91,21,0,112,170,18,300
2130003,0,0,0,77,40,4,121,232,16,369
2130004,4,0,4,102,36,6,144,265,31,440
2130005,0,3,3,58,25,0,83,215,27,325
2130006,0,0,0,66,14,0,80,142,18,240
2130007,3,0,3,50,16,5,71,215,33,319
2130008,0,0,0,81,35,3,119,257,27,403
2130009,8,4,12,44,24,0,68,222,15,305
2130010,0,0,0,124,33,3,160,254,32,446
2130011,6,0,6,152,38,4,194,344,62,600
2130012,3,0,3,209,59,15,283,514,40,837
2130013,0,0,0,66,9,3,78,135,15,228
2130014,0,0,0,490,84,16,590,934,115,1639
2130015,0,0,0,145,16,6,167,281,49,497
2130016,6,0,6,42,12,0,54,154,24,232
2130017,11,3,14,49,18,0,67,225,24,316
2130018,4,0,4,71,18,3,92,229,37,358
2130019,3,0,3,75,18,4,97,153,48,298
2130020,14,7,21,51,19,0,70,382,72,524
2130021,15,0,15,40,27,0,67,292,28,387
2130022,0,0,0,40,16,3,59,136,9,204
2130023,4,3,7,52,22,0,74,200,24,298
2130024,8,4,12,46,17,0,63,248,28,339
2130025,3,3,6,82,41,0,123,268,35,426
2130026,5,0,5,64,17,5,86,234,47,367
2130027,6,0,6,58,18,0,76,195,20,291
2130028,6,3,9,82,36,4,122,239,28,389
2130029,0,0,0,55,33,0,88,175,15,278
2130030,4,0,4,48,11,0,59,120,9,188
2130031,5,0,5,49,21,0,70,135,26,231
2130032,5,3,8,50,18,3,71,180,26,277
2130033,5,0,5,78,23,3,104,307,42,453
2130034,0,0,0,83,20,0,103,207,32,342
2130035,3,0,3,29,18,0,47,86,15,148
2130036,0,0,0,0,0,0,0,0,0,0
2130037,0,0,0,21,10,0,31,124,4,159
2130038,3,0,3,63,15,3,81,227,23,331
2130039,6,0,6,52,23,6,81,188,24,293
2130040,7,0,7,51,19,3,73,180,38,291
2130101,3,0,3,58,3,6,67,104,9,180
2130102,0,0,0,134,22,6,162,177,25,364
2130103,7,0,7,121,20,9,150,167,24,341
2130104,3,3,6,112,25,12,149,293,36,478
2130105,0,0,0,72,12,7,91,115,13,219
2130106,104,12,116,65,11,0,76,505,63,644
2130107,4,0,4,388,98,15,501,748,101,1350
2130108,4,0,4,86,17,3,106,164,29,299
2130109,0,0,0,96,12,9,117,214,18,349
2130110,6,0,6,67,31,3,101,179,17,297
2130111,0,0,0,98,34,6,138,208,22,368
2130112,0,0,0,430,85,10,525,661,70,1256
2130201,6,0,6,74,17,6,97,218,15,330
2130202,0,0,0,61,19,0,80,153,6,239
2130203,3,0,3,80,37,3,120,322,22,464
2130204,3,0,3,100,14,8,122,231,24,377
2130205,0,0,0,60,25,0,85,118,18,221
2130206,0,0,0,46,16,0,62,155,24,241
2130207,0,0,0,65,14,3,82,218,34,334
2130208,0,0,0,61,21,0,82,149,15,246
2130209,0,3,3,77,18,3,98,228,6,332
2130210,0,0,0,29,8,0,37,132,3,172
2130211,0,0,3,86,36,3,125,186,20,331
2130212,3,0,3,113,43,6,162,263,29,454
2130213,3,0,3,670,156,22,848,1327,131,2306
2130214,3,0,3,63,35,0,98,214,15,327
2130215,3,3,6,68,24,0,92,176,21,289
2130216,3,0,3,142,42,3,187,216,45,448
2130217,0,0,0,53,16,0,69,223,21,313
2130218,0,0,0,0,0,0,0,0,0,0
2130219,4,0,4,81,17,6,104,203,41,348
2130220,6,0,6,112,25,0,137,213,11,361
2130221,0,3,3,53,9,5,67,126,13,206
2130222,0,0,0,64,14,8,86,163,12,261
2130223,3,3,6,83,18,6,107,200,35,342
2130224,0,0,0,64,11,3,78,149,9,236
2130225,0,0,0,101,23,0,124,192,27,343
2130226,0,0,0,241,27,6,274,318,30,622
2130227,0,0,0,175,25,5,205,267,39,511
2130228,0,0,0,106,15,0,121,155,27,303
2130301,6,3,9,45,32,0,77,192,13,282
2130302,3,0,3,64,40,3,107,289,12,408
2130303,0,0,0,44,17,0,61,192,7,260
2130304,0,0,0,417,99,18,534,708,34,1276
2130305,0,0,0,34,9,0,43,123,12,178
2130306,8,0,8,79,31,10,120,289,11,420
2130307,8,3,11,59,27,0,86,213,21,320
2130308,8,0,8,75,38,0,113,283,34,430
2130309,3,3,6,80,33,0,113,257,30,400
2130310,0,0,0,31,9,0,40,136,9,185
2130311,0,0,0,56,12,6,74,157,10,241
2130312,0,0,0,44,15,3,62,118,10,190
2130313,3,3,6,60,23,0,83,196,14,293
2130314,59,52,111,34,23,4,61,348,136,545
2130401,0,0,0,127,28,8,163,204,19,386
2130402,3,0,3,54,13,4,71,136,9,216
2130403,0,3,3,71,8,3,82,129,15,226
2130404,0,0,0,108,31,4,143,202,14,359
2130405,0,0,0,106,21,3,130,210,25,365
2130406,0,0,0,96,24,3,123,153,37,313
2130407,0,0,0,99,17,0,116,163,21,300
2130408,0,0,0,154,25,9,188,208,34,430
2130409,0,0,0,134,29,5,168,266,27,461
2130410,0,0,0,290,47,10,347,375,31,753
2130411,3,0,3,14,12,0,26,71,13,110
2130412,0,0,0,82,20,5,107,191,17,315
2130413,0,0,0,56,18,0,74,126,27,227
2130414,26,0,26,55,10,7,72,217,22,311
2130415,0,3,3,164,48,15,227,381,61,669
2130416,0,0,0,57,10,0,67,144,18,229
2130417,0,0,0,35,12,0,47,92,14,153
2130418,0,0,0,40,16,3,59,110,5,174
2130419,0,0,0,33,12,0,45,111,15,171
2130420,0,0,0,48,9,0,57,122,13,192
2130501,0,0,0,73,15,3,91,156,25,272
2130502,0,0,0,89,6,3,98,261,30,389
2130503,4,0,4,148,22,0,170,272,46,488
2130504,0,0,0,51,12,0,63,124,6,193
2130505,3,0,3,115,45,3,163,342,21,526
2130506,4,0,4,66,18,0,84,282,29,395
2130507,0,0,0,67,20,0,87,179,12,278
2130508,0,0,0,47,15,3,65,178,15,258
2130509,4,3,7,95,38,0,133,385,51,569
2130510,6,0,6,67,18,0,85,226,33,344
2130511,3,0,3,120,23,0,143,327,33,503
2130512,3,0,6,59,9,3,71,185,33,289
2130513,0,0,0,90,28,6,124,249,19,392
2130514,0,0,0,44,9,0,53,111,12,176
2130515,6,0,6,120,37,3,160,373,27,560
2130516,3,3,6,73,23,3,99,232,21,352
2130517,4,0,4,80,24,9,113,261,21,395
2130518,3,0,3,90,29,6,125,240,27,392
2130519,3,0,3,76,21,0,97,219,26,342
2130520,0,3,3,81,16,3,100,262,46,408
2130521,0,0,0,124,31,7,162,283,40,485
2130522,0,0,0,53,16,3,72,122,13,207
2130523,3,3,6,75,12,0,87,245,35,367
2130524,6,3,9,65,26,3,94,256,28,378
2130525,3,0,3,86,27,0,113,188,19,320
2130526,0,0,0,0,0,0,0,3,0,3
2130527,0,0,0,145,27,0,172,259,37,468
2130528,0,0,0,97,18,12,127,142,12,281
2130529,0,0,0,135,15,3,153,318,39,510
2130530,0,0,0,98,29,0,127,228,39,394
2130531,3,0,3,102,25,3,130,265,46,441
2130532,3,0,3,69,18,0,87,249,22,358
2130533,3,0,3,66,8,3,77,154,40,271
2130534,0,0,0,51,0,7,58,104,12,174
2130535,0,0,0,80,17,3,100,230,45,375
2130536,9,3,12,106,25,0,131,299,59,489
2130537,4,0,4,108,33,0,141,312,23,476
2130538,0,0,0,123,18,10,151,292,42,485
2130539,0,0,0,99,24,6,129,227,37,393
2130540,0,0,0,70,16,0,86,243,17,346
2130541,3,0,3,79,16,0,95,182,37,314
2130542,0,0,0,151,13,0,164,352,34,550
2130543,0,0,0,238,51,0,289,467,54,810
2130544,0,0,0,56,9,3,68,131,18,217
2130545,0,0,0,152,40,4,196,316,29,541
2130546,6,0,6,48,22,0,70,173,13,256
2130547,0,0,0,67,18,6,91,212,21,324
2130548,8,3,11,38,26,0,64,206,35,305
2130601,46,3,49,157,15,0,172,328,30,530
2130602,0,0,0,85,4,4,93,158,12,263
2130603,0,0,0,73,15,3,91,223,21,335
2130604,4,0,4,1153,203,41,1397,2106,160,3663
2130605,0,0,0,88,0,6,94,181,18,293
2130606,3,0,3,112,24,0,136,173,12,321
2130607,6,0,6,113,25,7,145,262,25,432
2130608,3,0,3,132,22,4,158,271,25,454
2130609,0,0,0,0,0,0,0,0,0,0
2130610,19,39,58,340,43,15,398,578,132,1108
2130611,0,3,3,67,15,6,88,121,24,233
2130612,0,0,0,62,15,0,77,161,11,249
2130613,0,0,0,182,29,4,215,317,35,567
2130614,0,0,0,64,12,0,76,97,6,179
2130701,3,0,3,45,24,3,72,213,13,298
2130702,0,4,4,126,10,9,145,233,20,398
2130703,0,0,0,107,28,0,135,154,9,298
2130704,0,0,0,128,30,0,158,199,24,381
2130705,3,0,3,143,20,7,170,211,26,407
2130706,0,0,0,115,33,7,155,189,10,354
2130707,0,0,0,79,11,6,96,140,17,253
2130708,0,0,0,118,24,0,142,167,14,323
2130709,0,0,0,100,10,7,117,203,18,338
2130710,3,0,3,87,38,10,135,177,10,322
2130711,0,0,0,149,21,0,170,211,41,422
2130712,0,0,0,92,6,3,101,144,5,250
2130713,0,0,0,76,11,3,90,154,12,256
2130714,0,0,0,58,25,3,86,134,6,226
2130715,0,0,0,84,26,0,110,156,9,275
2130716,0,0,0,97,16,0,113,137,6,256
2130717,0,0,0,112,34,3,149,230,18,397
2130718,0,0,0,73,4,0,77,74,8,159
2130719,0,0,0,202,47,8,257,430,36,723
2130720,0,0,0,128,39,3,170,233,20,423
2130721,3,0,3,47,27,0,74,239,16,329
2130722,0,0,0,87,19,11,117,124,6,247
2130723,0,0,0,84,13,7,104,110,9,223
2130724,3,0,3,113,29,0,142,256,25,423
2130725,0,0,0,114,17,10,141,179,22,342
2130726,6,0,6,59,17,6,82,151,15,248
2130727,0,0,0,77,16,0,93,235,7,335
2130728,0,0,0,41,29,3,73,222,13,308
2130729,3,0,3,35,20,3,58,164,3,225
2130730,0,0,0,90,13,3,106,168,18,292
2130731,0,0,0,71,6,3,80,141,26,247
2130732,0,0,0,82,15,0,97,126,36,259
2130733,0,0,0,73,10,4,87,139,21,247
2130734,0,0,0,57,30,3,90,249,13,352
2130735,3,0,3,87,18,3,108,158,22,288
2130736,0,0,0,60,16,0,76,189,9,274
2130737,0,0,0,102,24,4,130,193,16,339
2130738,0,0,0,101,18,6,125,146,4,275
2130739,0,0,0,69,10,0,79,164,0,243
2130740,0,0,0,106,26,3,135,209,15,359
2130741,32,0,32,100,32,4,136,294,6,436
2130742,0,0,0,124,28,5,157,267,22,446
2130743,0,0,0,103,25,0,128,238,17,383
2130744,6,0,6,82,17,7,106,248,8,362
2130745,0,0,0,150,15,5,170,180,12,362
2130746,3,0,3,151,28,9,188,185,18,391
2130747,0,0,0,159,29,9,197,243,19,459
2130748,3,0,3,158,18,3,179,204,6,389
2130749,0,0,0,117,19,6,142,176,12,330
2130750,0,0,0,111,16,3,130,123,12,265
2130751,3,0,3,88,32,6,126,268,15,409
2130752,0,0,0,66,12,0,78,113,0,191
2130753,0,0,0,90,36,3,129,239,13,381
2130754,0,0,0,90,24,4,118,168,8,294
2130755,0,0,0,111,30,4,145,238,25,408
2130756,0,0,0,0,0,0,0,0,0,0
2130757,0,0,0,102,12,3,117,134,9,260
2130758,0,0,0,22,16,0,38,107,18,163
2130759,0,0,0,84,16,0,100,182,15,297
2130760,0,0,0,90,8,7,105,124,3,232
2130761,0,0,0,74,15,9,98,132,12,242
2130762,0,0,0,87,24,6,117,125,13,255
2130763,0,0,0,70,15,3,88,105,7,200
2130764,0,0,0,103,21,6,130,165,28,323
2130765,0,0,0,86,15,5,106,123,7,236
2130766,0,0,0,72,27,0,99,169,18,286
2130801,3,0,3,102,25,0,127,260,22,409
2130802,0,0,0,47,24,0,71,150,18,239
2130803,4,0,4,80,32,0,112,182,24,318
2130804,0,3,3,70,27,0,97,140,12,249
2130805,0,0,0,96,22,10,128,170,15,313
2130806,0,0,0,50,9,0,59,90,18,167
2130807,0,0,0,0,0,0,0,0,0,0
2130808,0,0,0,34,12,0,46,116,0,162
2130809,6,0,6,51,26,0,77,241,21,339
2130810,0,0,0,76,30,0,106,186,27,319
2130811,0,0,0,46,22,6,74,166,23,263
2130812,3,0,3,44,12,3,59,114,6,179
2130813,0,0,0,62,33,4,99,212,18,329
2130814,3,0,3,74,32,0,106,245,13,364
2130815,0,0,0,54,31,0,85,136,7,228
2130816,3,0,3,29,27,6,62,186,25,273
2130817,6,0,6,140,36,12,188,235,17,440
2130818,6,0,6,76,28,0,104,209,23,336
2130819,0,0,0,44,12,0,56,120,11,187
2130820,0,0,0,91,23,6,120,201,15,336
2130821,7,0,7,49,21,0,70,172,6,248
2130822,6,0,6,44,20,3,67,147,5,219
2130901,4,0,4,59,16,0,75,151,9,235
2130902,0,4,4,74,24,0,98,207,24,329
2130903,6,0,6,70,32,0,102,285,17,404
2130904,4,0,4,81,28,0,109,260,33,402
2130905,4,0,4,52,29,0,81,281,13,375
2130906,3,3,6,67,12,3,82,254,12,348
2130907,3,0,3,73,26,0,99,320,25,444
2130908,0,0,0,35,8,0,43,220,32,295
2130909,0,0,0,44,16,0,60,163,12,235
2130910,0,0,0,64,21,0,85,279,28,392
2130911,6,0,6,42,7,0,49,154,19,222
2130912,3,0,3,46,24,3,73,303,23,399
2130913,3,0,3,45,15,3,63,211,25,299
2130914,10,0,10,64,35,0,99,261,18,378
2130915,4,0,4,45,21,0,66,228,17,311
2130916,6,3,9,85,36,0,121,335,44,500
2130917,0,3,9,53,29,0,82,331,30,443
2130918,4,0,4,51,23,0,74,257,20,351
2130919,0,0,0,47,15,0,62,147,24,233
2130920,0,0,0,25,21,3,49,183,24,256
2130921,3,0,3,30,37,0,67,213,27,307
2130922,0,0,0,47,12,0,59,250,17,326
2130923,4,0,4,61,37,0,98,225,28,351
2130924,7,0,7,63,38,0,101,236,30,367
2130925,10,0,10,48,17,3,68,158,24,250
2130926,9,0,9,84,12,0,96,163,27,286
2130927,38,0,38,15,0,0,15,186,12,213
2130928,45,0,45,47,18,6,71,253,27,351
2130929,0,0,0,31,13,0,44,149,24,217
2130930,3,0,3,29,7,0,36,113,7,156
2130931,0,0,0,0,0,0,0,0,0,0
2130932,0,0,0,34,24,0,58,195,16,269
2131001,8,0,8,74,23,0,97,304,46,447
2131002,6,0,6,50,16,4,70,215,59,344
2131003,9,0,12,84,36,0,120,417,67,604
2131004,6,0,6,31,4,0,35,151,21,207
2131005,8,3,11,69,15,0,84,190,33,307
2131006,3,0,3,28,19,4,51,159,5,215
2131007,6,0,6,43,28,0,71,256,25,352
2131008,4,0,4,31,15,0,46,123,15,184
2131009,8,3,11,66,19,0,85,258,26,369
2131010,6,3,9,60,26,0,86,245,37,368
2131011,0,0,0,151,24,0,175,439,38,652
2131012,0,0,0,68,8,0,76,294,39,409
2131013,0,0,0,44,12,3,59,189,20,268
2131014,3,0,3,74,7,0,81,242,24,347
2131015,6,0,6,52,6,0,58,223,25,306
2131016,3,3,6,75,6,3,84,205,26,315
2131017,12,0,12,58,23,6,87,286,37,410
2131018,9,0,9,22,23,3,48,195,3,246
2131019,6,0,6,98,36,3,137,303,35,475
2131020,6,0,6,88,15,0,103,361,40,504
2131021,0,0,0,0,0,0,0,3,3,6
2131022,0,0,0,32,23,0,55,199,18,272
2131023,6,0,10,79,36,0,115,331,10,456
2131024,6,0,6,52,37,0,89,278,19,386
2131025,3,0,3,56,18,6,80,256,33,369
2131026,6,4,10,37,25,3,65,240,25,330
2131027,0,0,0,0,0,0,0,0,0,0
2131028,4,0,4,21,6,0,27,155,32,214
2131029,0,0,0,9,0,0,9,11,0,20
2131030,0,0,0,54,33,0,87,349,42,478
2131101,9,0,9,86,17,0,103,240,31,374
2131102,6,0,6,35,12,0,47,190,23,260
2131103,3,0,3,50,9,0,59,208,44,311
2131104,3,0,3,47,9,0,56,107,24,187
2131105,0,3,3,83,16,3,102,214,22,338
2131106,7,0,7,64,12,0,76,252,29,357
2131107,0,0,0,72,23,0,95,283,53,431
2131108,0,0,0,66,15,0,81,190,39,310
2131109,3,0,3,71,3,0,74,212,52,338
2131110,0,0,0,36,16,0,52,199,36,287
2131111,0,0,0,74,23,0,97,231,51,379
2131112,48,3,51,43,5,0,48,234,49,331
2131113,7,3,10,83,16,3,102,270,67,439
2131114,0,0,0,53,15,0,68,167,55,290
2131115,0,0,0,113,19,0,132,305,81,518
2131116,0,0,0,0,0,0,0,12,0,12
2131117,6,0,6,55,18,0,73,237,55,365
2131118,6,0,6,51,6,4,61,137,39,237
2131119,3,0,3,53,6,0,59,240,42,341
2131120,5,0,5,78,9,0,87,271,32,390
2131121,3,0,3,73,16,0,89,293,38,420
2131122,3,0,3,47,12,0,59,190,19,268
2131123,3,0,3,54,20,3,77,163,26,266
2131124,14,0,14,83,16,6,105,339,47,491
2131125,0,0,0,67,12,0,79,269,43,391
2131126,12,0,12,41,18,0,59,293,53,405
2131127,6,3,9,66,27,0,93,316,40,449
2131128,4,3,7,54,12,0,66,236,30,332
2131129,6,3,9,80,14,0,94,291,56,441
2131130,8,0,8,58,11,0,69,224,31,324
2131131,3,3,6,34,9,0,43,164,37,244
2131132,0,6,6,112,19,3,134,377,75,586
2131133,0,0,0,44,10,0,54,172,23,249
2131134,6,3,9,51,18,0,69,231,38,338
2131135,0,0,0,55,9,3,67,214,33,314
2131136,0,3,3,68,4,0,72,191,43,306
2131137,3,0,3,32,12,0,44,131,18,193
2131138,6,0,6,61,13,0,74,196,17,287
2131139,3,0,3,68,3,3,74,243,21,338
2131140,3,0,3,85,12,0,97,315,50,462
2131141,45,6,51,16,3,0,19,211,20,250
2131142,0,0,0,95,9,4,108,287,51,446
2131143,0,0,0,82,7,3,92,332,48,472
2131144,0,0,0,53,7,0,60,165,32,257
2131145,13,4,17,58,26,3,87,314,63,464
2131146,17,4,21,85,25,3,113,356,37,506
2131147,6,0,6,62,17,0,79,201,26,306
2131148,6,3,9,50,29,5,84,233,46,363
2131149,7,0,7,56,8,0,64,213,45,322
2131150,20,3,23,9,13,0,22,413,76,511
2131151,3,0,3,84,19,3,106,205,35,346
2131152,11,0,11,73,24,0,97,337,32,466
2131153,4,0,4,63,8,0,71,189,51,311
2131154,6,6,12,57,20,0,77,205,47,329
2131155,3,0,3,22,9,0,31,60,21,112
2131156,0,0,0,59,16,3,78,202,34,314
2131157,6,3,9,47,12,0,59,219,38,316
2131158,3,0,3,61,9,0,70,166,33,269
2131159,5,0,5,79,8,0,87,240,24,351
2131160,54,24,78,3,10,0,13,151,88,252
2131161,0,0,0,17,10,0,27,172,28,227
2131162,29,0,29,24,10,0,34,207,20,261
2131201,0,0,0,27,11,0,38,175,28,241
2131202,0,0,0,65,38,3,106,271,27,404
2131203,3,3,6,53,4,0,57,240,29,326
2131204,6,0,6,60,11,0,71,194,20,285
2131205,8,3,11,104,51,0,155,272,31,458
2131206,3,0,3,52,19,0,71,266,30,367
2131207,3,0,3,90,22,6,118,279,26,423
2131208,6,6,12,67,6,0,73,160,29,262
2131209,3,0,3,42,10,0,52,148,14,214
2131210,3,3,6,55,17,0,72,249,26,347
2131211,3,3,6,56,9,0,65,172,27,264
2131212,0,0,0,56,11,3,70,233,19,322
2131213,3,0,3,55,19,0,74,220,24,318
2131214,4,0,4,56,34,0,90,306,24,420
2131215,0,0,0,25,12,3,40,111,15,166
2131216,89,0,89,55,23,0,78,394,10,482
2131217,8,3,11,41,13,0,54,131,21,206
2131218,0,0,0,68,16,0,84,187,17,288
2131219,0,0,0,51,24,3,78,194,51,323
2131220,4,3,7,45,24,3,72,189,45,306
2131221,0,3,3,47,20,0,67,214,34,315
2131222,6,0,6,44,16,7,67,167,31,265
2131223,13,3,16,74,18,0,92,266,37,395
2131224,4,0,4,46,15,0,61,179,35,275
2131225,11,3,14,87,19,0,106,290,52,448
2131226,0,0,0,61,15,5,81,203,41,325
2131227,4,0,4,75,11,0,86,333,57,476
2131228,0,0,0,47,17,0,64,179,31,274
2131229,6,0,6,90,13,3,106,309,51,466
2131230,3,0,3,61,12,0,73,151,36,260
2131231,0,0,0,37,18,0,55,149,18,222
2131232,0,0,0,67,19,0,86,158,52,296
2131233,8,0,8,75,45,4,124,365,24,513
2131234,59,6,65,22,21,0,43,215,16,274
2131235,3,0,3,43,21,3,67,167,24,258
2131236,4,0,4,91,35,0,126,301,36,463
2131237,0,0,0,73,16,3,92,237,50,379
2131238,5,0,5,64,34,0,98,243,22,363
2131239,4,0,4,31,7,0,38,139,3,180
2131240,0,0,0,0,0,0,0,0,0,0
2131241,0,0,0,43,20,3,66,149,9,224
2131242,11,3,14,73,25,0,98,346,27,471
2131243,0,0,0,46,11,0,57,200,12,269
2131244,7,0,7,73,16,0,89,251,28,368
2131245,8,0,8,56,21,0,77,231,19,327
2131246,4,0,4,89,37,3,129,265,36,430
2131247,3,0,3,89,40,5,134,302,35,471
2131248,3,3,9,48,30,3,81,226,12,319
2131249,10,0,10,50,31,6,87,307,19,413
2131250,4,0,4,47,24,3,74,185,22,281
2131251,3,0,3,62,29,3,94,288,18,400
2131252,6,0,6,55,20,0,75,229,24,328
2131253,6,0,6,44,15,0,59,197,21,277
2131254,0,0,0,37,3,0,40,149,12,201
2131255,6,0,6,36,15,0,51,145,12,208
2131301,6,0,6,33,20,0,53,160,14,227
2131302,0,0,0,74,21,0,95,225,9,329
2131303,0,0,0,50,12,3,65,202,15,282
2131304,7,0,7,21,29,4,54,185,24,263
2131305,0,0,0,39,20,3,62,163,15,240
2131306,8,6,14,64,40,0,104,181,15,300
2131307,9,0,9,65,51,11,127,249,10,386
2131308,7,0,7,51,20,3,74,223,10,307
2131309,3,0,3,3,0,0,3,32,4,39
2131310,14,3,17,81,43,4,128,402,22,552
2131311,4,0,4,77,32,0,109,256,21,386
2131312,3,0,3,72,24,0,96,311,9,416
2131313,6,0,6,82,34,0,116,256,35,407
2131314,0,0,0,50,15,4,69,227,18,314
2131315,9,6,15,39,16,4,59,240,15,314
2131316,8,6,14,56,29,3,88,207,12,307
2131317,9,0,9,71,31,0,102,140,9,251
2131318,4,0,4,96,39,6,141,285,14,440
2131319,9,0,9,49,44,0,93,233,15,341
2131320,7,3,10,108,38,6,152,269,21,442
2131321,0,0,0,62,21,3,86,175,0,261
2131322,0,0,0,72,23,6,101,230,12,343
2131323,0,0,0,88,12,5,105,246,12,363
2131324,4,0,4,46,22,5,73,135,6,214
2131325,51,3,54,35,18,0,53,305,39,397
2131326,0,0,0,49,16,4,69,153,21,243
2131401,3,0,3,66,48,0,114,359,9,482
2131402,3,0,3,334,62,8,404,657,80,1141
2131403,3,0,3,205,29,8,242,368,73,683
2131404,4,0,4,155,33,0,188,350,24,562
2131405,5,0,5,144,22,0,166,348,26,540
2131406,59,14,73,35,9,0,44,233,38,315
2131407,0,0,0,65,18,0,83,175,26,284
2131408,0,0,0,137,25,6,168,335,25,528
2131409,0,0,0,16,20,0,36,81,15,132
2131410,6,0,6,23,15,4,42,143,11,196
2131411,0,0,0,70,39,0,109,318,13,440
2131412,0,0,0,33,14,0,47,167,12,226
2131413,6,3,9,55,20,3,78,187,30,295
2131414,3,0,3,25,21,0,46,166,21,233
2131415,4,0,4,62,36,3,101,302,19,422
2131416,3,0,3,40,10,0,50,139,12,201
2131417,3,0,3,35,21,0,56,231,19,306
2131418,6,0,6,51,25,3,79,218,22,319
2131419,3,3,6,56,11,0,67,321,39,427
2131420,3,0,3,52,12,0,64,199,28,291
2131421,0,0,0,34,12,0,46,98,21,165
2131422,9,0,9,65,19,0,84,251,10,345
2131423,0,0,0,6,0,0,6,0,0,6
2131424,0,0,0,0,0,0,0,0,0,0
2131425,0,0,0,59,21,0,80,203,36,319
2131426,3,0,3,61,36,0,97,339,30,466
2131427,3,0,3,78,27,0,105,252,32,389
2131428,6,0,6,74,28,0,102,278,25,405
2131429,6,0,6,70,18,0,88,211,16,315
2131430,4,0,4,39,13,0,52,141,6,199
2131431,6,0,6,35,18,6,59,206,19,284
2131432,0,0,0,47,17,0,64,171,36,271
2131433,3,3,6,62,44,0,106,301,28,435
2131434,0,0,0,39,23,3,65,183,24,272
2131435,0,0,0,68,30,0,98,220,18,336
2131436,3,0,3,51,33,0,84,221,28,333
2131437,4,0,4,55,27,0,82,299,21,402
2131438,8,0,8,58,23,0,81,254,26,361
2131439,0,0,0,66,31,0,97,238,19,354
2131440,9,0,9,82,34,3,119,273,15,407
2131441,3,0,3,43,18,0,61,157,27,245
2131442,3,0,3,45,15,0,60,250,30,340
2131443,13,14,27,47,14,0,61,203,51,315
2131444,5,0,5,73,19,0,92,291,20,403
2131445,3,3,6,79,16,0,95,232,29,356
2131446,0,0,3,68,26,0,94,291,25,410
2131501,3,0,3,65,24,0,89,223,24,336
2131502,0,3,3,47,19,0,66,170,36,272
2131503,6,0,6,91,38,0,129,351,41,521
2131504,0,0,0,49,18,3,70,195,18,283
2131505,3,0,3,38,23,6,67,123,20,210
2131506,33,3,36,56,13,0,69,341,31,441
2131507,5,0,5,56,11,0,67,182,20,269
2131508,13,5,18,89,30,0,119,226,45,390
2131509,3,0,3,35,9,0,44,147,10,201
2131510,9,6,15,90,28,3,121,382,35,538
2131511,72,6,78,32,11,3,46,305,39,390
2131512,3,0,3,37,4,0,41,168,21,230
2131513,5,3,8,85,14,4,103,350,35,488
2131514,6,0,6,75,31,0,106,207,19,332
2131515,6,3,9,47,16,3,66,228,27,321
2131516,4,0,4,45,18,0,63,182,14,259
2131517,3,6,9,51,26,3,80,241,42,363
2131518,6,0,6,64,42,0,106,303,28,437
2131519,6,6,12,82,28,3,113,328,32,473
2131520,3,0,3,64,36,0,100,230,18,348
2131521,0,0,0,48,9,3,60,216,13,289
2131522,4,0,4,65,19,0,84,296,57,437
2131523,6,0,6,76,12,0,88,320,28,436
2131524,3,3,6,90,22,0,112,329,29,470
2131525,12,0,12,74,15,0,89,290,47,426
2131526,3,0,3,90,31,0,121,349,35,505
2131527,4,0,4,43,13,3,59,248,24,331
2131528,0,0,0,85,19,3,107,265,31,403
2131529,7,0,7,64,27,0,91,266,45,402
2131530,9,0,9,76,20,0,96,308,30,434
2131531,0,0,0,82,26,3,111,265,44,420
2131532,3,0,3,67,43,6,116,314,39,469
2131533,3,3,6,107,18,0,125,402,59,586
2131534,41,4,45,69,11,6,86,288,26,400
2131535,0,6,6,99,31,0,130,361,53,544
2131536,15,0,15,90,8,0,98,324,29,451
2131537,0,0,0,75,30,0,105,318,48,471
2131538,0,4,4,68,20,0,88,258,35,381
2131539,8,0,8,76,20,0,96,274,21,391
2131540,15,6,21,58,28,0,86,343,49,478
2131541,0,0,0,92,20,0,112,315,61,488
2131542,0,0,0,70,17,0,87,251,26,364
2131543,6,3,9,87,16,3,106,398,70,574
2131544,0,0,0,36,6,0,42,151,17,210
2131545,4,0,4,69,22,0,91,310,21,422
2131546,11,0,11,71,26,0,97,377,54,528
2131547,0,0,0,62,14,0,76,237,30,343
2131548,0,0,0,74,32,0,106,296,45,447
2131549,6,0,6,33,12,0,45,181,12,238
2131550,19,0,19,68,38,5,111,313,19,443
2131551,20,4,24,57,44,0,101,343,92,536
2131552,89,3,92,52,5,3,60,405,27,492
2131553,0,3,3,68,17,0,85,219,25,329
2131554,7,0,7,63,15,0,78,228,42,348
2131555,10,0,10,57,16,3,76,226,33,335
2131556,3,3,6,92,25,0,117,399,44,560
2131557,0,0,0,89,11,0,100,364,56,520
2131558,7,0,7,61,28,0,89,333,43,465
2131601,4,0,4,46,15,0,61,145,24,230
2131602,3,0,3,52,23,0,75,170,20,265
2131603,3,0,3,68,24,0,92,308,39,439
2131604,3,0,3,49,18,3,70,181,11,262
2131605,3,0,3,51,15,0,66,193,53,312
2131606,0,0,0,35,11,0,46,196,21,263
2131607,6,0,6,91,32,7,130,321,26,477
2131608,3,0,3,53,22,0,75,246,24,345
2131609,0,0,0,69,23,0,92,233,27,352
2131610,5,0,5,96,31,6,133,365,30,528
2131611,0,0,0,68,32,0,100,291,34,425
2131612,5,3,8,80,20,0,100,260,22,382
2131613,3,0,3,81,36,0,117,286,15,418
2131614,0,0,0,78,10,0,88,261,36,385
2131615,7,0,7,32,11,0,43,129,6,178
2131616,4,0,4,44,32,0,76,232,22,330
2131617,6,3,12,83,26,0,109,329,22,460
2131618,0,0,0,0,0,0,0,0,0,0
2131701,0,3,3,34,6,0,40,128,27,195
2131702,3,0,3,42,13,0,55,191,27,273
2131703,7,3,10,44,21,0,65,286,27,378
2131704,8,0,8,31,9,0,40,172,16,228
2131705,0,3,3,32,9,0,41,164,14,219
2131706,5,0,5,40,12,0,52,210,55,317
2131707,0,0,0,32,10,0,42,172,30,244
2131708,84,22,106,30,21,0,51,402,74,527
2131709,9,0,9,71,20,0,91,283,29,403
2131710,0,3,3,54,30,0,84,248,33,365
2131711,6,0,6,41,18,0,59,226,19,304
2131712,5,3,8,69,16,3,88,329,45,462
2131713,6,0,6,63,13,0,76,218,51,345
2131714,6,0,6,65,12,0,77,297,35,409
2131715,0,0,0,41,16,0,57,185,32,274
2131716,3,0,3,97,44,3,144,297,26,467
2131717,3,6,9,62,18,0,80,280,27,387
2131718,0,0,0,48,23,0,71,187,35,293
2131719,7,0,7,83,18,4,105,300,44,449
2131720,18,3,21,76,24,6,106,308,55,469
2131721,6,0,9,33,14,0,47,186,30,263
2131722,0,4,4,54,18,0,72,223,22,317
2131723,39,3,42,60,28,3,91,367,44,502
2131724,12,0,12,60,20,0,80,286,28,394
2131725,8,0,8,60,3,0,63,210,38,311
2131726,3,0,3,49,6,0,55,200,21,276
2131727,7,0,7,70,34,0,104,253,34,391
2131728,6,0,6,53,10,3,66,213,27,306
2131729,0,0,0,25,0,0,25,130,16,171
2131730,9,3,12,63,15,0,78,308,47,433
2131731,0,0,0,0,0,0,0,0,3,3
2131732,0,0,0,100,15,0,115,308,29,452
2131733,0,0,0,0,0,0,0,0,0,0
2131734,3,0,3,58,12,0,70,310,21,401
2131735,9,0,9,64,18,3,85,307,33,425
2131736,9,3,12,66,17,0,83,291,27,401
2131737,3,3,6,50,15,0,65,261,25,351
2131738,3,0,3,63,15,0,78,219,18,315
2131739,7,0,7,40,13,0,53,234,10,297
2131740,0,0,0,102,18,0,120,301,19,440
2131741,3,4,7,68,24,0,92,395,32,519
2131742,3,4,7,58,12,0,70,238,22,330
2131743,6,6,12,82,14,0,96,281,57,434
2131744,0,0,0,0,0,0,0,0,0,0
2131745,3,3,6,43,8,0,51,241,40,332
2131746,3,3,6,60,33,0,93,274,44,411
2131747,7,3,10,78,26,3,107,273,42,422
2131748,6,0,6,67,20,0,87,234,22,343
2131749,3,0,3,52,9,0,61,173,24,258
2131801,4,0,4,69,21,0,90,253,31,374
2131802,6,0,6,75,22,0,97,207,30,334
2131803,0,0,0,63,7,3,73,242,15,330
2131804,5,0,5,69,19,0,88,282,39,409
2131805,8,0,8,83,25,6,114,341,19,474
2131806,50,6,56,91,30,3,124,364,33,521
2131807,4,0,4,82,24,3,109,281,35,425
2131808,4,0,4,66,19,0,85,300,27,412
2131809,0,3,3,66,22,0,88,139,24,251
2131810,6,0,6,48,11,4,63,175,7,245
2131811,6,0,6,83,27,0,110,307,44,461
2131812,4,0,4,59,22,0,81,242,26,349
2131813,0,6,6,78,30,0,108,319,24,451
2131814,3,0,3,49,11,0,60,225,38,323
2131815,6,0,6,34,18,0,52,175,25,252
2131816,9,0,9,84,20,0,104,301,59,464
2131817,4,0,4,43,20,0,63,158,18,239
2131818,3,0,3,79,19,0,98,268,37,403
2131819,3,0,3,78,21,3,102,262,33,397
2131820,3,0,3,68,12,0,80,211,27,318
2131821,5,0,5,65,23,0,88,407,47,542
2131822,5,0,5,67,26,3,96,337,21,454
2131823,0,0,0,66,24,0,90,246,29,365
2131824,9,0,9,90,30,0,120,258,22,400
2131825,0,0,0,68,16,0,84,291,39,414
2131826,0,0,0,31,10,0,41,183,22,246
2131901,6,0,6,62,20,3,85,205,21,311
2131902,6,0,6,41,18,0,59,236,15,310
2131903,4,3,10,66,17,3,86,268,30,384
2131904,8,0,8,87,34,0,121,408,22,551
2131905,11,0,11,105,30,5,140,266,18,424
2131906,6,3,9,77,18,3,98,206,28,332
2131907,5,6,11,58,11,3,72,214,12,298
2131908,13,3,16,78,17,6,101,223,25,349
2131909,6,6,12,84,19,0,103,211,33,347
2131910,7,0,7,51,19,3,73,181,24,278
2131911,15,3,18,78,19,6,103,299,40,442
2131912,9,0,9,72,26,0,98,172,3,273
2131913,0,0,0,60,17,0,77,165,9,251
2131914,3,0,3,139,24,4,167,274,36,477
2131915,3,0,3,90,30,6,126,212,11,349
2131916,6,3,9,58,24,3,85,251,7,343
2131917,6,0,6,66,22,0,88,262,20,370
2131918,7,3,10,29,20,3,52,173,27,252
2131919,48,0,48,65,9,0,74,348,24,446
2131920,9,3,12,45,14,0,59,222,28,309
2131921,7,6,13,43,22,0,65,389,55,509
2131922,7,0,7,53,16,0,69,332,31,432
2131923,6,3,9,76,14,4,94,229,49,372
2131924,11,0,11,74,19,3,96,281,50,427
2131925,4,3,7,33,13,3,49,207,25,281
2131926,3,0,3,48,14,0,62,206,18,286
2131927,15,0,15,73,8,0,81,249,16,346
2131928,3,0,3,39,4,5,48,192,23,263
2131929,7,0,7,114,27,0,141,300,48,489
2131930,0,0,0,44,3,0,47,143,13,203
2131931,7,3,10,137,44,3,184,402,21,607
2131932,0,0,0,39,15,0,54,153,15,222
2131933,7,0,7,77,13,0,90,261,30,381
2131934,0,3,3,53,14,0,67,163,13,243
2131935,16,0,16,97,20,6,123,279,47,449
2131936,5,0,5,79,18,0,97,178,25,300
2131937,61,0,61,65,15,8,88,247,16,351
2131938,0,0,0,0,0,0,0,0,0,0
2131939,6,0,9,40,50,0,90,216,33,339
2132001,3,0,3,13,14,3,30,487,56,573
2132002,0,0,0,4,20,0,24,747,29,800
2132003,6,6,12,16,10,0,26,310,28,364
2132004,20,3,23,29,19,0,48,479,48,575
2132005,15,0,15,29,9,0,38,417,6,461
2132006,3,0,3,66,22,0,88,257,23,368
2132007,0,0,0,0,0,0,0,0,0,0
2132008,0,0,0,80,20,0,100,272,30,402
2132009,4,0,4,40,17,3,60,163,15,238
2132010,6,3,9,47,16,0,63,201,15,279
2132011,10,4,14,34,3,0,37,181,20,238
2132012,14,0,14,102,6,0,108,393,28,529
2132013,10,3,13,52,16,0,68,325,66,459
2132014,78,12,90,58,12,3,73,396,52,521
2132015,11,4,15,47,4,0,51,291,41,383
2132016,12,0,12,45,7,0,52,244,9,305
2132017,5,0,5,67,28,3,98,339,21,458
2132018,4,3,7,34,18,0,52,240,25,317
2132019,4,0,4,34,15,3,52,205,9,266
2132020,9,8,17,72,24,0,96,420,63,579
2132021,4,3,7,60,12,4,76,242,36,354
2132022,7,0,7,43,10,0,53,290,18,361
2132023,0,0,0,29,12,0,41,149,9,199
2132024,3,0,3,34,9,3,46,325,43,414
2132025,6,0,6,37,10,0,47,380,44,471
2132026,12,0,12,70,15,0,85,327,50,462
2132027,3,6,9,42,9,3,54,203,18,275
2132028,5,0,5,78,18,0,96,500,61,657
2132029,4,0,4,56,14,0,70,277,30,377
2132030,4,0,4,62,3,0,65,345,28,438
2132031,3,0,3,47,15,0,62,388,37,487
2132032,3,3,6,37,3,0,40,466,29,535
2132033,3,0,3,11,7,0,18,257,18,293
2132034,0,0,0,82,29,0,111,613,152,876
2132035,0,0,0,76,21,0,97,332,42,471
2132036,9,6,15,44,21,0,65,209,28,302
2132037,95,5,100,15,10,0,25,372,31,428
2132038,6,0,6,39,33,0,72,275,41,388
2132101,4,5,9,77,45,15,137,339,27,503
2132102,0,0,0,44,30,6,80,161,9,250
2132103,3,0,3,82,41,4,127,255,14,396
2132104,16,7,23,65,22,0,87,226,30,343
2132105,15,0,15,84,25,0,109,284,43,436
2132106,3,0,3,52,18,0,70,111,24,205
2132107,0,0,0,56,22,0,78,162,30,270
2132108,0,3,3,56,29,0,85,224,15,324
2132109,10,3,13,77,35,4,116,267,30,413
2132110,54,10,64,57,43,0,100,363,52,515
2132111,11,0,11,61,30,3,94,252,13,359
2132112,6,0,6,64,18,3,85,251,18,354
2132113,0,0,0,71,31,3,105,268,9,382
2132114,6,0,6,65,31,6,102,316,38,456
2132115,4,0,4,67,47,0,114,313,30,457
2132116,0,3,3,60,7,0,67,117,9,193
2132117,0,0,0,81,34,0,115,300,17,432
2132118,7,0,7,49,31,0,80,207,12,299
2132119,3,3,6,47,24,0,71,178,19,268
2132120,12,0,12,61,31,0,92,242,20,354
2132121,0,5,5,102,35,3,140,299,18,457
2132122,0,0,0,49,29,3,81,243,15,339
2132123,0,0,0,26,33,3,62,171,3,236
2132124,4,0,4,66,24,0,90,230,25,345
2132125,6,0,6,81,28,0,109,235,17,361
2132126,9,0,9,41,16,0,57,167,12,236
2132127,9,3,12,62,31,3,96,309,25,430
2132128,0,0,0,59,43,0,102,212,6,320
2132129,3,0,3,43,18,0,61,230,6,297
2132130,8,0,8,96,36,5,137,293,18,448
2132131,3,0,3,88,32,0,120,249,18,387
2132132,6,0,6,78,29,0,107,197,17,321
2132133,3,0,3,30,23,0,53,125,26,204
2132134,3,0,3,51,37,3,91,185,15,291
2132135,4,0,4,47,40,0,87,211,3,301
2132136,3,0,3,28,17,3,48,121,3,172
2132137,3,0,3,63,45,3,111,199,15,325
2132138,67,15,82,50,25,0,75,331,23,429
2132139,4,0,4,41,26,0,67,119,0,186
2132140,3,0,3,25,20,0,45,113,8,166
2132141,4,0,4,88,26,6,120,257,12,389
2132142,3,0,3,82,30,4,116,225,6,347
2132143,3,0,3,36,22,3,61,110,9,180
2132144,0,0,0,35,25,3,63,201,12,276
2132145,0,18,18,64,40,3,107,225,57,389
2132146,3,0,3,76,18,4,98,196,6,300
2132147,5,0,5,60,35,3,98,219,6,323
2132148,4,0,4,33,17,0,50,179,19,248
2132149,4,0,4,26,17,6,49,147,6,202
2132150,6,6,12,59,9,0,68,160,30,258
2132151,3,0,3,48,17,3,68,204,9,281
2132152,6,0,6,53,25,0,78,155,7,240
2132153,3,0,3,46,33,0,79,176,9,264
2132154,0,3,6,48,21,3,72,178,6,256
2132201,0,5,5,79,18,5,102,244,20,366
2132202,3,0,3,83,17,4,104,231,32,367
2132203,4,0,4,64,30,0,94,167,25,286
2132204,0,0,0,68,20,0,88,211,18,317
2132205,3,3,6,40,10,0,50,138,6,194
2132206,4,0,4,58,18,0,76,210,15,301
2132207,3,0,3,47,16,0,63,171,12,246
2132208,0,81,81,50,23,0,73,196,163,432
2132209,6,0,6,37,15,0,52,158,3,213
2132210,4,0,4,37,20,0,57,193,12,262
2132211,7,4,11,30,21,0,51,177,4,232
2132212,6,0,6,57,21,0,78,273,20,371
2132213,10,3,13,46,18,0,64,211,25,300
2132214,6,6,12,40,23,0,63,239,22,324
2132215,16,4,20,54,11,3,68,241,41,350
2132216,11,0,11,43,9,0,52,183,21,256
2132217,5,0,5,43,11,0,54,163,23,240
2132218,65,3,71,46,15,0,61,285,19,365
2132219,9,3,12,36,28,6,70,230,31,331
2132220,3,0,3,63,25,0,88,216,15,319
2132221,3,0,3,68,30,3,101,283,16,400
2132222,6,0,6,42,16,3,61,177,6,244
2132223,6,0,6,51,28,6,85,249,39,373
2132224,9,0,9,64,26,0,90,177,18,285
2132225,6,0,6,75,23,3,101,416,43,560
2132226,0,0,0,17,13,3,33,114,18,165
2132227,10,4,14,73,29,3,105,254,28,387
2132228,5,0,5,64,13,6,83,174,12,269
2132229,7,3,10,45,23,0,68,243,39,350
2132230,5,0,5,51,26,3,80,287,22,389
2132231,8,0,8,64,43,0,107,200,27,334
2132232,12,4,16,82,26,0,108,271,34,413
2132233,10,0,10,87,32,3,122,292,24,438
2132234,5,0,5,77,16,0,93,216,9,318
2132235,0,0,0,42,23,4,69,146,17,232
2132236,8,0,8,48,17,0,65,147,16,228
2132237,3,0,3,37,16,3,56,111,3,170
2132238,4,0,4,45,27,3,75,152,3,230
2132239,6,0,6,85,31,6,122,354,28,504
2132240,3,0,3,45,21,0,66,185,26,277
2132241,0,0,0,58,16,3,77,207,9,293
2132242,6,0,6,24,36,0,60,166,12,238
2132243,0,0,0,58,32,6,96,220,15,331
2132244,3,3,6,72,13,4,89,156,15,260
2132245,3,0,3,37,18,4,59,142,3,204
2132246,6,0,6,63,15,0,78,211,20,309
2132247,0,0,0,0,0,0,0,0,0,0
2132248,18,0,18,27,16,0,43,194,11,248
2132249,6,0,6,42,16,0,58,140,5,203
2132250,0,0,0,52,19,3,74,209,9,292
2132251,3,3,6,42,22,0,64,218,25,307
2132252,0,0,0,58,23,6,87,195,9,291
2132301,6,3,9,79,30,0,109,256,13,378
2132302,6,0,6,59,46,0,105,261,10,376
2132303,16,0,16,24,15,0,39,171,0,210
2132304,6,0,6,23,18,0,41,161,6,208
2132305,6,3,9,68,25,3,96,251,22,369
2132306,8,0,8,70,34,0,104,274,15,393
2132307,6,0,6,78,20,0,98,282,6,386
2132308,9,0,9,78,31,3,112,291,24,427
2132309,16,3,19,62,37,0,99,222,16,337
2132310,4,6,10,82,13,6,101,286,22,409
2132311,0,0,0,63,36,3,102,272,7,381
2132312,0,0,0,0,0,0,0,0,0,0
2132313,11,6,17,48,29,3,80,287,16,383
2132314,16,0,16,64,34,7,105,307,21,433
2132315,8,0,8,20,21,3,44,135,9,188
2132316,6,3,9,53,21,0,74,207,20,301
2132317,3,0,3,58,32,0,90,258,15,363
2132318,3,3,6,76,33,0,109,300,13,422
2132319,9,0,9,82,26,0,108,277,17,402
2132320,3,0,3,63,33,0,96,186,20,302
2132321,0,0,0,49,24,0,73,171,34,278
2132322,6,3,9,62,18,3,83,244,39,366
2132323,7,0,7,70,26,3,99,192,7,298
2132324,13,4,17,79,25,3,107,265,30,402
2132325,7,0,7,74,22,0,96,188,15,299
2132326,7,5,12,63,31,3,97,268,31,396
2132327,7,0,7,101,31,6,138,230,11,379
2132328,7,6,13,93,41,0,134,352,13,499
2132329,10,0,10,82,31,0,113,236,23,372
2132330,13,0,13,59,31,6,96,313,22,431
2132331,7,0,7,62,31,4,97,324,44,465
2132332,7,3,10,57,21,3,81,246,18,345
2132333,8,0,11,80,26,0,106,219,18,343
2132334,6,0,6,55,27,6,88,222,9,319
2132335,7,0,7,43,7,0,50,178,6,234
2132336,6,0,6,41,23,0,64,119,21,204
2132337,5,0,5,35,24,3,62,143,12,217
2132401,0,0,0,50,13,3,66,117,7,190
2132402,6,0,6,126,31,0,157,315,21,493
2132403,14,0,14,76,21,3,100,245,10,355
2132404,17,3,20,88,45,3,136,368,22,526
2132405,6,0,6,38,15,0,53,130,6,189
2132406,10,3,13,71,33,6,110,335,37,482
2132407,15,0,15,81,12,0,93,258,15,366
2132408,6,0,6,71,26,3,100,203,18,321
2132409,15,0,18,80,29,0,109,359,16,484
2132410,0,0,0,0,0,0,0,0,3,3
2132411,66,11,77,106,25,8,139,379,32,550
2132412,0,0,0,65,20,3,88,198,12,298
2132413,3,0,3,46,24,5,75,168,9,252
2132414,14,0,14,67,30,0,97,243,9,349
2132415,6,0,6,43,25,0,68,162,5,235
2132416,0,0,0,88,20,3,111,349,18,478
2132417,14,3,17,87,37,0,124,347,26,497
2132418,6,4,10,78,12,0,90,209,7,306
2132419,8,0,8,93,50,3,146,346,22,514
2132420,21,8,29,60,33,3,96,306,29,431
2132421,21,0,21,53,41,0,94,407,26,527
2132422,6,0,6,43,20,3,66,186,5,257
2132423,6,3,9,85,37,3,125,262,9,396
2132424,0,0,0,57,23,7,87,204,18,309
2132425,10,0,10,70,38,3,111,259,5,375
2132426,0,3,3,59,22,0,81,187,15,283
2132427,9,0,9,58,20,0,78,261,31,370
2132428,7,0,7,58,21,3,82,201,24,307
2132429,0,0,0,44,29,0,73,173,0,246
2132430,0,0,4,31,7,0,38,129,3,170
2132431,11,0,11,92,40,0,132,315,15,462
2132432,6,0,6,84,28,4,116,250,27,393
2132433,7,0,10,74,18,4,96,203,11,310
2132434,4,0,4,59,25,0,84,155,9,248
2132435,11,0,11,98,34,3,135,388,30,553
2132436,11,0,11,57,32,6,95,247,18,360
2132437,16,0,16,47,14,6,67,225,12,304
2132438,8,0,8,68,28,0,96,246,24,366
2132439,18,3,24,62,33,4,99,301,17,417
2132440,14,0,14,53,34,7,94,264,0,358
2132441,0,0,0,0,0,0,0,0,0,0
2132501,0,0,0,42,10,0,52,129,11,192
2132502,4,0,4,94,48,0,142,313,24,479
2132503,12,0,12,76,32,6,114,294,19,427
2132504,3,3,6,87,49,0,136,333,37,506
2132505,0,0,0,92,37,0,129,317,29,475
2132506,7,0,7,69,11,0,80,181,22,283
2132507,0,0,0,39,34,3,76,239,24,339
2132508,3,0,3,44,31,0,75,214,0,289
2132509,0,0,0,64,23,4,91,242,23,356
2132510,3,0,3,68,14,0,82,205,9,296
2132511,3,0,3,52,34,0,86,208,18,312
2132512,0,0,0,58,27,3,88,221,6,315
2132513,5,0,5,58,41,0,99,240,19,358
2132514,0,0,0,0,0,0,0,3,0,3
2132515,3,0,3,71,34,3,108,203,9,320
2132516,0,0,0,83,25,3,111,254,24,389
2132517,0,0,0,168,49,10,227,347,19,593
2132518,0,0,0,64,26,0,90,175,24,289
2132519,4,0,4,57,31,0,88,282,18,388
2132520,0,0,0,63,14,0,77,186,16,279
2132521,0,0,0,0,0,0,0,4,0,4
2132522,3,0,3,71,31,0,102,249,37,388
2132523,9,3,12,86,45,6,137,276,14,427
2132524,3,0,3,303,40,7,350,615,65,1030
2132525,7,3,10,76,42,0,118,315,20,453
2132526,0,0,0,48,31,0,79,236,15,330
2132527,7,0,7,88,46,0,134,338,21,493
2132528,54,7,61,98,16,0,114,362,27,503
2132529,7,3,13,81,29,0,110,266,30,406
2132530,3,0,3,63,36,0,99,239,21,359
2132531,3,0,3,38,18,0,56,129,15,200
2132532,7,49,56,35,43,0,78,177,87,342
2132533,15,64,79,20,6,0,26,115,99,240
2132534,4,0,4,62,16,3,81,275,9,365
2132535,3,0,3,60,11,0,71,163,22,256
2132536,3,0,3,44,26,3,73,211,6,290
2132537,6,0,6,53,26,0,79,236,24,339
2132538,3,3,6,44,32,0,76,224,18,318
2132539,0,0,0,40,16,3,59,124,12,195
2132540,0,0,0,32,27,0,59,203,12,274
2132541,8,0,8,60,19,0,79,307,21,407
2132542,0,0,0,49,26,0,75,179,12,266
2132543,0,0,0,0,0,0,0,0,0,0
2132601,4,0,4,51,15,7,73,143,11,227
2132602,7,4,11,83,25,0,108,258,25,391
2132603,8,0,8,53,18,3,74,141,14,229
2132604,0,0,0,0,0,0,0,0,0,0
2132605,13,0,13,87,20,6,113,355,46,514
2132606,8,4,12,76,32,0,108,258,24,390
2132607,5,0,5,61,14,0,75,225,30,330
2132608,9,0,15,63,25,3,91,249,6,346
2132609,7,6,13,106,19,0,125,291,35,451
2132610,3,0,3,44,22,0,66,211,20,297
2132611,3,0,3,95,56,3,154,312,27,493
2132612,9,4,13,91,15,0,106,205,20,331
2132613,3,0,3,65,18,3,86,262,22,370
2132614,7,0,7,52,26,3,81,239,18,338
2132615,6,3,9,74,23,0,97,368,26,491
2132616,8,6,14,77,17,0,94,298,27,419
2132617,0,0,0,89,29,0,118,177,7,302
2132618,10,3,13,88,23,0,111,231,21,363
2132619,12,0,12,118,16,3,137,334,39,510
2132620,8,0,8,92,16,3,111,162,6,279
2132621,6,0,6,70,19,0,89,209,12,310
2132622,14,0,14,84,32,0,116,329,29,474
2132623,3,0,3,39,14,0,53,156,18,227
2132624,8,0,8,54,17,0,71,177,11,259
2132625,3,0,3,52,10,7,69,190,19,278
2132626,11,3,14,86,12,10,108,318,32,458
2132627,6,0,6,79,40,0,119,287,38,444
2132628,4,0,4,39,15,0,54,184,33,271
2132629,7,6,13,120,33,6,159,333,30,522
2132630,3,0,3,60,19,3,82,264,14,360
2132631,8,0,11,112,35,3,150,379,17,546
2132632,77,7,84,48,6,0,54,268,22,344
2132633,4,0,4,39,14,0,53,171,0,224
2132634,6,0,6,23,0,0,23,100,12,135
2132635,11,0,11,47,17,0,64,255,15,334
2132636,6,3,9,87,20,6,113,264,34,411
2132637,12,4,16,73,27,10,110,256,37,403
2132638,4,0,4,100,20,9,129,244,40,413
2132639,16,3,19,68,38,0,106,287,23,416
2132640,0,0,0,3,0,0,3,0,0,3
2132641,0,0,0,0,6,0,6,60,12,78
2132642,4,0,4,65,18,3,86,196,13,295
2132643,6,3,9,40,6,5,51,164,22,237
2132644,5,0,5,64,6,0,70,146,12,228
2132645,0,0,0,0,0,0,0,0,0,0
2132646,3,3,6,51,23,0,74,147,15,236
2132647,5,0,5,45,13,0,58,202,16,276
2132648,0,0,0,39,15,0,54,255,33,342
2132649,3,0,3,69,34,3,106,161,19,286
2132650,3,57,60,15,6,0,21,96,108,225
2132651,0,0,0,35,12,0,47,124,12,183
2132652,9,0,9,61,17,0,78,203,9,290
2132653,3,0,6,51,11,0,62,118,12,192
2132701,3,0,3,63,35,0,98,259,18,375
2132702,0,0,0,52,27,5,84,197,12,293
2132703,3,0,3,85,44,3,132,296,13,441
2132704,3,0,3,76,31,3,110,221,26,357
2132705,8,0,8,52,37,0,89,174,15,278
2132706,0,3,3,79,47,0,126,312,20,458
2132707,5,0,5,109,26,0,135,264,6,405
2132708,4,0,4,61,46,0,107,210,10,327
2132709,5,3,8,67,28,0,95,209,30,334
2132710,4,4,8,69,32,0,101,224,14,339
2132711,4,0,4,55,29,0,84,202,3,289
2132712,6,0,6,63,28,0,91,224,9,324
2132713,3,0,3,38,19,3,60,293,14,367
2132714,3,0,3,73,33,3,109,290,14,413
2132715,0,0,0,72,51,3,126,255,22,403
2132716,3,0,3,53,34,0,87,150,6,243
2132717,7,0,7,67,32,0,99,209,12,320
2132718,10,0,10,56,20,0,76,236,5,317
2132719,4,0,4,66,33,0,99,192,18,309
2132720,5,0,5,74,12,5,91,269,21,381
2132721,7,0,7,47,28,3,78,244,5,327
2132722,3,0,3,51,35,0,86,304,10,400
2132723,0,0,0,46,23,3,72,195,24,291
2132724,4,0,4,47,35,4,86,289,15,390
2132725,0,0,0,50,41,3,94,252,16,362
2132726,50,6,56,67,20,0,87,305,23,415
2132727,3,0,3,68,27,0,95,230,21,346
2132728,0,0,0,0,0,0,0,0,0,0
2132729,3,0,3,51,27,0,78,198,16,292
2132730,0,0,0,63,18,0,81,132,7,220
2132731,0,0,0,69,28,3,100,312,21,433
2132732,7,0,7,94,47,6,147,308,24,479
2132733,7,0,7,53,32,0,85,236,32,353
2132734,0,0,0,43,30,0,73,127,5,205
2132735,10,14,24,43,36,3,82,240,34,356
2132736,8,0,8,68,34,6,108,231,15,354
2132737,190,19,209,23,20,0,43,470,42,555
2132738,3,0,7,50,27,0,77,275,16,368
2132739,0,0,0,56,16,0,72,202,16,290
2132740,4,0,4,75,52,6,133,292,16,441
2132741,8,3,11,62,36,4,102,285,23,410
2132742,3,0,3,102,52,3,157,336,15,508
2132743,4,0,4,69,35,3,107,207,7,321
2132744,0,0,0,37,38,0,75,188,12,275
2132745,3,0,3,38,15,0,53,184,14,251
2132746,0,0,0,0,0,0,0,0,0,0
2132747,3,3,6,27,21,0,48,180,6,234
2132748,3,0,3,74,44,0,118,235,8,361
2132801,3,3,6,57,6,0,63,207,25,295
2132802,20,43,63,60,10,0,70,250,90,410
2132803,3,3,6,31,11,0,42,119,41,202
2132804,9,3,12,57,27,0,84,344,43,471
2132805,8,0,8,59,26,0,85,244,22,351
2132806,0,0,0,0,0,0,0,0,0,0
2132807,3,0,3,50,5,0,55,237,37,329
2132808,0,0,0,72,7,0,79,294,77,450
2132809,3,0,3,53,9,0,62,209,18,289
2132810,0,0,0,23,14,0,37,203,47,287
2132811,3,3,6,50,14,0,64,151,23,238
2132812,0,0,0,29,15,3,47,139,24,210
2132813,0,4,4,55,23,0,78,188,19,285
2132814,7,6,13,58,18,3,79,235,32,346
2132815,6,3,9,76,6,4,86,259,42,387
2132816,21,3,24,60,16,0,76,264,39,379
2132817,4,6,10,25,17,0,42,155,41,238
2132818,11,3,14,47,24,0,71,180,38,289
2132819,11,0,11,61,34,3,98,381,64,543
2132901,3,0,3,98,16,0,114,209,19,342
2132902,0,0,0,93,41,3,137,229,32,398
2132903,0,0,0,64,9,6,79,176,18,273
2132904,4,0,4,52,26,3,81,181,5,267
2132905,0,0,0,67,12,3,82,197,63,342
2132906,6,3,9,74,30,0,104,195,39,338
2132907,0,0,0,69,8,0,77,212,16,305
2132908,0,0,0,98,32,0,130,297,69,496
2132909,4,0,4,102,19,0,121,292,25,438
2132910,0,0,0,44,7,0,51,166,3,220
2132911,0,0,0,77,20,0,97,216,9,322
2132912,6,0,6,119,43,6,168,335,24,527
2132913,0,0,0,102,19,0,121,201,24,346
2132914,0,3,3,91,18,6,115,218,21,354
2132915,0,0,0,106,24,0,130,244,18,392
2132916,3,0,3,112,30,0,142,290,38,470
2132917,0,0,0,137,13,3,153,194,36,383
2132918,0,0,0,60,18,0,78,160,18,256
2132919,0,0,0,67,6,0,73,104,27,204
2133001,3,0,3,28,16,0,44,120,30,194
2133002,0,0,0,71,16,0,87,170,13,270
2133003,3,0,3,43,22,3,68,157,13,238
2133004,0,0,0,46,16,0,62,155,6,223
2133005,3,0,3,87,18,4,109,251,31,391
2133006,0,0,0,46,10,0,56,164,17,237
2133007,0,0,0,105,28,3,136,252,42,430
2133008,3,0,3,254,49,4,307,564,55,926
2133009,0,0,0,0,0,0,0,3,0,3
2133010,0,0,0,0,0,0,0,0,0,0
2133011,0,0,0,0,0,0,0,0,0,0
2133012,3,0,3,50,20,0,70,288,49,407
2133013,0,0,0,67,17,3,87,274,37,398
2133014,8,0,8,67,22,0,89,231,38,358
2133015,3,0,3,40,27,0,67,185,19,271
2133016,7,0,7,37,13,0,50,140,8,198
2133017,3,0,3,30,19,0,49,173,18,240
2133018,6,0,6,52,31,0,83,253,65,401
2133019,0,0,0,64,35,0,99,285,43,427
2133020,0,0,0,100,23,6,129,133,7,269
2133021,0,0,0,272,39,3,314,485,48,847
2133022,3,0,3,36,16,0,52,149,42,243
2133023,0,3,3,41,13,0,54,156,24,234
2133024,0,3,3,39,12,9,60,154,23,237
2133025,0,0,0,337,69,13,419,668,94,1181
2133026,3,0,3,532,108,18,658,1145,240,2043
2133027,6,0,6,230,49,0,279,551,135,965
2133028,0,0,0,38,15,0,53,165,12,230
2133029,0,0,0,28,12,0,40,153,22,215
2133030,3,0,3,45,27,0,72,217,18,307
2133031,0,0,0,22,21,0,43,147,22,212
2133032,6,0,6,56,16,0,72,191,19,282
2133033,4,0,4,40,12,0,52,168,27,247
2133034,0,0,0,39,18,0,57,149,22,228
2133035,3,0,3,73,26,0,99,238,23,360
2133036,3,0,3,48,19,3,70,176,21,267
2133037,3,0,3,68,34,0,102,246,35,383
2133038,0,0,0,51,17,0,68,184,20,272
2133039,5,0,5,42,15,0,57,185,29,271
2133040,6,6,12,77,28,0,105,229,63,397
2133041,6,3,9,28,9,0,37,121,27,185
2133042,5,0,5,40,8,0,48,164,38,250
2133043,0,0,0,47,34,0,81,213,33,327
2133044,0,0,0,0,0,0,0,0,0,0
2133045,0,0,0,22,0,0,22,106,17,145
2133046,3,0,3,325,51,3,379,635,103,1117
2133101,0,0,0,92,22,0,114,221,36,371
2133102,0,0,0,56,13,0,69,116,26,211
2133103,3,0,3,94,18,0,112,350,62,524
2133104,0,0,0,0,0,0,0,0,0,0
2133105,3,0,3,86,9,0,95,234,31,360
2133106,0,0,0,75,16,0,91,164,27,282
2133107,0,0,0,56,15,0,71,169,15,255
2133108,0,0,0,70,25,3,98,205,21,324
2133109,3,0,3,77,15,4,96,210,29,335
2133110,0,0,0,41,23,0,64,213,24,301
2133111,0,0,0,70,26,3,99,274,18,391
2133112,56,3,59,35,7,0,42,147,27,216
2133113,3,0,3,44,17,3,64,158,21,243
2133114,0,0,0,56,9,3,68,130,12,210
2133115,3,0,3,66,3,0,69,136,20,225
2133116,0,0,0,51,6,0,57,161,9,227
2133117,0,0,0,110,24,0,134,370,45,549
2133118,0,0,0,38,17,0,55,146,21,222
2133119,0,0,0,43,13,0,56,183,18,257
2133120,0,0,0,58,9,0,67,126,25,218
2133121,3,0,3,81,16,3,100,207,40,347
2133122,0,0,0,52,18,0,70,211,41,322
2133123,0,0,0,67,12,0,79,146,20,245
2133201,4,0,4,58,33,0,91,299,26,416
2133202,19,0,19,21,12,0,33,222,23,278
2133203,3,0,3,55,20,0,75,227,20,322
2133204,3,0,3,45,18,0,63,174,9,246
2133205,3,0,3,40,26,0,66,140,18,224
2133206,0,0,0,41,19,6,66,159,27,252
2133207,3,0,3,39,24,3,66,199,18,283
2133208,28,6,34,46,22,0,68,254,29,351
2133209,0,3,3,38,25,0,63,199,22,284
2133210,0,0,0,6,0,0,6,4,0,10
2133211,0,0,0,81,26,0,107,279,18,404
2133212,0,0,0,52,29,0,81,232,12,325
2133213,3,0,3,67,29,3,99,256,33,388
2133214,0,0,0,45,21,0,66,231,24,321
2133215,0,0,0,0,0,0,0,0,0,0
2133216,6,0,6,72,21,0,93,237,30,360
2133217,3,0,3,87,42,0,129,305,20,454
2133218,0,0,0,21,6,0,27,148,9,184
2133219,3,0,3,59,30,0,89,211,16,316
2133220,0,0,0,49,15,3,67,254,7,328
2133221,0,0,0,49,10,0,59,229,17,305
2133222,0,0,0,58,29,0,87,176,5,268
2133223,0,0,0,47,42,0,89,201,25,315
2133224,3,0,3,48,15,0,63,155,21,239
2133225,0,0,0,61,20,4,85,253,20,358
2133226,0,0,0,47,23,0,70,181,15,266
2133227,6,0,6,63,32,3,98,299,17,414
2133228,0,0,0,25,19,0,44,214,18,276
2133229,3,0,3,38,17,0,55,164,20,239
2133230,3,0,3,34,24,0,58,188,15,261
2133231,0,0,0,45,13,3,61,211,26,298
2133232,0,0,0,87,57,0,144,361,35,540
2133233,0,0,0,45,12,0,57,142,22,221
2133234,0,0,0,0,0,0,0,0,0,0
2133235,3,0,3,65,31,0,96,268,26,390
2133236,0,0,0,17,14,3,34,126,9,169
2133237,0,0,0,64,29,3,96,221,24,341
2133238,3,0,3,46,12,0,58,106,21,185
2133239,4,0,4,46,11,0,57,168,15,240
2133240,0,0,0,54,6,0,60,128,6,194
2133301,0,0,0,74,33,0,107,271,67,445
2133302,0,0,0,64,15,4,83,196,14,293
2133303,0,0,0,44,23,0,67,175,60,302
2133304,0,0,0,54,19,0,73,221,21,315
2133305,0,0,0,54,37,0,91,245,39,375
2133306,0,0,0,32,21,0,53,178,20,251
2133307,6,0,6,61,16,3,80,210,33,323
2133308,4,0,4,21,15,0,36,139,35,210
2133309,0,0,0,41,13,0,54,204,27,285
2133310,0,3,3,33,16,0,49,168,16,233
2133311,0,0,0,50,24,3,77,239,36,352
2133312,3,3,6,49,18,0,67,203,33,303
2133313,0,3,3,58,14,0,72,256,66,394
2133314,6,0,6,75,46,3,124,310,18,452
2133315,0,3,3,65,49,3,117,333,37,487
2133316,0,0,0,30,9,0,39,182,18,239
2133317,3,0,3,32,22,3,57,170,26,253
2133318,0,0,0,69,30,3,102,281,56,439
2133319,0,0,0,75,30,3,108,308,41,457
2133320,0,0,0,56,28,0,84,205,44,333
2133321,3,0,3,60,7,0,67,276,47,390
2133322,3,0,3,44,11,0,55,147,10,212
2133323,0,3,3,39,21,3,63,206,18,287
2133324,0,0,0,61,21,4,86,229,34,349
2133325,6,0,6,50,15,0,65,214,21,300
2133326,0,0,0,60,19,3,82,197,17,296
2133327,3,0,3,50,12,0,62,170,12,244
2133328,0,0,0,50,24,0,74,201,12,287
2133329,0,0,0,49,17,0,66,167,24,257
2133330,3,0,3,62,22,0,84,237,25,346
2133331,4,0,4,62,24,0,86,168,43,297
2133332,0,0,0,69,29,0,98,168,28,294
2133333,0,0,0,86,24,3,113,335,44,492
2133401,0,0,0,60,28,3,91,252,27,370
2133402,0,0,0,53,12,0,65,221,14,300
2133403,3,4,7,42,15,0,57,176,26,259
2133404,3,0,3,42,25,0,67,251,44,362
2133405,4,4,8,52,12,0,64,206,64,334
2133406,4,3,7,46,19,3,68,192,48,308
2133407,3,0,3,74,15,0,89,295,61,445
2133408,3,6,9,50,10,0,60,164,34,258
2133409,6,0,6,46,29,3,78,218,45,341
2133410,3,6,9,57,22,0,79,231,38,348
2133411,7,5,12,65,30,0,95,293,37,425
2133412,0,0,0,68,13,0,81,214,36,331
2133413,3,0,3,45,12,0,57,201,31,289
2133414,11,0,11,71,13,0,84,231,57,372
2133415,17,3,20,59,27,0,86,349,89,524
2133416,11,3,14,29,15,0,44,199,72,315
2133417,9,0,12,48,24,0,72,204,43,319
2133418,3,0,3,60,22,0,82,251,55,388
2133419,6,0,6,51,12,0,63,219,77,359
2133420,5,0,5,46,8,3,57,257,73,387
2133421,0,0,0,56,17,0,73,194,48,315
2133422,3,0,3,33,26,0,59,220,27,306
2133423,13,3,16,56,32,0,88,323,96,507
2133424,0,3,3,52,31,0,83,202,23,308
2133425,5,0,5,84,31,0,115,232,61,408
2133426,0,0,0,56,28,3,87,316,29,432
2133427,8,3,11,63,11,0,74,289,28,391
2133428,3,0,3,39,14,0,53,251,30,334
2133429,7,4,11,94,16,0,110,272,47,429
2133430,5,0,5,61,36,3,100,296,49,445
2133431,4,0,4,31,10,0,41,140,26,207
2133432,9,0,9,48,14,3,65,217,40,322
2133433,6,0,6,88,26,0,114,252,49,415
2133434,0,3,3,37,13,0,50,169,45,264
2133435,0,0,0,50,17,0,67,248,42,357
2133436,3,0,3,73,37,3,113,268,80,461
2133437,0,0,0,71,20,3,94,221,37,352
2133438,0,4,4,27,8,0,35,194,21,250
2133439,0,0,0,26,10,0,36,122,13,171
2133440,0,3,3,51,19,3,73,268,19,360
2133441,0,0,0,71,18,3,92,243,70,405
2133442,6,0,6,38,18,3,59,267,45,371
2133443,7,6,13,49,17,0,66,275,68,409
2133444,3,3,6,24,6,0,30,118,19,167
2133445,0,0,0,31,5,3,39,119,35,193
2133501,10,0,10,71,10,0,81,243,46,370
2133502,12,0,12,71,26,0,97,325,85,507
2133503,8,3,11,58,12,0,70,296,79,445
2133504,7,0,7,101,17,0,118,255,33,406
2133505,6,3,9,37,16,0,53,202,33,288
2133506,7,0,7,50,38,0,88,274,47,409
2133507,3,0,3,47,18,3,68,169,38,275
2133508,0,4,4,62,18,3,83,235,40,358
2133509,3,0,3,46,25,0,71,205,31,307
2133510,3,3,6,54,26,0,80,224,78,382
2133511,3,3,6,55,24,0,79,223,32,334
2133512,0,3,3,42,13,0,55,201,84,340
2133513,3,0,3,42,14,0,56,186,31,273
2133514,9,3,12,71,19,0,90,253,82,425
2133515,4,3,7,68,24,0,92,253,69,414
2133516,3,0,3,90,34,0,124,418,30,572
2133517,0,0,0,55,26,0,81,291,28,400
2133518,6,0,6,52,28,3,83,238,28,349
2133519,0,0,0,33,12,0,45,141,27,213
2133520,9,0,9,72,6,3,81,340,73,494
2133521,0,0,0,40,32,0,72,237,29,338
2133522,3,0,6,35,21,0,56,160,37,253
2133523,6,3,9,25,10,0,35,198,22,255
2133524,13,0,13,20,3,0,23,119,39,181
2133525,0,0,0,49,9,0,58,213,25,296
2133526,3,0,3,61,12,0,73,207,20,300
2133527,3,0,3,100,26,0,126,335,34,495
2133528,0,0,0,20,17,0,37,98,6,141
2133529,6,0,6,77,13,3,93,239,58,390
2133530,0,0,0,81,24,0,105,310,33,448
2133531,0,0,0,70,18,0,88,201,30,319
2133532,0,0,0,41,16,0,57,203,40,300
2133533,3,0,3,28,9,0,37,200,21,258
2133534,3,0,3,52,30,0,82,226,27,335
2133535,27,0,27,54,25,0,79,326,33,438
2133536,10,0,10,96,30,0,126,318,46,490
2133537,6,3,9,35,11,0,46,177,25,248
2133538,0,0,0,30,17,3,50,147,36,233
2133601,18,4,22,34,9,3,46,287,50,383
2133602,0,0,0,0,0,0,0,7,0,7
2133603,6,3,9,61,7,0,68,194,38,300
2133604,13,6,19,50,0,3,53,168,30,251
2133605,10,0,10,42,15,0,57,246,35,338
2133606,10,0,10,90,11,0,101,308,59,468
2133607,6,3,9,50,31,0,81,348,49,478
2133608,7,4,11,40,13,0,53,213,43,309
2133609,11,6,17,75,23,0,98,281,39,418
2133610,11,4,15,63,22,0,85,227,63,375
2133611,9,0,9,78,43,0,121,339,64,524
2133612,22,0,22,80,24,0,104,339,25,468
2133613,11,6,17,106,46,0,152,335,47,534
2133614,6,0,6,73,29,0,102,292,42,436
2133615,4,3,7,42,7,3,52,148,41,241
2133616,6,0,6,101,19,3,123,305,43,471
2133617,3,6,9,76,21,0,97,310,62,469
2133618,50,0,50,64,10,0,74,347,35,456
2133619,12,6,22,75,18,3,96,340,40,476
2133701,3,3,6,42,19,0,61,184,64,309
2133702,3,0,3,48,17,0,65,194,48,307
2133703,0,0,0,102,42,0,144,305,24,473
2133704,7,0,7,60,16,6,82,211,30,323
2133705,27,4,31,41,9,0,50,283,33,366
2133706,8,0,8,63,23,0,86,301,24,411
2133707,9,0,9,36,19,0,55,171,19,245
2133708,9,0,9,33,18,0,51,223,24,298
2133709,16,0,19,49,18,0,67,264,38,369
2133710,9,0,9,31,18,0,49,204,37,290
2133711,14,0,14,50,7,0,57,217,41,315
2133712,4,0,4,92,30,3,125,339,81,545
2133713,6,3,9,77,16,0,93,236,37,366
2133714,0,0,0,26,3,3,32,48,6,86
2133715,3,0,3,31,22,0,53,157,10,220
2133716,11,3,14,45,18,0,63,247,36,346
2133717,7,0,7,60,22,0,82,279,39,400
2133718,42,3,45,61,17,0,78,400,39,517
2133719,3,0,3,47,14,0,61,179,28,268
2133720,4,5,9,52,28,0,80,247,34,361
2133721,0,0,0,67,19,0,86,168,4,258
2133722,3,0,3,41,20,0,61,266,32,359
2133723,0,0,0,63,9,0,72,180,40,292
2133724,10,0,10,89,20,0,109,362,54,525
2133725,0,0,0,0,0,0,0,0,0,0
2133726,6,4,10,91,36,0,127,334,19,480
2133801,5,0,5,42,18,0,60,172,34,266
2133802,3,0,3,52,36,0,88,291,48,427
2133803,3,3,6,29,24,0,53,210,50,313
2133804,0,0,0,76,37,6,119,356,52,527
2133805,0,0,0,77,6,3,86,144,36,266
2133806,4,0,4,23,27,3,53,181,29,263
2133807,6,3,9,27,19,3,49,223,33,305
2133808,6,0,6,48,31,0,79,262,44,385
2133809,4,0,4,33,29,3,65,156,25,246
2133810,3,0,3,24,21,0,45,166,21,232
2133811,8,0,8,66,19,0,85,220,35,340
2133812,3,0,3,43,33,0,76,277,63,416
2133813,7,0,7,49,15,0,64,181,19,264
2133814,11,0,11,65,23,3,91,280,20,391
2133815,3,0,3,50,20,0,70,157,45,272
2133816,0,0,0,65,22,3,90,264,29,383
2133817,15,0,15,43,14,0,57,271,40,368
2133818,4,0,4,32,18,0,50,156,16,222
2133819,0,0,0,28,21,0,49,215,28,292
2133820,50,3,53,20,4,0,24,197,26,247
2133821,14,0,14,31,6,9,46,195,20,261
2133822,7,0,7,59,12,0,71,251,29,351
2133823,3,3,9,58,40,0,98,261,35,394
2133824,3,0,3,40,15,3,58,162,18,238
2133825,6,0,6,39,28,0,67,229,22,318
2133826,7,5,12,61,34,0,95,356,46,497
2133827,0,0,0,77,27,0,104,307,36,447
2133828,0,0,0,119,14,3,136,313,26,475
2133829,0,0,0,41,9,0,50,109,31,190
2133830,6,3,9,53,28,0,81,216,13,310
2133831,0,0,0,33,0,0,33,123,19,175
2133832,0,0,0,0,0,0,0,6,0,6
2133833,0,0,0,0,0,0,0,6,0,6
2133834,0,0,0,54,15,3,72,218,39,329
2133835,3,0,3,37,12,0,49,133,30,212
2133836,3,0,3,78,12,0,90,192,20,302
2133837,0,0,0,47,28,3,78,182,23,283
2133838,0,0,0,35,20,0,55,137,12,204
2133839,0,0,0,102,31,0,133,224,10,367
2133840,3,0,3,51,9,0,60,144,33,237
2133841,11,6,17,46,17,0,63,256,43,362
2133842,0,0,0,78,25,7,110,340,34,484
2133843,0,0,0,51,10,0,61,199,17,277
2133844,0,0,0,71,6,0,77,235,28,340
2133845,3,0,3,48,7,0,55,214,34,303
2133901,0,0,0,41,18,0,59,118,30,207
2133902,3,0,3,80,18,0,98,174,23,295
2133903,0,0,0,117,29,0,146,248,21,415
2133904,0,0,0,134,35,8,177,229,23,429
2133905,0,0,0,117,20,0,137,284,24,445
2133906,0,0,0,72,24,6,102,185,13,300
2133907,3,0,3,122,16,3,141,225,32,398
2133908,0,0,0,71,15,3,89,152,22,263
2133909,0,0,0,63,23,6,92,161,6,259
2133910,0,0,0,100,11,0,111,165,17,293
2133911,0,0,0,77,18,0,95,159,21,275
2133912,3,0,3,100,13,0,113,177,19,309
2133913,0,0,0,115,21,8,144,250,22,416
2133914,0,11,11,81,7,0,88,155,72,315
2133915,0,0,0,55,22,0,77,203,29,309
2133916,0,0,0,71,14,6,91,256,31,378
2133917,3,0,3,59,26,0,85,211,25,321
2133918,3,0,3,76,12,0,88,202,19,309
2133919,0,53,53,87,18,0,105,273,138,516
2133920,3,0,3,38,12,3,53,137,19,209
2133921,5,0,5,62,9,0,71,281,104,456
2133922,0,0,0,73,13,3,89,166,12,267
2133923,4,33,37,107,28,3,138,241,87,466
2133924,0,0,0,70,10,3,83,217,30,330
2133925,3,0,3,83,10,9,102,192,3,297
2133926,0,0,0,81,9,6,96,184,31,311
2133927,0,0,0,43,7,0,50,102,18,170
2134001,3,0,3,45,23,0,68,246,14,328
2134002,0,0,0,48,18,0,66,246,8,320
2134003,6,0,6,58,34,6,98,276,16,390
2134004,6,0,6,71,46,3,120,266,9,395
2134005,0,0,0,103,5,5,113,255,14,382
2134006,0,0,0,102,24,3,129,221,9,359
2134007,0,0,0,53,12,0,65,195,9,269
2134008,3,0,3,46,11,3,60,225,0,285
2134009,0,0,0,98,28,0,126,276,15,417
2134010,0,0,0,3,0,0,3,0,0,3
2134011,3,3,6,36,7,0,43,113,28,184
2134012,0,0,0,86,18,3,107,281,9,397
2134013,0,0,0,9,6,0,15,45,4,64
2134014,0,0,0,0,0,0,0,0,0,0
2134015,0,0,0,119,16,0,135,186,17,338
2134016,3,0,3,64,28,0,92,248,9,349
2134017,0,0,0,81,22,3,106,308,13,427
2134018,0,0,0,79,13,0,92,192,38,322
2134019,3,0,3,64,8,0,72,177,18,267
2134020,0,0,0,33,13,3,49,161,3,213
2134021,0,0,0,72,38,3,113,307,34,454
2134022,0,0,0,91,9,0,100,266,24,390
2134023,3,0,3,103,22,3,128,227,6,361
2134024,0,4,4,92,14,9,115,285,28,428
2134025,0,0,0,36,10,0,46,150,15,211
2134026,0,0,0,74,20,0,94,241,21,356
2134027,0,0,0,60,25,3,88,232,17,337
2134028,3,0,3,92,21,0,113,205,20,338
2134029,0,3,3,78,39,0,117,364,23,504
2134030,0,0,0,54,26,0,80,259,20,359
2134031,0,0,0,54,13,4,71,159,19,249
2134032,0,0,0,32,9,0,41,150,22,213
2134033,0,0,0,42,9,0,51,206,15,272
2134034,0,0,0,74,31,0,105,294,33,432
2134035,0,0,0,67,20,3,90,182,19,291
2134036,0,0,0,53,9,0,62,196,12,270
2134037,0,0,0,64,0,0,64,159,12,235
2134038,0,0,0,77,18,0,95,234,27,356
2134039,0,0,0,0,0,0,0,0,0,0
2134040,0,0,0,88,18,3,109,266,10,385
2134041,0,0,0,74,21,3,98,243,14,355
2134042,0,0,0,47,4,0,51,176,22,249
2134043,0,0,0,50,23,0,73,206,17,296
2134044,3,0,3,42,12,0,54,159,9,222
2134045,40,9,49,10,13,4,27,231,46,304
2134046,0,0,0,34,12,0,46,130,0,176
2134047,0,0,0,59,12,0,71,167,12,250
2134048,0,0,0,73,16,4,93,207,16,316
2134049,0,0,0,49,32,0,81,149,11,241
2134101,13,0,13,105,36,3,144,341,41,526
2134102,3,0,3,69,27,9,105,265,28,398
2134103,10,3,13,87,25,6,118,331,33,482
2134104,9,0,9,71,18,4,93,207,25,325
2134105,5,0,5,49,37,3,89,248,22,359
2134106,8,4,12,59,24,0,83,209,14,306
2134107,9,3,12,70,31,6,107,217,18,342
2134108,6,3,9,45,26,0,71,261,15,347
2134109,0,0,0,0,0,0,0,0,0,0
2134110,6,6,12,56,38,3,97,278,35,410
2134111,3,0,3,46,20,3,69,156,17,242
2134112,7,3,10,50,14,3,67,224,27,318
2134113,7,0,10,75,44,3,122,356,25,503
2134114,3,0,3,61,10,6,77,234,18,329
2134115,10,0,10,29,20,0,49,150,13,212
2134116,11,0,11,84,38,0,122,313,38,473
2134117,12,6,18,94,29,9,132,413,31,576
2134118,17,3,20,71,36,3,110,322,38,470
2134119,15,0,15,68,30,0,98,361,50,509
2134120,12,3,15,61,30,0,91,258,30,379
2134121,11,3,14,82,35,0,117,350,27,494
2134122,24,5,29,87,39,0,126,406,57,589
2134123,0,0,0,0,0,0,0,0,0,0
2134124,6,3,9,48,34,3,85,187,15,287
2134125,48,10,58,6,12,0,18,162,39,219
2134126,9,3,12,51,10,3,64,201,30,295
2134127,11,0,11,37,19,0,56,154,15,225
2134128,5,0,5,78,23,10,111,266,39,416
2134129,0,0,0,0,0,0,0,4,0,4
2134130,0,0,0,0,0,0,0,0,0,0
2134201,0,0,0,42,18,3,63,162,21,246
2134202,0,0,0,64,26,0,90,219,21,330
2134203,0,0,0,44,13,3,60,233,15,308
2134204,0,0,0,57,34,4,95,286,21,402
2134205,6,0,6,97,28,6,131,273,38,442
2134206,3,0,3,105,34,12,151,357,37,545
2134207,3,0,3,54,10,0,64,172,21,257
2134208,0,0,0,0,0,0,0,0,0,0
2134209,0,0,0,0,0,0,0,0,0,0
2134210,0,0,0,40,13,0,53,187,3,243
2134211,0,0,0,34,20,0,54,222,11,287
2134212,12,0,12,32,9,0,41,147,16,204
2134213,0,0,0,42,21,0,63,245,41,349
2134214,3,0,3,51,13,0,64,147,23,234
2134215,7,0,7,79,33,0,112,312,46,470
2134216,0,0,0,45,7,0,52,186,15,253
2134217,3,0,3,53,11,3,67,140,13,220
2134218,0,0,0,115,27,0,142,273,38,453
2134219,6,0,6,56,27,6,89,267,38,394
2134220,4,0,4,114,15,3,132,307,23,462
2134221,0,0,0,91,23,0,114,246,35,395
2134222,0,0,0,121,18,6,145,205,22,372
2134223,3,0,6,87,36,0,123,289,26,438
2134224,4,0,4,52,25,0,77,225,38,340
2134225,3,0,3,42,30,0,72,258,28,358
2134226,0,0,0,86,28,0,114,309,39,462
2134227,6,3,9,47,30,3,80,201,30,311
2134228,6,0,6,54,23,0,77,244,25,346
2134229,0,0,0,94,21,0,115,271,31,417
2134230,3,0,3,31,24,0,55,165,30,250
2134231,0,3,3,44,18,0,62,207,54,323
2134232,0,3,3,44,10,0,54,120,31,205
2134233,6,0,6,45,9,0,54,122,18,194
2134234,3,0,3,88,19,0,107,247,42,396
2134235,47,4,51,71,15,0,86,283,37,406
2134236,0,0,0,74,19,3,96,148,18,262
2134237,0,0,0,87,15,0,102,200,18,320
2134238,3,0,3,55,12,3,70,200,19,289
2134239,3,3,6,34,17,0,51,207,9,267
2134240,0,0,0,33,18,3,54,184,16,254
2134241,3,0,3,75,36,0,111,309,27,447
2134242,0,0,0,38,40,0,78,255,9,342
2134243,0,3,3,65,27,0,92,229,12,333
2134244,3,0,3,66,29,3,98,242,26,366
2134245,5,0,5,80,28,3,111,342,9,462
2134246,0,0,0,42,13,0,55,178,14,247
2134247,44,0,44,49,24,0,73,269,27,369
2134248,3,0,3,59,0,0,59,187,26,272
2134301,6,3,9,36,18,0,54,140,30,224
2134302,0,4,4,61,36,0,97,234,21,352
2134303,0,0,0,0,0,0,0,3,0,3
2134304,21,0,21,55,22,7,84,319,54,457
2134305,14,0,14,75,23,0,98,296,35,429
2134306,9,0,9,90,28,3,121,337,29,487
2134307,14,0,14,45,24,0,69,242,37,348
2134308,0,0,0,0,0,0,0,31,6,37
2134309,0,0,0,0,0,0,0,0,0,0
2134310,6,3,9,63,21,4,88,246,50,384
2134311,3,0,3,38,12,0,50,160,28,238
2134312,10,6,16,101,31,3,135,395,53,583
2134313,5,3,8,39,16,3,58,185,12,255
2134314,6,0,6,44,18,0,62,183,25,270
2134315,6,0,6,69,26,0,95,224,42,361
2134316,6,3,9,43,15,6,64,188,36,288
2134317,8,3,11,43,20,4,67,236,93,396
2134318,8,0,8,66,30,0,96,301,39,436
2134319,7,0,10,45,32,3,80,205,14,299
2134320,10,0,10,48,20,3,71,184,60,315
2134321,3,0,3,61,17,0,78,218,23,319
2134322,4,0,4,76,19,0,95,238,46,379
2134323,6,0,6,65,30,4,99,209,49,357
2134324,7,0,7,110,37,0,147,358,58,563
2134325,6,0,6,65,22,0,87,317,41,445
2134326,14,4,18,73,33,0,106,310,40,456
2134327,28,0,28,37,23,0,60,304,41,405
2134328,9,0,9,38,12,0,50,241,12,303
2134329,3,0,3,42,6,3,51,147,24,222
2134330,12,26,38,64,32,4,100,300,89,489
2134331,31,82,113,14,12,0,26,133,157,316
2134332,3,0,3,67,26,3,96,198,63,357
2134401,7,0,7,56,12,0,68,161,19,248
2134402,28,0,28,82,21,3,106,206,28,340
2134403,5,0,5,93,35,0,128,265,29,422
2134404,7,0,7,62,18,0,80,186,24,290
2134405,10,6,16,76,28,6,110,317,34,461
2134406,0,0,3,80,35,0,115,224,29,368
2134407,6,3,9,73,24,0,97,279,21,397
2134408,6,3,9,73,11,0,84,177,18,279
2134409,5,0,5,98,10,6,114,202,15,331
2134410,7,3,10,93,26,0,119,226,31,376
2134411,3,6,9,108,19,4,131,211,24,366
2134412,6,3,9,122,23,0,145,221,22,388
2134413,0,0,0,0,0,0,0,0,0,0
2134414,0,0,0,0,0,0,0,0,0,0
2134415,18,0,18,58,15,3,76,234,16,326
2134416,9,0,9,49,15,0,64,188,18,270
2134417,6,0,6,50,18,0,68,186,13,267
2134418,6,0,6,25,5,0,30,167,13,210
2134419,4,3,7,88,20,5,113,177,30,320
2134420,7,0,7,89,18,3,110,146,24,280
2134421,6,0,6,90,13,0,103,199,20,322
2134422,0,3,3,92,24,8,124,226,32,382
2134423,7,3,10,61,13,9,83,224,26,333
2134424,0,0,0,0,0,0,0,0,0,0
2134425,7,0,7,89,23,6,118,268,41,427
2134426,3,3,6,82,15,15,112,186,39,337
2134427,0,0,0,54,16,0,70,252,15,337
2134428,3,0,3,59,19,0,78,191,24,293
2134429,8,3,11,72,23,9,104,241,30,375
2134430,10,0,13,93,37,9,139,301,27,467
2134431,3,0,3,103,24,4,131,303,30,464
2134432,3,0,3,42,15,0,57,127,21,205
2134433,5,0,5,51,10,3,64,82,18,164
2134434,0,4,4,79,12,9,100,215,18,333
2134435,0,0,0,72,7,3,82,139,19,240
2134436,0,0,0,81,9,6,96,111,12,219
2134437,11,4,15,91,30,10,131,237,32,400
2134438,4,19,23,45,10,0,55,126,61,242
2134439,9,3,12,127,20,10,157,263,46,466
2134440,5,3,8,98,17,4,119,272,31,422
2134441,3,0,3,47,18,0,65,106,15,186
2134442,8,0,8,83,28,7,118,350,35,503
2134501,0,0,0,51,4,0,55,166,10,231
2134502,0,0,0,47,21,0,68,147,21,236
2134503,5,0,5,69,16,0,85,236,30,351
2134504,3,0,3,48,15,3,66,203,24,293
2134505,5,0,5,64,25,0,89,152,24,265
2134506,0,0,0,92,9,0,101,206,21,328
2134507,0,0,0,88,24,3,115,192,24,331
2134508,0,0,0,81,18,0,99,118,33,250
2134509,0,0,0,86,13,3,102,150,14,266
2134510,0,0,0,59,11,4,74,98,11,183
2134511,0,0,0,143,32,0,175,312,38,525
2134512,0,0,3,62,16,0,78,140,18,236
2134513,3,0,3,114,19,7,140,168,27,335
2134601,0,4,4,81,22,7,110,197,28,335
2134602,3,3,6,61,15,6,82,174,9,265
2134603,7,0,7,95,16,4,115,234,25,374
2134604,8,0,8,91,23,3,117,308,37,462
2134605,5,0,5,76,30,0,106,244,45,395
2134606,4,3,7,67,27,4,98,205,29,332
2134607,3,0,3,77,23,3,103,160,7,270
2134608,6,6,12,38,12,4,54,140,14,208
2134609,13,8,21,115,38,7,160,342,41,543
2134610,3,6,9,75,26,7,108,176,15,299
2134611,14,0,14,90,23,3,116,211,9,336
2134612,7,3,10,47,18,3,68,228,21,317
2134613,4,0,4,131,31,14,176,275,14,465
2134614,6,0,9,86,30,4,120,213,13,346
2134615,22,0,22,41,28,3,72,180,0,252
2134616,7,0,7,65,28,4,97,215,4,316
2134617,12,0,12,112,23,6,141,272,26,439
2134618,5,4,9,80,28,0,108,205,29,342
2134619,4,3,7,106,23,11,140,216,15,371
2134620,0,0,0,101,18,3,122,192,12,326
2134621,3,0,3,70,25,7,102,207,20,329
2134622,10,3,13,99,31,11,141,273,45,459
2134623,8,4,12,75,18,6,99,195,10,304
2134624,9,0,9,120,37,3,160,298,3,461
2134625,0,0,0,79,20,3,102,275,19,396
2134626,20,0,20,53,16,0,69,237,19,325
2134627,6,4,10,62,19,0,81,225,9,315
2134628,0,0,0,90,9,4,103,181,12,296
2134629,0,0,0,3,3,0,6,18,6,30
2134630,33,10,43,130,24,4,158,272,37,467
2134631,3,3,6,33,16,6,55,152,21,228
2134632,9,3,12,128,41,4,173,354,22,549
2134633,6,0,6,50,12,6,68,122,9,199
2134634,0,0,0,56,8,0,64,135,0,199
2134635,0,0,0,48,15,0,63,119,12,194
2134701,0,0,0,65,13,0,78,179,18,275
2134702,5,5,10,89,18,0,107,326,64,497
2134703,3,3,6,44,11,0,55,199,59,313
2134704,0,0,0,37,9,0,46,147,34,227
2134705,3,0,3,44,15,0,59,134,36,229
2134706,5,0,5,36,12,0,48,185,52,285
2134707,0,0,0,24,11,0,35,148,36,219
2134708,5,0,5,32,21,0,53,202,37,292
2134709,4,3,7,51,21,0,72,220,56,348
2134710,5,0,5,37,15,0,52,175,99,326
2134711,10,0,10,81,26,0,107,342,60,509
2134712,3,3,6,25,16,0,41,210,38,289
2134713,11,0,11,55,7,0,62,155,19,236
2134714,8,3,11,98,22,3,123,245,25,393
2134715,11,6,17,31,31,0,62,143,18,223
2134716,33,3,36,145,53,0,198,886,308,1392
2134717,0,0,0,63,20,0,83,222,12,317
2134718,0,0,0,27,24,3,54,108,32,194
2134719,3,0,3,49,13,0,62,162,25,249
2134720,7,0,7,77,23,3,103,326,45,474
2134721,5,0,5,79,17,0,96,236,32,364
2134722,5,3,8,44,24,0,68,181,15,264
2134723,3,3,9,55,8,11,74,237,33,344
2134724,3,4,7,77,8,3,88,258,35,381
2134725,6,3,9,55,15,0,70,182,27,279
2134726,0,0,0,63,13,3,79,120,18,217
2134727,6,0,6,69,18,0,87,208,38,333
2134728,6,0,6,40,16,0,56,212,44,312
2134729,3,3,6,72,34,9,115,350,48,513
2134730,3,0,3,52,9,0,61,199,31,291
2134731,3,0,3,54,13,0,67,215,41,323
2134732,0,3,3,54,5,0,59,272,35,366
2134733,0,0,0,51,15,0,66,185,25,276
2134734,12,0,12,58,21,6,85,254,48,387
2134735,0,0,0,49,9,0,58,272,97,427
2134736,3,0,3,29,9,0,38,103,57,198
2134737,6,0,6,85,20,6,111,344,51,506
2134801,5,3,8,45,9,0,54,131,123,308
2134802,12,6,18,84,22,4,110,288,50,448
2134803,8,0,8,85,12,0,97,334,56,487
2134804,31,8,39,64,17,0,81,316,86,483
2134805,0,0,0,71,3,0,74,162,76,312
2134806,0,0,0,76,9,3,88,240,76,404
2134807,7,0,7,49,24,3,76,181,35,292
2134808,3,3,6,82,6,0,88,463,124,675
2134809,5,0,5,50,17,6,73,429,79,581
2134810,0,0,0,34,10,4,48,149,19,216
2134811,0,6,6,23,13,0,36,269,107,412
2134812,0,5,5,48,22,0,70,350,90,510
2134813,6,6,12,50,18,0,68,215,52,335
2134814,6,0,6,58,23,0,81,268,71,420
2134815,5,3,8,60,22,0,82,311,39,432
2134816,4,0,4,30,15,0,45,227,16,288
2134817,3,6,9,44,8,6,58,208,35,301
2134818,8,0,8,27,9,0,36,236,45,317
2134819,7,3,10,83,39,0,122,313,59,494
2134820,0,0,0,10,10,0,20,202,44,266
2134821,4,0,4,77,21,0,98,335,24,457
2134822,6,6,12,43,16,0,59,279,39,377
2134823,3,0,3,24,9,0,33,181,25,239
2134824,3,3,6,49,11,0,60,243,50,353
2134825,5,0,5,36,12,3,51,193,17,261
2134826,0,0,0,54,12,0,66,289,41,396
2134827,6,0,6,50,7,0,57,269,98,424
2134828,82,3,85,76,6,6,88,580,61,729
2134829,0,0,0,0,0,0,0,0,0,0
2134830,3,3,6,63,12,3,78,228,28,334
2134901,0,0,0,300,62,3,365,860,46,1271
2134902,8,0,8,49,13,0,62,234,34,330
2134903,12,3,15,52,16,0,68,253,48,369
2134904,4,0,4,49,21,6,76,272,18,366
2134905,0,0,0,9,10,0,19,175,34,228
2134906,3,0,3,76,29,0,105,304,41,450
2134907,0,4,4,60,9,4,73,200,36,309
2134908,3,0,3,49,6,0,55,172,9,236
2134909,0,0,0,59,18,0,77,170,15,262
2134910,0,0,0,58,22,0,80,183,25,288
2134911,0,0,0,50,6,0,56,128,18,202
2134912,0,0,0,43,23,0,66,174,58,298
2134913,5,0,5,54,26,6,86,368,37,491
2134914,6,3,12,48,24,0,72,199,26,297
2134915,6,0,9,62,20,0,82,441,47,570
2134916,3,0,3,82,16,3,101,169,25,295
2134917,0,0,0,88,9,0,97,140,14,251
2134918,3,0,3,127,21,0,148,272,24,444
2134919,8,3,11,53,25,0,78,267,33,378
2134920,5,3,8,37,14,0,51,239,25,315
2134921,0,0,0,38,6,0,44,208,54,306
2134922,0,0,0,17,9,0,26,214,54,294
2134923,3,0,3,67,17,5,89,174,8,271
2135001,0,0,0,92,17,3,112,163,12,287
2135002,3,0,3,76,9,4,89,224,15,328
2135003,0,0,0,89,24,4,117,258,28,403
2135004,0,0,0,57,16,3,76,206,22,304
2135005,0,0,0,100,11,9,120,213,15,348
2135006,6,0,6,120,15,0,135,172,10,317
2135007,3,3,6,71,25,6,102,214,48,364
2135008,6,3,9,64,13,6,83,239,49,371
2135009,3,0,3,76,17,0,93,273,49,415
2135010,4,3,7,95,12,8,115,186,37,338
2135011,0,5,5,56,15,6,77,238,26,341
2135012,4,4,8,91,28,3,122,216,25,363
2135013,11,0,11,91,16,0,107,248,33,388
2135014,4,0,4,93,22,8,123,278,46,447
2135015,4,0,4,55,16,0,71,166,21,258
2135016,0,0,0,54,21,6,81,272,8,361
2135017,0,0,0,63,28,3,94,193,17,304
2135018,3,0,3,97,21,6,124,435,60,619
2135019,0,0,0,81,18,0,99,180,21,300
2135101,3,0,3,63,12,6,81,169,13,263
2135102,14,0,14,71,16,10,97,228,18,343
2135103,6,3,9,63,24,3,90,207,38,335
2135104,8,6,14,65,10,3,78,243,27,348
2135105,10,6,16,53,22,3,78,304,27,409
2135106,6,0,6,65,34,3,102,203,14,319
2135107,7,3,10,91,33,6,130,213,43,386
2135108,3,4,7,38,3,4,45,235,64,344
2135109,13,4,17,82,15,0,97,232,49,378
2135110,5,0,5,90,24,12,126,267,31,424
2135111,0,0,0,0,0,0,0,6,0,6
2135112,3,6,9,42,23,0,65,198,31,294
2135113,6,0,6,75,24,0,99,307,47,453
2135114,0,0,0,0,0,0,0,9,0,9
2135115,10,0,10,63,18,6,87,194,16,297
2135116,11,0,11,69,21,0,90,209,19,318
2135117,0,0,0,35,6,3,44,215,37,296
2135118,6,0,6,69,15,0,84,334,38,456
2135119,0,0,0,69,11,0,80,239,30,349
2135120,7,3,10,66,12,0,78,221,53,352
2135121,0,3,3,35,18,6,59,215,25,299
2135122,11,3,14,69,22,5,96,267,31,394
2135123,0,0,0,9,0,0,9,6,6,21
2135124,7,0,7,66,21,6,93,151,4,248
2135125,6,0,6,70,12,4,86,256,22,364
2135126,0,6,6,53,7,6,66,240,34,340
2135127,0,3,3,44,6,0,50,152,18,220
2135128,0,0,0,57,23,4,84,185,6,275
2135201,6,0,6,110,26,10,146,201,17,364
2135202,4,0,4,73,24,0,97,267,23,387
2135203,4,0,4,65,21,3,89,284,18,391
2135204,54,0,54,61,15,0,76,227,0,303
2135205,8,0,8,54,14,6,74,260,12,346
2135206,12,5,17,99,28,3,130,371,32,533
2135207,7,0,7,92,37,0,129,369,39,537
2135208,0,0,0,111,24,7,142,256,31,429
2135209,0,0,0,102,20,9,131,214,6,351
2135210,0,0,0,101,12,12,125,189,25,339
2135211,6,6,12,60,19,7,86,200,12,298
2135212,4,0,4,103,31,16,150,279,45,474
2135213,4,0,7,60,20,6,86,247,20,353
2135214,7,0,7,54,16,3,73,174,16,263
2135215,6,0,6,49,20,0,69,259,12,340
2135216,5,0,5,102,18,9,129,288,27,444
2135217,6,5,11,78,20,0,98,244,9,351
2135218,4,0,4,122,20,0,142,240,18,400
2135219,16,4,20,93,22,3,118,297,67,482
2135220,6,3,9,41,9,3,53,123,21,197
2135221,10,0,10,84,21,3,108,208,18,334
2135222,5,0,5,108,14,15,137,196,28,361
2135223,8,3,11,84,22,4,110,208,13,331
2135224,11,0,11,116,26,3,145,295,40,480
2135225,4,0,4,38,15,0,53,222,4,279
2135226,5,9,14,102,13,9,124,293,49,466
2135227,0,0,0,0,0,0,0,0,0,0
2135228,5,0,5,80,19,3,102,213,16,331
2135229,0,0,0,100,20,0,120,227,22,369
2135230,9,0,12,115,30,3,148,255,34,437
2135231,3,0,3,53,6,0,59,183,10,252
2135232,0,0,0,0,0,0,0,0,0,0
2135301,4,0,4,43,21,0,64,139,24,227
2135302,39,0,39,111,24,3,138,181,35,354
2135303,0,0,0,156,39,6,201,265,25,491
2135304,6,0,6,63,26,3,92,176,21,289
2135305,0,0,0,55,12,0,67,120,23,210
2135306,0,0,0,61,11,0,72,189,8,269
2135307,3,0,3,143,23,10,176,200,23,399
2135308,0,3,3,40,24,0,64,131,22,217
2135309,0,0,0,74,19,4,97,209,26,332
2135310,0,0,0,61,24,6,91,206,28,325
2135311,0,0,0,75,31,0,106,166,21,293
2135312,8,12,20,73,25,6,104,250,37,391
2135313,13,8,21,29,39,0,68,221,25,314
2135314,22,4,26,56,32,0,88,294,31,413
2135315,0,0,0,72,17,3,92,102,23,217
2135316,0,0,0,183,36,4,223,291,12,526
2135317,0,0,0,68,35,3,106,189,19,314
2135318,0,0,0,67,15,6,88,161,20,269
2135319,3,0,3,70,38,4,112,222,5,339
2135320,0,0,0,79,17,6,102,203,21,326
2135321,0,0,0,173,34,19,226,235,34,495
2135322,6,3,12,65,32,6,103,187,16,306
2135323,15,6,21,43,26,3,72,195,39,306
2135324,4,0,4,71,21,4,96,227,30,353
2135325,3,0,3,49,20,0,69,194,45,308
2135326,0,5,5,116,17,6,139,241,26,406
2135327,9,4,13,125,53,15,193,334,29,556
2135328,14,3,17,35,23,4,62,270,38,370
2135329,7,0,7,148,53,15,216,324,43,583
2135330,3,0,3,93,45,5,143,233,36,412
2135331,0,3,3,57,16,3,76,195,6,277
2135332,4,0,4,54,20,3,77,165,16,258
2135333,3,0,3,41,27,3,71,237,15,323
2135334,3,0,3,52,30,6,88,161,19,268
2135335,3,0,3,64,30,3,97,262,22,381
2135336,3,0,3,44,20,0,64,177,28,269
2135337,4,0,4,58,23,0,81,252,21,354
2135338,6,0,6,84,29,9,122,188,18,328
2135339,0,0,0,118,24,0,142,223,14,379
2135401,0,0,0,0,0,0,0,0,0,0
2135402,0,0,0,640,93,9,742,1037,127,1906
2135403,0,3,3,77,18,0,95,137,12,244
2135404,0,0,0,61,17,6,84,138,15,237
2135405,0,0,0,106,21,12,139,178,6,323
2135406,0,0,0,78,19,3,100,150,18,268
2135407,0,0,0,73,21,0,94,212,24,330
2135408,104,7,111,19,18,0,37,432,51,520
2135409,0,0,0,116,13,6,135,195,29,359
2135410,0,0,0,77,24,7,108,144,12,264
2135411,0,0,0,61,7,0,68,78,9,155
2135412,3,0,3,74,12,0,86,202,6,294
2135413,0,0,0,74,21,3,98,186,12,296
2135414,0,0,0,24,19,0,43,144,13,200
2135415,0,0,0,13,24,0,37,170,4,211
2135416,3,0,3,79,29,5,113,191,27,331
2135417,0,0,0,69,3,6,78,108,15,201
2135418,0,0,0,51,10,0,61,71,0,132
2135419,0,0,0,145,22,0,167,217,24,408
2135420,0,0,0,357,56,6,419,668,57,1144
2135421,0,0,0,126,37,5,168,275,27,470
2135422,0,0,0,118,23,4,145,247,15,407
2135423,0,0,0,125,15,9,149,217,15,381
2135424,0,0,0,142,18,0,160,216,3,379
2135425,0,0,0,87,9,7,103,129,4,236
2135426,0,0,0,109,15,3,127,165,24,316
2135427,0,0,0,102,13,0,115,124,9,248
2135428,0,0,0,113,18,0,131,168,34,333
2135429,0,0,0,76,4,4,84,153,16,253
2135430,0,0,0,72,12,6,90,109,5,204
2135431,3,0,3,131,10,0,141,213,14,368
2135432,0,0,0,133,24,6,163,196,26,385
2135433,0,0,0,112,29,0,141,227,15,383
2135434,0,0,0,102,7,3,112,134,21,267
2135435,0,0,0,137,24,10,171,217,24,412
2135436,0,0,0,86,9,3,98,117,9,224
2135437,0,0,0,77,20,6,103,147,16,266
2135438,0,0,0,41,10,9,60,113,3,176
2135439,3,0,3,669,116,10,795,1133,129,2057
2135440,3,0,3,257,51,0,308,353,63,724
2135441,0,0,0,128,32,3,163,260,18,441
2135442,0,0,0,50,4,4,58,125,6,189
2135443,0,0,0,80,9,4,93,161,7,261
2135444,3,0,3,100,21,0,121,178,14,313
2135445,0,0,0,178,20,5,203,333,38,574
2135446,0,0,0,71,14,4,89,139,7,235
2135447,0,0,0,114,5,3,122,132,21,275
2135448,0,0,0,42,7,0,49,88,8,145
2135449,0,0,0,79,9,0,88,174,29,291
2135501,0,0,0,33,19,0,52,114,9,175
2135502,0,0,0,116,19,8,143,161,9,313
2135503,0,0,0,76,10,0,86,143,20,249
2135504,0,0,0,93,18,3,114,215,6,335
2135505,0,0,0,87,10,0,97,183,16,296
2135506,0,0,0,128,16,5,149,165,20,334
2135507,0,0,0,83,0,0,83,139,15,237
2135508,3,0,3,91,25,6,122,160,16,298
2135509,0,0,0,144,7,0,151,173,19,343
2135510,0,0,0,86,9,0,95,202,9,306
2135511,0,0,0,168,41,9,218,245,37,500
2135512,0,0,0,114,29,9,152,284,37,473
2135513,0,0,0,155,18,9,182,269,31,482
2135514,3,0,3,62,20,0,82,152,27,261
2135515,0,0,0,76,12,3,91,127,15,233
2135516,3,0,3,66,14,6,86,188,23,297
2135517,0,0,0,87,15,3,105,93,21,219
2135518,3,0,3,82,19,6,107,171,9,287
2135519,0,0,0,70,14,6,90,156,3,249
2135520,3,0,3,87,15,3,105,229,27,361
2135521,0,0,0,163,30,0,193,239,21,453
2135522,0,0,0,86,18,6,110,187,17,314
2135523,0,0,0,64,18,3,85,191,5,281
2135524,0,0,0,66,9,0,75,145,13,233
2135525,0,0,0,88,24,3,115,165,19,299
2135526,0,0,0,132,18,3,153,174,24,351
2135527,0,0,0,76,12,12,100,209,35,344
2135528,0,0,0,93,13,3,109,130,7,246
2135529,0,0,0,52,28,0,80,237,10,327
2135530,3,0,3,106,16,0,122,195,14,331
2135531,3,0,3,61,12,0,73,151,6,230
2135532,0,0,0,19,18,0,37,131,8,176
2135533,0,0,0,38,6,0,44,123,9,176
2135534,0,0,0,80,15,0,95,115,13,223
2135535,0,0,0,59,13,0,72,146,17,235
2135536,0,0,0,164,6,6,176,195,12,383
2135537,0,0,0,106,14,3,123,153,33,309
2135538,0,0,0,42,15,3,60,128,6,194
2135601,3,0,3,48,8,3,59,127,18,204
2135602,0,0,0,97,17,0,114,141,19,274
2135603,3,4,7,21,16,0,37,123,11,171
2135604,0,0,0,160,31,9,200,321,58,579
2135605,0,0,0,110,27,0,137,167,18,322
2135606,0,0,0,289,40,19,348,396,89,833
2135607,3,0,3,171,58,6,235,399,48,682
2135608,6,3,9,53,28,0,81,198,12,291
2135609,4,3,7,40,28,0,68,228,31,327
2135610,0,0,0,91,41,0,132,243,44,419
2135611,0,0,0,55,29,0,84,165,39,288
2135612,4,0,4,74,38,6,118,300,40,458
2135613,3,0,3,54,37,3,94,251,4,349
2135614,5,0,5,65,34,3,102,278,21,401
2135615,4,3,7,75,35,3,113,303,38,454
2135616,8,0,8,28,24,6,58,158,16,232
2135617,6,0,6,81,57,3,141,271,19,431
2135618,3,0,3,67,32,0,99,226,16,341
2135619,7,0,7,88,19,3,110,233,36,379
2135620,6,0,6,43,11,3,57,189,22,268
2135621,13,0,13,93,37,3,133,312,42,487
2135622,14,10,24,24,11,0,35,201,32,268
2135623,11,0,11,46,30,4,80,239,34,353
2135624,6,0,6,108,50,6,164,300,30,494
2135625,33,0,33,73,21,0,94,221,15,330
2135626,0,0,0,44,12,3,59,174,15,248
2135627,3,0,3,104,21,6,131,257,21,409
2135628,0,0,0,95,29,6,130,236,14,380
2135629,5,0,5,55,43,6,104,326,37,467
2135630,3,0,3,37,10,0,47,127,6,180
2135631,0,0,0,101,31,4,136,192,45,373
2135632,3,6,9,67,27,0,94,255,52,401
2135633,3,0,3,61,29,0,90,321,49,460
2135634,0,0,0,110,43,8,161,267,30,458
2135635,0,0,0,91,22,6,119,236,24,379
2135636,0,0,0,116,38,7,161,297,35,493
2135701,3,0,3,93,30,6,129,278,25,432
2135702,0,0,0,71,13,0,84,174,45,303
2135703,0,0,0,71,18,0,89,176,19,284
2135704,3,0,3,58,26,3,87,218,39,344
2135705,0,0,0,73,33,4,110,240,40,390
2135706,0,4,4,85,42,7,134,247,21,402
2135707,0,0,0,77,44,0,121,364,50,535
2135708,0,3,3,69,21,3,93,199,27,319
2135709,8,6,14,75,44,0,119,259,37,415
2135710,4,5,9,76,38,3,117,373,37,527
2135711,0,0,0,109,40,4,153,371,64,588
2135712,39,0,39,71,45,0,116,324,51,491
2135713,4,3,7,88,26,0,114,301,46,461
2135714,0,0,0,94,52,3,149,300,60,509
2135715,6,0,9,72,40,6,118,179,31,328
2135716,7,0,7,65,28,3,96,223,27,346
2135717,0,0,0,119,31,0,150,264,30,444
2135718,3,0,3,111,35,4,150,209,19,378
2135719,3,0,3,71,34,6,111,254,25,390
2135720,44,0,44,77,13,7,97,285,76,458
2135721,3,0,3,555,125,23,703,1030,112,1845
2135722,27,6,33,42,48,3,93,492,67,652
2135723,12,8,20,40,29,3,72,230,33,335
2135724,0,0,0,92,41,5,138,263,28,429
2135725,0,0,0,83,33,0,116,126,11,253
2135726,0,0,0,182,60,8,250,308,27,585
2135801,3,0,3,37,22,3,62,156,21,239
2135802,3,0,3,74,26,0,100,218,46,364
2135803,0,0,0,59,19,4,82,151,21,254
2135804,0,0,0,40,12,3,55,157,24,236
2135805,4,0,4,99,20,7,126,290,32,448
2135806,4,0,4,101,36,7,144,200,4,348
2135807,0,0,0,211,34,6,251,372,102,725
2135808,0,0,0,191,40,7,238,338,49,625
2135809,3,0,3,120,53,9,182,303,16,501
2135810,3,0,3,100,24,0,124,156,5,285
2135811,0,0,0,259,67,15,341,427,43,811
2135812,0,0,0,111,34,0,145,230,50,425
2135813,0,0,0,47,23,3,73,135,24,232
2135814,0,0,0,22,17,3,42,115,7,164
2135815,0,0,0,290,54,15,359,467,38,864
2135816,3,0,3,63,31,6,100,170,24,294
2135817,3,0,3,128,23,5,156,237,25,418
2135818,3,3,6,65,14,0,79,214,41,334
2135819,0,0,0,53,25,7,85,135,30,250
2135820,3,0,3,144,35,7,186,391,45,622
2135821,0,3,3,67,22,3,92,185,32,309
2135822,0,0,0,101,46,6,153,228,31,412
2135823,0,0,0,38,3,5,46,124,11,181
2135824,3,0,3,39,22,6,67,178,15,260
2135825,7,0,7,55,18,0,73,159,19,251
2135826,0,3,3,131,43,4,178,302,34,514
2135827,0,4,4,32,15,0,47,103,23,173
2135828,0,0,0,18,20,0,38,97,14,149
2135901,0,0,0,32,23,0,55,130,39,224
2135902,3,3,6,48,20,0,68,192,82,342
2135903,3,0,3,53,22,3,78,178,48,304
2135904,0,0,0,59,22,3,84,268,50,402
2135905,0,0,0,0,0,0,0,0,911,911
2135906,3,0,3,28,32,0,60,138,12,210
2136001,0,0,0,93,7,0,100,178,6,284
2136002,0,0,0,76,12,0,88,173,8,269
2136003,0,0,3,125,23,3,151,228,40,419
2136004,0,0,0,120,15,0,135,172,33,340
2136005,3,0,3,102,11,0,113,133,15,261
2136006,0,0,0,130,22,0,152,201,7,360
2136007,0,0,0,93,6,0,99,138,20,257
2136008,0,0,0,71,7,0,78,140,0,218
2136009,6,0,6,102,24,0,126,197,23,346
2136010,0,0,0,169,29,3,201,227,20,448
2136011,0,0,0,67,0,0,67,124,6,197
2136012,0,0,0,82,19,0,101,205,10,316
2136013,0,0,0,78,12,9,99,139,12,250
2136014,0,0,0,193,24,12,229,289,21,539
2136015,0,0,0,79,11,0,90,127,9,226
2136016,7,6,13,92,47,3,142,373,57,572
2136017,0,0,0,168,20,6,194,222,10,426
2136018,0,0,0,325,48,0,373,452,55,880
2136019,0,0,0,181,31,0,212,214,22,448
2136020,0,0,0,96,9,0,105,152,9,266
2136021,3,0,3,116,13,0,129,148,12,289
2136022,0,0,0,113,4,3,120,152,3,275
2136023,0,0,0,89,13,0,102,133,13,248
2136024,0,0,0,926,101,27,1054,1293,102,2449
2136025,0,0,0,121,20,0,141,212,12,365
2136101,0,0,0,89,21,6,116,189,15,320
2136102,0,0,0,86,10,0,96,132,9,237
2136103,0,0,0,167,27,0,194,236,22,452
2136104,0,0,0,86,27,4,117,193,13,323
2136105,7,0,7,72,20,12,104,304,46,454
2136106,0,3,3,38,12,0,50,148,30,228
2136107,0,0,0,61,8,8,77,108,34,219
2136108,3,3,6,62,23,0,85,191,21,297
2136109,0,0,0,52,14,0,66,124,20,210
2136110,0,0,0,94,10,12,116,168,27,311
2136111,0,3,3,57,11,4,72,132,22,226
2136112,0,0,0,91,21,3,115,143,12,270
2136113,4,3,7,33,20,3,56,182,14,252
2136114,0,0,0,80,40,3,123,270,8,401
2136115,0,0,0,96,16,0,112,178,20,310
2136116,3,0,3,49,20,0,69,187,10,266
2136117,0,0,0,71,27,0,98,202,25,325
2136118,0,0,0,47,23,0,70,165,35,270
2136119,0,0,7,87,30,3,120,283,39,442
2136120,3,0,3,50,10,0,60,192,14,266
2136121,3,0,3,66,31,0,97,212,15,324
2136122,3,3,6,69,32,0,101,278,35,414
2136123,0,0,0,56,20,0,76,178,14,268
2136124,3,3,6,84,24,0,108,293,29,430
2136125,0,0,0,3,0,0,3,10,3,16
2136126,0,4,4,136,51,3,190,407,32,629
2136127,0,0,0,103,21,6,130,197,12,339
2136128,0,0,0,69,21,3,93,162,12,267
2136129,0,0,0,86,27,0,113,168,17,298
2136130,0,0,0,81,24,5,110,175,26,311
2136131,0,0,0,82,18,4,104,243,15,362
2136132,20,6,26,54,30,3,87,264,18,369
2136133,3,0,3,70,23,0,93,251,25,369
2136134,0,0,0,73,20,7,100,150,9,259
2136135,3,0,3,55,23,0,78,198,38,314
2136136,3,3,6,39,9,3,51,167,47,265
2136137,0,0,0,89,39,3,131,228,16,375
2136138,0,0,0,49,11,3,63,173,18,254
2136139,0,0,0,39,10,3,52,135,20,207
2136140,0,0,0,75,15,0,90,163,33,286
2136141,0,0,0,94,21,3,118,196,15,329
2136142,0,0,0,69,12,0,81,171,24,276
2136143,0,0,0,92,17,0,109,236,27,372
2136144,0,0,0,32,18,0,50,189,13,252
2136145,0,0,0,61,15,9,85,171,12,268
2136146,0,3,3,47,21,0,68,186,26,280
2136147,0,0,0,82,12,6,100,217,18,335
2136148,0,0,0,58,16,9,83,123,22,228
2136201,0,3,3,87,49,3,139,339,68,546
2136202,0,0,0,103,34,0,137,304,54,495
2136203,4,0,4,49,19,3,71,194,17,282
2136204,7,0,7,51,39,0,90,207,15,312
2136205,5,3,8,76,25,0,101,243,24,368
2136206,0,0,0,70,21,3,94,136,0,230
2136207,0,0,0,55,7,4,66,166,19,251
2136208,3,0,3,83,24,5,112,218,16,346
2136209,0,0,0,83,13,0,96,170,22,288
2136210,6,0,6,84,20,0,104,241,10,355
2136211,3,0,3,60,40,3,103,165,36,304
2136212,7,0,7,50,40,0,90,204,28,322
2136213,6,0,6,45,26,3,74,258,40,372
2136214,5,0,5,32,41,0,73,215,40,328
2136215,6,0,6,25,20,4,49,201,24,274
2136216,0,0,0,32,21,0,53,121,14,188
2136217,0,0,5,98,32,6,136,247,16,399
2136218,0,0,0,72,31,6,109,237,26,372
2136219,3,0,3,71,27,6,104,258,20,382
2136220,11,3,14,18,15,3,36,119,19,174
2136221,4,0,4,36,25,3,64,212,26,302
2136222,0,0,0,41,23,0,64,121,25,210
2136223,0,0,0,61,3,3,67,136,15,218
2136224,3,0,3,63,12,0,75,173,10,258
2136225,0,0,0,60,27,0,87,235,29,351
2136226,0,0,0,28,19,0,47,135,7,189
2136227,0,0,0,49,22,3,74,281,8,363
2136228,0,0,0,43,27,0,70,164,29,263
2136229,0,3,3,54,18,0,72,141,21,234
2136230,0,0,0,75,13,0,88,237,38,363
2136231,3,0,3,68,22,6,96,252,41,389
2136232,0,0,0,39,20,3,62,160,16,238
2136233,3,0,3,67,25,6,98,216,5,319
2136234,3,0,3,70,31,3,104,192,12,308
2136235,3,0,3,84,36,0,120,273,42,435
2136236,3,0,3,61,22,0,83,151,8,242
2136237,0,0,0,33,19,9,61,146,9,216
2136238,0,0,0,62,18,8,88,149,12,249
2136239,3,0,3,62,26,0,88,206,13,307
2136240,4,0,4,34,33,0,67,171,48,286
2136241,3,3,6,48,18,0,66,243,40,349
2136242,4,0,4,38,21,0,59,170,46,275
2136243,3,3,6,49,23,0,72,171,45,288
2136244,0,0,0,15,15,0,30,113,8,151
2136245,3,3,6,54,31,6,91,203,24,318
2136246,3,3,6,58,39,4,101,190,33,324
2136247,3,0,3,61,27,13,101,201,22,324
2136248,0,0,0,60,26,0,86,157,14,257
2136249,0,0,0,52,20,0,72,157,27,256
2136250,0,3,3,33,3,7,43,157,12,212
2136301,3,0,3,47,15,0,62,230,23,315
2136302,4,0,4,82,18,0,100,351,39,490
2136303,0,0,0,50,6,0,56,257,38,351
2136304,0,0,0,3,0,0,3,3,0,6
2136305,6,3,9,222,42,9,273,596,82,951
2136306,4,0,4,76,18,0,94,218,40,352
2136307,0,0,0,0,0,0,0,56,20,76
2136308,0,0,0,63,9,6,78,221,56,355
2136309,3,0,3,63,27,0,90,247,38,375
2136310,0,0,0,58,10,3,71,200,27,298
2136311,3,0,3,38,11,0,49,161,28,238
2136312,3,3,6,34,11,0,45,164,15,224
2136313,3,3,6,52,19,0,71,268,31,370
2136401,0,0,0,54,15,0,69,101,4,174
2136402,0,0,0,0,0,0,0,0,0,0
2136403,0,0,0,0,0,0,0,0,0,0
2136404,0,0,0,91,9,6,106,125,9,240
2136405,0,0,0,117,15,3,135,144,7,286
2136406,0,0,0,117,25,6,148,165,6,319
2136407,0,0,0,134,9,4,147,134,21,302
2136408,0,0,0,0,0,0,0,0,0,0
2136409,0,0,0,210,26,8,244,269,42,555
2136410,0,0,0,0,3,0,3,0,0,3
2136411,6,0,6,1079,131,31,1241,1783,190,3214
2136412,0,0,0,79,9,3,91,188,12,291
2136413,0,0,0,299,34,6,339,401,34,774
2136414,0,0,0,220,20,10,250,264,15,529
2136415,0,0,0,200,41,6,247,389,41,677
2136416,3,0,3,171,22,15,208,263,48,519
2136417,3,0,3,189,14,11,214,178,12,404
2136418,0,0,0,121,13,3,137,123,6,266
2136419,4,0,4,221,28,3,252,316,18,586
2136420,0,0,0,70,16,0,86,113,12,211
2136421,0,0,0,85,12,6,103,143,13,259
2136422,6,0,6,220,23,7,250,270,27,547
2136423,0,0,0,194,23,11,228,255,27,510
2136424,0,3,3,132,12,3,147,163,24,334
2136425,0,0,0,170,21,6,197,261,23,481
2136426,4,0,4,401,39,10,450,540,20,1010
2136427,0,0,0,233,63,8,304,358,44,706
2136428,3,0,3,227,24,3,254,304,33,591
2136429,0,0,0,124,15,6,145,181,3,329
2136430,0,0,0,92,11,5,108,123,16,247
2136431,0,0,0,230,25,3,258,406,31,695
2136432,0,0,0,102,9,6,117,105,9,231
2136433,0,0,0,121,18,0,139,116,15,270
2136434,0,0,0,174,24,0,198,268,24,490
2136435,0,0,0,83,17,3,103,114,4,221
2136436,5,0,8,499,62,13,574,928,73,1575
2136437,0,3,3,531,57,16,604,720,86,1410
2136438,0,0,0,187,34,3,224,308,23,555
2136439,0,0,0,142,13,0,155,178,9,342
2136440,0,0,0,185,18,6,209,248,21,478
2136441,0,0,0,193,30,6,229,325,31,585
2136442,0,0,0,78,6,3,87,118,0,205
2136443,6,0,6,523,54,18,595,855,38,1488
2136444,0,0,0,102,7,0,109,167,12,288
2136501,3,0,3,146,26,3,175,318,13,506
2136502,0,0,0,194,37,7,238,370,60,668
2136503,0,0,0,180,25,4,209,318,29,556
2136504,0,0,0,120,21,0,141,223,42,406
2136505,0,0,0,273,39,3,315,539,77,931
2136506,0,0,0,298,54,11,363,493,46,902
2136507,0,0,0,76,26,0,102,208,27,337
2136508,0,0,0,42,15,0,57,88,6,151
2136509,0,0,0,77,21,6,104,105,8,217
2136510,0,0,0,162,38,0,200,304,36,540
2136511,0,0,0,180,20,3,203,250,29,482
2136512,0,0,0,191,43,6,240,334,63,637
2136513,0,0,0,32,21,3,56,164,17,237
2136514,3,0,3,31,18,0,49,117,17,183
2136515,0,0,0,46,16,3,65,97,18,180
2136516,0,0,0,125,25,4,154,210,33,397
2136517,0,0,0,129,34,10,173,251,37,461
2136518,0,0,0,87,24,0,111,118,9,238
2136519,0,0,0,76,17,0,93,112,6,211
2136520,10,0,10,24,34,0,58,168,18,244
2136521,0,0,0,72,15,0,87,160,9,256
2136522,0,0,0,254,35,7,296,424,44,764
2136523,0,0,0,133,33,0,166,266,16,448
2136524,3,0,3,500,72,11,583,855,245,1683
2136525,0,0,0,73,18,6,97,172,31,300
2136526,0,0,0,60,15,0,75,148,11,234
2136527,0,3,3,85,9,3,97,170,16,283
2136528,3,0,3,128,29,3,160,247,38,445
2136529,0,0,0,94,35,4,133,158,7,298
2136530,0,0,0,313,35,11,359,523,88,970
2136531,9,0,9,164,47,0,211,326,33,570
2136532,3,0,3,214,31,6,251,408,63,722
2136533,0,0,0,130,23,3,156,177,14,347
2136534,0,0,0,80,9,4,93,168,15,276
2136601,0,4,4,0,0,0,0,0,788,788
2136602,5,0,5,947,167,23,1137,2023,299,3459
2136603,0,0,0,31,3,0,34,69,9,112
2136604,0,0,0,0,0,0,0,7,0,7
2136605,0,0,0,108,22,0,130,221,25,376
2136606,0,0,0,127,9,0,136,184,21,341
2136607,0,0,0,133,24,3,160,211,3,374
2136608,0,0,0,469,61,10,540,888,85,1513
2136609,0,0,0,265,44,9,318,388,33,739
2136610,0,0,0,172,37,6,215,350,29,594
2136701,3,3,6,112,24,3,139,173,30,342
2136702,3,0,3,49,26,0,75,164,29,268
2136703,6,0,6,120,18,3,141,209,39,389
2136704,3,0,3,89,17,3,109,157,31,297
2136705,3,0,3,54,21,3,78,188,8,274
2136706,3,0,3,86,22,0,108,279,47,434
2136707,13,3,16,45,23,0,68,199,54,321
2136708,9,0,9,37,39,3,79,277,37,393
2136709,6,0,6,63,27,10,100,265,12,377
2136710,7,0,7,44,20,4,68,183,18,269
2136711,6,0,6,117,32,3,152,281,27,460
2136712,0,0,0,117,21,0,138,236,42,416
2136713,3,0,3,99,9,0,108,266,62,436
2136714,3,6,9,54,25,3,82,147,39,268
2136715,3,0,3,114,36,9,159,265,33,457
2136716,7,3,10,52,28,0,80,191,36,307
2136717,0,0,0,49,15,0,64,140,15,219
2136718,0,0,0,84,19,7,110,218,17,345
2136719,4,3,7,74,40,0,114,262,21,397
2136720,0,0,0,64,33,3,100,195,35,330
2136721,3,0,3,53,26,0,79,195,27,301
2136722,0,0,0,59,15,0,74,172,18,264
2136723,3,0,3,55,27,3,85,202,27,314
2136724,3,0,3,80,24,3,107,171,12,290
2136725,0,0,0,70,29,6,105,267,56,428
2136726,3,0,3,57,24,6,87,234,39,360
2136727,0,0,0,50,18,0,68,148,48,264
2136728,5,0,5,74,29,4,107,338,30,475
2136729,6,0,6,45,28,3,76,170,13,259
2136730,0,0,0,112,20,9,141,243,34,418
2136731,0,0,0,63,30,0,93,222,30,345
2136732,0,0,0,57,3,0,60,154,21,235
2136733,4,0,4,104,17,3,124,216,20,360
2136734,0,0,0,84,18,3,105,208,9,322
2136735,0,0,0,67,25,0,92,188,28,308
2136736,3,0,3,42,18,0,60,158,9,227
2136737,104,77,181,3,3,0,6,219,150,375
2136738,0,0,0,62,9,6,77,218,9,304
2136739,0,0,0,0,0,0,0,0,0,0
2136740,0,0,0,90,12,3,105,142,0,247
2136741,0,0,0,86,18,6,110,156,8,274
2136742,0,0,0,0,0,0,0,0,0,0
2136743,0,0,0,69,15,3,87,139,10,236
2136744,0,0,0,81,15,4,100,139,4,243
2136745,0,0,0,45,20,0,65,158,9,232
2136746,4,0,4,63,7,0,70,156,21,247
2136747,0,0,0,110,19,0,129,214,39,382
2136748,0,0,0,41,33,3,77,231,24,332
2136749,6,0,6,83,16,0,99,206,25,330
2136750,0,0,0,86,25,0,111,244,41,396
2136751,0,0,0,56,26,0,82,179,35,296
2136752,6,0,6,78,22,3,103,271,34,408
2136753,0,0,0,42,22,3,67,195,27,289
2136754,0,0,0,21,13,0,34,131,18,183
2136755,0,0,0,81,19,6,106,170,29,305
2136756,0,0,0,21,17,4,42,168,3,213
2136757,3,0,3,52,28,6,86,161,9,256
2136758,0,0,0,93,33,0,126,233,34,393
2136759,3,0,3,144,26,0,170,263,27,460
2136760,21,10,31,48,40,0,88,334,54,476
2136761,0,0,0,93,27,6,126,250,6,382
2136762,35,3,38,73,16,0,89,358,44,491
2136763,10,0,10,46,9,3,58,237,16,311
2136764,4,0,4,43,15,0,58,192,24,274
2136765,5,0,5,53,17,0,70,227,34,331
2136766,6,0,6,30,9,4,43,149,15,207
2136767,0,0,0,44,6,3,53,176,15,244
2136768,4,0,4,106,37,0,143,279,34,456
2136769,0,0,0,49,12,0,61,123,15,199
2136770,7,0,7,45,21,0,66,157,15,238
2136771,0,0,0,51,26,0,77,141,10,228
2136772,0,3,3,63,19,0,82,158,27,267
2136773,0,0,0,55,6,0,61,105,14,180
2136774,0,0,0,50,18,9,77,151,6,234
2136775,0,0,0,66,21,3,90,177,41,308
2136776,0,0,0,55,6,0,61,115,12,188
2136801,3,3,6,58,17,0,75,228,27,330
2136802,0,0,0,48,35,5,88,279,7,374
2136803,0,0,0,0,0,0,0,0,0,0
2136804,6,0,6,61,35,3,99,303,16,418
2136805,0,0,0,0,0,0,0,0,0,0
2136806,5,0,5,57,22,0,79,201,12,292
2136807,17,0,17,70,41,3,114,324,36,474
2136808,8,0,8,62,17,0,79,182,27,288
2136809,3,4,7,63,28,3,94,264,20,378
2136810,10,0,10,67,32,4,103,221,18,342
2136811,36,0,36,67,30,0,97,286,24,407
2136812,0,0,0,35,23,4,62,156,19,237
2136813,7,0,7,40,14,0,54,189,10,253
2136814,6,0,9,34,31,0,65,180,31,276
2136815,3,0,3,48,13,3,64,164,8,236
2136816,23,6,29,61,23,0,84,276,27,387
2136817,35,8,43,48,18,0,66,283,38,387
2136818,6,3,9,33,20,0,53,229,15,297
2136819,0,0,0,0,0,0,0,4,0,4
2136820,4,0,4,44,20,3,67,210,18,295
2136821,0,0,0,33,19,0,52,165,0,217
2136822,6,0,6,56,36,3,95,292,14,401
2136823,9,0,9,56,23,3,82,348,27,457
2136824,17,6,23,66,37,0,103,317,42,462
2136825,0,0,0,149,36,0,185,295,17,497
2136826,4,0,4,137,37,5,179,328,12,519
2136827,0,0,0,46,22,9,77,203,31,311
2136828,7,0,7,43,30,0,73,204,15,292
2136901,3,3,6,59,9,4,72,122,27,221
2136902,0,0,0,93,24,0,117,288,39,444
2136903,0,0,0,64,12,9,85,141,27,253
2136904,0,0,0,54,31,0,85,136,15,236
2136905,0,0,0,38,15,3,56,110,13,179
2136906,0,0,0,50,39,6,95,171,26,292
2136907,3,0,3,50,30,3,83,217,27,327
2136908,0,0,0,66,19,3,88,160,18,266
2136909,0,0,0,43,12,3,58,140,22,220
2136910,0,0,0,91,16,4,111,195,17,323
2136911,0,0,0,130,24,4,158,172,22,352
2136912,0,0,0,164,25,10,199,198,8,405
2136913,3,0,3,162,25,3,190,238,30,458
2136914,3,0,3,210,31,9,250,333,42,625
2136915,0,0,0,110,16,3,129,194,18,341
2136916,0,0,0,26,27,3,56,111,20,187
2136917,0,0,0,198,46,0,244,265,57,566
2136918,4,0,4,127,38,4,169,333,46,548
2136919,3,0,3,66,24,5,95,160,12,267
2136920,6,0,6,99,43,10,152,288,40,480
2136921,4,0,4,61,28,3,92,221,16,329
2136922,28,0,31,619,112,19,750,1003,144,1897
2136923,6,0,6,63,24,0,87,123,6,216
2136924,0,0,0,80,12,3,95,144,9,248
2136925,0,0,0,12,9,0,21,20,18,59
2136926,0,0,0,0,0,0,0,0,0,0
2136927,0,0,0,94,22,7,123,158,18,299
2136928,3,0,3,53,18,3,74,69,11,154
2136929,0,0,0,69,9,0,78,95,21,194
2136930,0,0,0,54,28,0,82,160,18,260
2136931,0,0,0,52,7,0,59,109,12,180
2136932,0,0,0,43,18,0,61,133,21,215
2136933,0,0,0,41,12,0,53,100,12,165
2136934,0,0,0,38,21,4,63,103,17,183
2136935,0,0,0,48,13,0,61,90,23,174
2136936,3,0,3,344,65,8,417,563,75,1055
2136937,0,0,0,15,6,0,21,50,0,71
2137001,3,0,3,63,4,4,71,108,14,193
2137002,6,0,6,49,16,0,65,139,25,229
2137003,0,0,0,103,32,0,135,273,28,436
2137004,0,0,0,98,28,4,130,212,12,354
2137005,3,3,6,188,43,13,244,366,65,675
2137006,0,0,0,139,34,7,180,311,30,521
2137007,3,0,3,192,39,6,237,382,35,654
2137008,26,4,30,83,41,0,124,365,62,551
2137009,3,0,3,118,28,4,150,206,18,374
2137010,0,0,0,77,30,0,107,185,22,314
2137011,16,3,19,70,27,4,101,284,37,422
2137012,10,0,10,43,13,0,56,196,21,273
2137013,42,10,52,120,28,13,161,409,82,652
2137014,0,3,3,97,30,5,132,254,38,424
2137015,0,0,0,60,9,0,69,128,13,210
2137016,0,0,0,55,30,0,85,222,18,325
2137017,6,0,6,69,18,3,90,221,33,344
2137018,0,0,0,61,24,7,92,168,40,300
2137019,6,0,6,130,35,14,179,333,21,533
2137020,0,0,0,76,18,3,97,188,35,320
2137021,0,0,0,65,16,0,81,112,36,229
2137022,0,0,0,49,17,3,69,161,27,257
2137023,63,18,81,109,34,3,146,514,69,729
2137024,0,0,0,172,45,6,223,381,35,639
2137025,0,0,0,0,0,0,0,0,0,0
2137026,0,0,0,0,0,0,0,3,0,3
2137027,0,0,0,0,0,0,0,3,0,3
2137028,0,0,0,0,0,0,0,10,0,10
2137029,0,0,0,0,0,0,0,0,0,0
2137030,0,3,3,61,16,0,77,140,22,239
2137031,0,0,0,108,14,0,122,190,56,368
2137032,0,0,0,112,28,6,146,329,124,599
2137033,40,0,40,90,44,7,141,348,82,571
2137034,3,0,3,70,14,0,84,143,35,262
2137035,0,0,0,62,31,9,102,151,24,277
2137036,0,0,0,64,15,6,85,185,16,286
2137037,3,0,3,80,20,4,104,186,19,309
2137038,0,3,3,25,12,6,43,106,18,167
2137039,0,0,0,26,18,6,50,103,16,169
2137040,0,0,0,59,22,3,84,235,56,375
2137041,3,0,3,57,16,9,82,257,30,369
2137042,0,0,0,95,16,7,118,246,29,393
2137043,0,0,0,50,11,6,67,196,15,278
2137044,0,0,0,102,35,6,143,236,19,398
2137101,6,3,9,82,26,9,117,216,40,373
2137102,9,0,9,46,27,3,76,194,36,306
2137103,0,0,0,85,24,6,115,190,10,315
2137104,4,0,4,47,20,0,67,113,12,192
2137105,4,3,7,86,26,8,120,198,12,330
2137106,0,0,0,68,31,0,99,164,12,275
2137107,7,3,10,93,32,5,130,285,52,467
2137108,18,6,24,49,18,0,67,234,48,349
2137109,6,3,9,26,21,6,53,247,27,327
2137110,20,4,24,64,27,0,91,313,49,453
2137111,0,0,0,52,25,5,82,146,29,257
2137112,7,0,7,39,24,0,63,192,23,278
2137113,3,0,3,44,24,0,68,155,18,241
2137114,10,0,10,59,17,0,76,207,37,320
2137115,6,3,9,77,25,5,107,207,15,329
2137116,10,0,10,40,24,0,64,219,27,310
2137117,3,0,6,50,38,8,96,263,19,378
2137118,3,7,10,47,32,0,79,242,44,365
2137119,3,0,3,60,38,4,102,226,23,351
2137120,6,0,6,43,10,6,59,157,17,233
2137121,11,0,11,59,26,0,85,303,24,412
2137122,6,0,6,57,27,12,96,233,27,356
2137123,12,0,12,27,15,0,42,222,35,299
2137124,8,0,8,62,23,0,85,250,97,432
2137125,7,3,10,68,14,0,82,237,53,372
2137126,4,3,7,43,15,6,64,248,51,363
2137127,5,3,8,50,22,0,72,202,15,289
2137128,6,0,6,49,15,9,73,167,20,260
2137129,6,6,12,44,19,4,67,299,44,410
2137130,8,3,11,47,14,0,61,192,38,291
2137131,15,0,15,68,15,9,92,312,38,442
2137132,6,3,9,68,21,6,95,241,53,389
2137133,3,3,6,29,15,0,44,180,26,250
2137134,5,4,9,75,41,0,116,223,20,359
2137135,15,3,18,38,30,6,74,287,56,417
2137136,7,0,7,57,33,0,90,296,29,415
2137137,0,3,3,26,17,0,43,116,9,168
2137138,53,10,63,42,20,6,68,317,34,419
2137139,7,3,10,49,15,0,64,151,23,238
2137140,6,3,9,41,21,3,65,124,12,201
2137141,6,6,12,38,20,0,58,197,39,294
2137142,6,0,6,89,38,12,139,224,15,378
2137143,0,0,0,62,34,4,100,205,25,330
2137144,6,0,6,54,40,3,97,194,14,305
2137145,3,3,6,65,33,6,104,180,20,304
2137146,3,3,6,82,38,0,120,258,23,401
2137147,3,0,3,85,17,7,109,167,13,289
2137148,0,0,0,81,23,6,110,184,15,309
2137149,3,0,3,60,20,0,80,165,12,257
2137150,4,3,7,49,27,0,76,167,15,258
2137151,4,3,7,43,25,0,68,271,70,409
2137152,4,0,4,64,38,0,102,227,58,387
2137153,3,3,6,55,28,3,86,216,42,344
2137154,0,0,0,42,23,3,68,191,20,279
2137155,0,0,0,30,21,3,54,146,21,221
2137201,0,0,0,65,22,6,93,202,32,327
2137202,5,5,10,94,41,3,138,315,34,487
2137203,3,3,9,38,17,0,55,165,33,253
2137204,7,0,7,77,25,0,102,246,50,398
2137205,3,6,9,54,25,3,82,193,35,310
2137206,8,3,11,69,28,3,100,281,35,416
2137207,3,3,6,61,20,4,85,157,28,270
2137208,4,0,4,24,29,0,53,180,34,267
2137209,0,0,0,3,0,0,3,3,0,6
2137210,0,0,0,0,0,0,0,6,0,6
2137211,0,3,3,37,19,0,56,198,46,300
2137212,4,0,4,72,35,7,114,217,24,355
2137213,0,3,3,105,24,6,135,232,29,396
2137214,4,3,7,72,31,0,103,283,33,419
2137215,6,0,6,81,60,0,141,290,15,446
2137216,4,0,4,78,28,9,115,213,18,346
2137217,4,0,4,78,28,5,111,216,31,358
2137218,10,3,13,88,44,0,132,270,43,445
2137219,6,18,24,12,7,3,22,121,34,177
2137220,8,4,12,59,41,4,104,241,32,377
2137221,0,3,3,44,23,0,67,243,24,334
2137222,6,0,6,67,40,0,107,273,22,402
2137223,54,6,60,49,43,7,99,362,44,505
2137224,11,0,11,52,30,0,82,262,38,382
2137225,9,3,12,72,25,0,97,378,37,512
2137226,7,6,13,54,39,0,93,237,45,375
2137227,3,0,3,81,33,6,120,249,39,408
2137228,6,3,9,37,25,0,62,104,9,175
2137229,0,7,7,26,20,0,46,100,26,172
2137230,3,0,3,40,13,0,53,150,18,221
2137231,0,0,0,44,18,6,68,175,10,253
2137232,5,0,5,53,21,9,83,218,46,347
2137233,8,0,8,91,25,6,122,293,41,456
2137234,3,0,3,71,31,6,108,302,33,443
2137235,0,3,3,35,18,0,53,161,21,235
2137236,0,0,0,74,40,6,120,220,9,349
2137237,3,3,6,63,27,3,93,180,22,295
2137238,8,0,8,38,21,4,63,105,21,189
2137239,0,0,0,47,20,6,73,150,3,226
2137240,6,0,6,68,31,0,99,217,21,337
2137241,54,9,63,63,43,6,112,327,69,508
2137242,3,3,6,72,25,3,100,234,63,397
2137243,3,0,3,40,23,0,63,157,13,233
2137244,4,3,7,23,11,0,34,156,13,203
2137245,0,3,3,64,33,6,103,273,34,410
2137246,3,0,3,67,21,4,92,203,35,330
2137247,0,0,0,48,21,3,72,204,27,303
2137248,0,0,0,44,24,6,74,140,42,256
2137301,5,0,5,56,26,3,85,226,5,316
2137302,0,0,0,75,21,0,96,162,9,267
2137303,8,3,11,77,31,10,118,233,21,372
2137304,3,0,3,73,35,4,112,159,6,277
2137305,3,0,3,26,20,6,52,123,0,175
2137306,0,0,3,28,22,6,56,118,0,174
2137307,6,0,6,53,17,6,76,114,3,193
2137308,5,0,5,90,40,6,136,312,20,468
2137309,8,0,8,93,29,9,131,236,17,384
2137310,3,0,3,48,15,0,63,169,12,244
2137311,6,3,9,98,49,6,153,295,30,478
2137312,3,6,9,56,27,3,86,158,15,259
2137313,0,0,0,58,20,3,81,150,26,257
2137314,76,41,117,26,8,3,37,201,58,296
2137315,3,0,3,59,51,0,110,214,20,344
2137316,3,57,60,61,31,3,95,228,115,438
2137317,0,0,0,55,23,3,81,140,15,236
2137318,0,0,0,45,37,0,82,242,3,327
2137319,0,3,3,55,14,3,72,128,7,207
2137320,7,0,7,38,17,3,58,126,4,188
2137321,8,0,8,87,23,6,116,155,0,271
2137322,3,0,3,71,36,6,113,196,9,318
2137323,9,0,9,111,43,7,161,273,23,457
2137324,0,6,6,82,15,3,100,209,36,345
2137325,6,3,9,76,27,3,106,201,16,323
2137326,11,0,11,59,41,5,105,190,15,310
2137327,6,3,9,69,35,3,107,224,29,360
2137328,8,3,11,37,27,0,64,196,11,271
2137329,0,0,0,34,19,0,53,108,14,175
2137330,0,0,0,65,19,0,84,274,33,391
2137331,13,5,21,96,47,3,146,286,19,451
2137332,3,3,9,90,19,6,115,187,16,318
2137333,8,0,8,36,19,0,55,135,8,198
2137334,10,5,15,55,32,0,87,213,18,318
2137335,15,0,15,96,39,0,135,250,21,406
2137336,9,6,15,87,47,12,146,262,20,428
2137337,11,3,14,31,15,9,55,156,18,229
2137338,6,0,6,77,21,3,101,191,12,304
2137339,168,92,260,0,17,0,17,464,153,634
2137340,3,0,3,109,38,0,147,311,27,485
2137341,3,0,3,103,27,5,135,248,18,401
2137342,3,0,3,122,35,3,160,272,19,451
2137343,0,0,0,41,21,0,62,157,9,228
2137344,0,0,0,0,0,0,0,0,0,0
2137345,3,0,3,45,17,6,68,100,4,172
2137346,0,0,0,65,18,6,89,184,0,273
2137401,3,0,3,59,34,0,93,226,12,331
2137402,3,0,3,139,44,6,189,308,33,530
2137403,6,3,12,50,26,0,76,169,15,260
2137404,7,0,7,74,27,4,105,294,28,427
2137405,0,0,0,74,36,3,113,217,20,350
2137406,3,3,6,132,30,8,170,239,20,429
2137407,6,0,6,150,64,9,223,377,19,619
2137408,3,0,3,90,30,8,128,271,13,412
2137409,3,0,3,84,10,9,103,131,13,247
2137410,0,0,0,56,37,3,96,191,18,305
2137411,3,3,6,90,34,6,130,191,19,340
2137412,3,0,3,42,22,6,70,137,14,221
2137413,0,0,0,101,49,0,150,287,14,451
2137414,6,0,6,213,40,12,265,390,28,683
2137415,0,0,0,92,19,10,121,154,10,285
2137416,3,3,6,89,19,6,114,170,15,299
2137417,0,0,0,103,44,3,150,256,16,422
2137418,0,3,3,54,12,3,69,172,9,250
2137419,6,0,6,62,22,3,87,188,12,287
2137420,0,0,0,84,24,6,114,147,4,265
2137421,3,0,3,99,21,5,125,153,0,278
2137422,0,0,0,79,28,8,115,169,4,288
2137423,0,3,3,56,14,3,73,130,12,215
2137424,0,0,0,96,39,9,144,288,18,450
2137425,3,0,3,56,26,6,88,176,17,281
2137426,3,0,3,72,42,6,120,177,6,303
2137427,5,0,5,134,42,5,181,383,18,582
2137428,3,0,3,79,21,9,109,288,28,425
2137429,4,0,4,99,56,0,155,279,23,457
2137430,3,0,3,67,33,16,116,195,3,314
2137431,0,0,0,68,14,3,85,171,3,259
2137432,3,0,3,68,35,10,113,195,6,314
2137433,0,0,0,85,8,3,96,200,16,312
2137434,3,0,3,88,18,11,117,182,12,311
2137435,0,0,0,0,4,0,4,0,0,4
2137436,0,0,0,78,41,3,122,275,24,421
2137437,0,0,0,56,12,0,68,234,9,311
2137438,3,3,6,94,39,3,136,257,30,423
2137439,0,0,0,39,8,6,53,127,8,188
2137440,0,0,0,67,9,0,76,143,20,239
2137441,7,0,7,57,32,3,92,285,9,386
2137442,3,3,6,50,36,3,89,259,8,356
2137443,3,0,3,64,29,3,96,291,22,409
2137444,0,0,0,115,48,5,168,333,36,537
2137445,6,3,9,104,22,6,132,245,18,395
2137446,3,0,3,74,18,3,95,160,19,274
2137447,0,0,0,86,31,7,124,210,23,357
2137448,0,4,4,93,44,3,140,221,13,374
2137449,12,0,12,30,21,0,51,214,32,297
2137450,0,0,0,76,16,4,96,157,16,269
2137451,3,0,3,81,36,0,117,179,10,306
2137501,48,13,61,0,6,0,6,156,30,192
2137502,0,0,0,18,15,0,33,111,12,156
2137503,0,0,0,40,12,3,55,111,12,178
2137504,6,4,10,64,21,5,90,237,57,384
2137505,3,3,6,77,25,0,102,231,27,360
2137506,0,0,0,42,15,0,57,174,42,273
2137507,6,3,9,81,44,4,129,272,24,425
2137508,11,3,14,77,31,12,120,229,22,371
2137509,0,0,0,0,0,0,0,0,0,0
2137510,6,0,6,145,38,3,186,307,55,548
2137511,0,3,3,89,29,16,134,250,46,430
2137512,0,0,0,81,22,7,110,193,16,319
2137513,8,0,8,79,36,6,121,229,5,355
2137514,3,3,9,60,22,0,82,161,16,259
2137515,3,3,6,73,30,0,103,284,24,411
2137516,0,6,6,60,19,4,83,157,34,274
2137517,10,0,10,75,32,6,113,291,30,434
2137518,3,0,3,32,8,0,40,189,52,281
2137519,0,0,0,92,28,4,124,275,22,421
2137520,12,0,12,69,20,5,94,247,26,367
2137521,6,6,12,72,27,6,105,226,19,350
2137522,8,0,8,49,43,6,98,255,52,405
2137523,4,3,7,72,29,6,107,228,48,383
2137524,6,3,9,46,17,0,63,243,40,346
2137525,0,0,0,0,0,0,0,3,0,3
2137526,6,3,9,81,39,7,127,313,31,471
2137527,6,6,12,93,39,0,132,276,31,439
2137528,0,3,3,64,25,0,89,257,40,386
2137529,3,0,3,47,25,9,81,193,15,289
2137530,0,0,0,37,24,7,68,135,25,228
2137531,0,3,3,47,38,0,85,210,12,307
2137532,6,0,6,29,19,3,51,193,55,299
2137533,0,3,3,57,35,0,92,221,48,361
2137534,3,0,3,24,18,8,50,165,21,236
2137535,5,3,8,61,21,3,85,194,40,319
2137536,4,0,4,42,23,0,65,191,17,273
2137537,0,6,6,55,34,0,89,229,28,346
2137538,9,0,9,63,25,0,88,257,58,403
2137539,0,3,3,64,38,4,106,253,35,394
2137540,24,15,39,43,25,0,68,269,52,389
2137541,3,0,3,56,25,6,87,226,17,330
2137601,0,0,0,69,20,0,89,109,10,208
2137602,0,0,0,346,93,8,447,742,41,1230
2137603,0,6,6,134,28,3,165,344,46,555
2137604,0,0,0,49,30,6,85,175,16,276
2137605,3,0,3,123,54,9,186,301,17,504
2137606,4,3,7,176,27,15,218,265,47,530
2137607,0,0,0,51,19,0,70,145,18,233
2137608,0,0,0,69,12,9,90,125,15,230
2137609,0,0,0,70,3,0,73,97,18,188
2137610,0,0,0,69,14,0,83,162,3,248
2137611,0,0,0,124,18,0,142,146,12,300
2137612,6,0,6,90,33,3,126,162,12,300
2137613,3,4,7,123,21,3,147,219,11,377
2137614,3,0,3,95,21,12,128,241,23,392
2137615,3,0,3,120,30,12,162,227,11,400
2137616,0,0,0,70,45,3,118,200,12,330
2137617,3,0,3,227,82,6,315,477,24,816
2137618,0,0,0,66,11,12,89,134,15,238
2137619,0,0,0,103,21,9,133,184,16,333
2137620,4,0,4,62,19,7,88,162,16,266
2137701,13,3,16,20,24,0,44,165,22,231
2137702,15,26,41,62,51,3,116,268,54,438
2137703,6,0,6,37,40,0,77,241,24,342
2137704,7,0,7,42,25,3,70,140,20,230
2137705,0,0,0,0,0,0,0,15,3,18
2137706,3,0,3,40,27,0,67,138,12,217
2137707,3,0,3,84,36,3,123,242,5,370
2137708,13,0,13,58,15,4,77,168,22,267
2137709,0,0,0,55,21,0,76,192,9,277
2137710,5,0,5,46,18,3,67,206,14,287
2137711,3,0,3,34,24,3,61,165,21,247
2137712,11,0,11,76,38,5,119,236,26,381
2137713,7,4,11,31,21,0,52,138,15,205
2137714,3,5,8,52,17,0,69,212,21,302
2137715,7,3,10,37,24,6,67,170,15,252
2137716,26,77,103,54,34,3,91,249,159,499
2137717,3,0,3,67,25,6,98,177,22,297
2137718,13,8,21,29,40,0,69,198,17,284
2137719,13,0,13,80,29,3,112,259,24,395
2137720,6,0,6,53,44,3,100,247,24,371
2137721,16,6,22,36,20,0,56,244,35,335
2137722,11,0,11,40,62,7,109,315,26,450
2137723,3,0,3,56,22,0,78,126,18,222
2137724,8,3,11,66,22,9,97,205,32,334
2137725,8,0,8,68,21,3,92,240,33,365
2137801,7,0,7,33,30,0,63,178,41,282
2137802,0,0,0,69,29,9,107,154,18,279
2137803,7,0,7,52,31,6,89,185,35,309
2137804,9,0,9,34,25,0,59,172,12,243
2137805,3,0,3,9,11,0,20,72,0,92
2137806,33,0,33,21,27,0,48,148,12,208
2137807,0,0,0,84,18,6,108,218,25,351
2137808,3,0,3,63,29,0,92,175,12,279
2137809,6,0,6,50,34,0,84,211,20,315
2137810,3,0,3,47,24,4,75,230,18,323
2137811,3,0,3,53,26,3,82,141,0,223
2137812,0,3,3,71,31,0,102,193,41,336
2137813,0,0,0,37,17,0,54,92,18,164
2137814,0,0,0,48,17,10,75,218,11,304
2137815,0,0,0,49,27,0,76,196,29,301
2137816,9,0,9,34,16,0,50,140,16,206
2137817,0,0,0,10,6,0,16,59,3,78
2137818,0,0,0,28,13,0,41,82,9,132
2137901,5,0,5,28,12,0,40,149,25,214
2137902,9,0,9,76,29,10,115,316,58,489
2137903,48,3,54,60,11,0,71,352,38,461
2137904,15,0,15,48,29,0,77,234,27,338
2137905,4,0,4,49,38,3,90,220,25,335
2137906,0,0,0,151,33,0,184,312,41,537
2137907,3,0,3,81,28,5,114,178,23,315
2137908,0,0,0,55,20,3,78,167,36,281
2137909,12,3,15,59,37,13,109,435,61,605
2137910,3,0,3,186,37,8,231,302,27,560
2137911,6,0,6,158,33,4,195,272,12,479
2137912,9,0,9,96,25,0,121,326,42,489
2137913,4,0,4,116,41,0,157,294,37,488
2137914,3,3,6,73,22,0,95,232,30,357
2137915,3,0,3,70,32,0,102,259,15,376
2137916,0,0,0,72,14,6,92,172,27,291
2137917,8,0,8,54,32,3,89,194,29,312
2137918,5,6,11,87,31,3,121,257,40,418
2137919,4,0,4,49,14,3,66,151,16,233
2137920,3,0,3,66,32,0,98,205,45,348
2137921,0,0,0,62,21,0,83,146,24,253
2137922,3,0,3,93,33,6,132,240,25,397
2137923,0,0,0,44,29,0,73,153,18,244
2137924,0,0,0,77,30,6,113,210,22,345
2137925,4,0,4,74,24,5,103,178,22,303
2137926,6,0,6,51,26,4,81,155,10,246
2137927,0,0,0,36,28,0,64,136,18,218
2137928,0,0,0,76,12,3,91,167,14,272
2137929,6,0,6,114,20,11,145,140,18,303
2137930,3,0,3,122,28,3,153,217,21,391
2137931,3,0,3,51,36,4,91,225,26,342
2137932,4,0,4,54,19,0,73,192,32,297
2137933,11,0,11,74,24,4,102,197,30,329
2137934,7,3,10,92,37,6,135,235,26,396
2137935,10,5,15,53,30,0,83,205,40,328
2137936,3,0,3,35,15,0,50,98,16,164
2137937,0,4,4,130,49,6,185,273,21,479
2137938,6,0,6,36,42,3,81,167,24,272
2137939,8,0,8,45,17,6,68,181,21,270
2137940,0,0,0,91,11,5,107,844,34,985
2137941,22,3,25,116,47,12,175,364,31,570
2137942,0,0,0,0,0,0,0,3,0,3
2137943,18,6,24,34,9,0,43,230,45,318
2137944,11,3,14,38,39,0,77,193,48,318
2137945,0,0,0,56,25,8,89,234,31,354
2138001,17,0,17,30,21,0,51,223,15,289
2138002,10,5,15,37,25,0,62,204,35,301
2138003,3,0,3,50,23,3,76,160,29,265
2138004,20,5,25,76,45,9,130,264,32,426
2138005,7,3,10,50,53,0,103,243,26,372
2138006,16,4,20,45,21,0,66,153,7,226
2138007,6,0,6,48,31,6,85,246,18,349
2138008,16,4,20,51,38,4,93,295,36,424
2138009,9,3,18,43,40,6,89,188,24,301
2138010,11,0,11,36,37,3,76,208,33,317
2138011,6,4,10,59,33,6,98,228,29,355
2138012,5,3,8,47,19,0,66,172,24,262
2138013,29,95,124,12,15,0,27,97,136,260
2138014,19,0,19,49,55,0,104,354,47,505
2138015,21,38,59,35,59,0,94,337,93,524
2138016,30,8,38,44,40,6,90,316,44,450
2138017,3,4,7,31,37,0,68,199,10,277
2138018,15,3,18,82,41,3,126,318,24,468
2138019,0,0,0,39,10,0,49,119,9,177
2138020,8,4,12,61,28,0,89,227,22,338
2138021,4,0,4,30,25,0,55,174,13,242
2138022,5,0,5,52,33,5,90,190,15,295
2138023,5,0,5,61,17,6,84,188,24,296
2138024,9,0,9,54,33,6,93,184,21,298
2138025,6,0,12,45,21,6,72,156,19,247
2138026,4,0,4,62,31,0,93,171,7,271
2138027,6,3,9,72,36,4,112,230,16,358
2138028,6,3,9,46,51,0,97,207,40,344
2138029,15,3,18,41,34,5,80,275,27,382
2138030,8,0,8,43,18,6,67,206,19,292
2138031,0,0,0,72,37,0,109,196,17,322
2138032,13,0,16,51,20,3,74,139,12,225
2138033,0,0,0,80,12,3,95,152,15,262
2138034,11,0,11,106,31,3,140,248,13,401
2138035,9,0,9,57,29,7,93,224,23,340
2138036,7,0,7,70,20,8,98,231,42,371
2138037,0,0,0,102,18,10,130,127,12,269
2138038,0,0,0,123,20,17,160,212,7,379
2138039,79,51,130,76,28,8,112,376,115,603
2138040,0,0,0,116,33,13,162,169,5,336
2138041,3,0,3,106,43,13,162,212,9,383
2138042,0,0,0,101,23,6,130,107,9,246
2138043,0,0,0,112,32,5,149,168,13,330
2138044,0,0,0,87,12,0,99,107,14,220
2138045,0,0,0,121,38,13,172,178,8,358
2138046,0,0,0,48,12,3,63,115,15,193
2138047,0,0,0,43,23,0,66,112,34,212
2138048,0,0,0,0,0,0,0,0,0,0
2138049,6,3,9,92,21,4,117,321,50,488
2138050,6,0,6,45,20,0,65,171,15,251
2138051,4,0,4,29,22,0,51,119,24,194
2138052,0,0,0,0,0,0,0,4,0,4
2138053,4,4,8,81,16,0,97,195,21,313
2138054,3,0,3,57,29,4,90,167,24,281
2138055,0,0,0,92,18,3,113,149,16,278
2138056,0,0,0,100,31,7,138,199,15,352
2138057,3,3,6,52,14,3,69,217,39,325
2138058,25,3,28,90,49,9,148,359,19,526
2138059,0,0,0,3,0,0,3,4,0,7
2138101,13,0,13,78,23,6,107,218,29,354
2138102,3,3,6,73,24,0,97,181,26,304
2138103,6,0,6,90,18,6,114,187,15,316
2138104,4,0,4,87,14,3,104,176,24,304
2138105,0,0,0,87,35,4,126,179,24,329
2138106,6,0,6,75,31,5,111,205,11,327
2138107,48,0,48,39,13,0,52,180,14,246
2138108,17,6,26,23,23,0,46,179,34,259
2138109,29,8,37,42,37,0,79,258,36,373
2138110,0,0,0,76,21,6,103,164,16,283
2138111,0,0,0,47,8,0,55,117,7,179
2138112,0,0,0,76,23,3,102,126,6,234
2138113,3,3,6,125,27,3,155,229,33,417
2138114,3,0,3,107,19,10,136,234,6,376
2138115,0,0,0,112,26,9,147,203,6,356
2138116,0,0,0,107,31,7,145,197,19,361
2138117,3,0,3,49,21,6,76,143,13,232
2138118,0,0,0,58,34,0,92,167,9,268
2138119,8,3,11,32,22,0,54,122,9,185
2138120,6,0,6,94,48,4,146,246,25,417
2138121,0,0,0,55,18,5,78,156,6,240
2138122,0,0,0,79,14,0,93,184,31,308
2138123,0,0,0,46,9,3,58,158,12,228
2138124,3,0,3,111,27,4,142,295,19,456
2138125,5,0,5,90,40,3,133,251,17,401
2138126,8,0,8,42,19,3,64,122,24,210
2138127,0,0,0,57,16,3,76,162,13,251
2138128,53,0,53,34,15,0,49,178,0,227
2138129,3,0,3,58,25,0,83,222,36,341
2138130,3,3,6,77,38,3,118,253,22,393
2138131,9,0,9,57,25,5,87,131,13,231
2138132,10,3,13,118,14,7,139,222,21,382
2138133,5,3,8,53,20,4,77,124,3,204
2138134,6,0,6,85,44,6,135,313,34,482
2138135,8,0,8,58,35,0,93,186,22,301
2138136,13,6,19,53,36,6,95,215,18,328
2138137,22,5,27,96,46,5,147,287,31,465
2138138,29,3,32,43,41,6,90,287,52,429
2138139,6,0,6,78,43,9,130,202,18,350
2138140,11,3,14,45,30,0,75,135,9,219
2138141,19,0,19,56,27,3,86,251,23,360
2138142,0,0,0,77,30,5,112,150,6,268
2138143,3,4,7,92,21,5,118,210,16,344
2138144,4,0,4,47,19,4,70,117,6,193
2138201,6,3,9,88,27,12,127,237,37,401
2138202,0,0,0,42,18,3,63,114,10,187
2138203,8,0,8,62,28,4,94,213,27,334
2138204,6,0,6,95,40,6,141,192,24,357
2138205,0,0,0,0,0,0,0,3,0,3
2138206,3,0,3,49,24,0,73,131,15,219
2138207,0,0,0,23,22,0,45,132,24,201
2138208,0,0,0,42,29,6,77,170,18,265
2138209,8,0,8,67,30,3,100,195,12,307
2138210,10,4,14,38,25,3,66,192,36,294
2138211,6,3,9,57,46,0,103,246,16,365
2138212,19,58,77,61,27,5,93,252,130,475
2138213,0,0,0,59,21,4,84,128,9,221
2138214,3,0,3,38,7,0,45,156,7,208
2138215,0,0,0,131,15,9,155,180,22,357
2138216,3,0,3,134,35,10,179,209,12,400
2138217,0,0,0,190,17,17,224,243,19,486
2138218,6,0,6,112,44,8,164,187,11,362
2138219,0,0,0,93,17,3,113,198,10,321
2138220,6,0,6,115,58,7,180,254,24,458
2138221,14,4,18,66,30,12,108,241,34,383
2138222,11,3,14,70,61,9,140,241,43,424
2138223,4,0,4,65,33,0,98,153,11,262
2138224,9,0,9,98,33,9,140,209,44,393
2138225,6,3,9,40,26,3,69,175,27,271
2138226,17,0,17,63,23,3,89,160,19,268
2138227,59,20,79,53,61,6,120,467,59,646
2138228,11,0,11,115,57,9,181,409,18,608
2138229,0,87,87,115,41,7,163,222,151,536
2138230,0,0,0,66,12,0,78,140,6,224
2138231,0,0,0,95,20,0,115,127,9,251
2138232,0,0,0,149,44,7,200,236,10,446
2138233,0,0,0,133,24,7,164,228,39,431
2138234,0,0,0,48,10,6,64,124,12,200
2138235,6,0,6,59,21,4,84,130,14,228
2138236,0,0,0,80,14,3,97,156,7,260
2138237,6,0,6,70,26,0,96,148,18,262
2138238,0,0,0,113,25,6,144,233,16,393
2138239,3,0,3,118,15,0,133,173,20,326
2138240,4,0,4,96,26,6,128,165,19,312
2138301,6,6,12,31,21,0,52,125,37,214
2138302,0,0,0,69,34,5,108,261,23,392
2138303,6,0,6,31,24,6,61,128,13,202
2138304,9,5,14,33,29,0,62,207,30,299
2138305,12,0,12,78,25,0,103,207,24,334
2138306,4,0,4,115,19,6,140,258,45,443
2138307,18,5,23,89,39,9,137,314,58,509
2138308,6,0,6,11,36,0,47,155,10,212
2138309,9,6,15,27,28,0,55,192,27,274
2138310,6,0,6,70,38,3,111,261,27,399
2138311,7,3,10,79,33,9,121,297,35,453
2138312,3,0,3,59,31,0,90,166,34,290
2138313,4,0,4,25,4,3,32,138,31,201
2138314,0,0,0,48,13,16,77,170,19,266
2138315,3,0,3,40,18,3,61,165,29,255
2138316,0,0,0,43,24,3,70,216,28,314
2138317,6,5,11,51,34,6,91,235,19,345
2138318,3,3,6,36,4,3,43,137,24,204
2138319,13,4,17,53,26,0,79,240,42,361
2138320,10,4,14,39,23,3,65,183,34,282
2138321,7,8,15,57,15,9,81,189,70,340
2138322,11,6,17,35,12,0,47,186,34,267
2138323,3,0,3,77,37,6,120,244,47,411
2138324,0,0,0,57,27,0,84,124,25,233
2138325,3,0,3,79,27,3,109,209,45,363
2138326,7,8,15,42,48,0,90,228,21,339
2138327,10,4,14,28,49,0,77,250,19,346
2138328,0,4,4,62,37,0,99,255,49,403
2138329,29,8,37,36,26,0,62,252,56,370
2138330,29,3,32,24,27,0,51,203,20,274
2138331,13,7,20,27,54,0,81,247,34,362
2138332,10,3,13,34,15,3,52,185,31,268
2138333,7,6,13,29,13,0,42,123,15,180
2138334,0,3,3,75,26,0,101,182,24,307
2138335,6,8,14,44,24,0,68,205,80,353
2138336,10,3,13,42,29,0,71,228,45,344
2138337,3,0,3,53,15,0,68,219,35,322
2138338,0,4,4,63,18,4,85,146,23,254
2138339,8,0,8,50,6,4,60,243,43,346
2138340,0,0,0,0,0,0,0,0,0,0
2138341,8,0,8,16,43,0,59,120,23,202
2138342,0,0,0,96,26,0,122,214,27,363
2138343,0,0,0,88,13,0,101,180,24,305
2138344,3,0,3,73,29,4,106,171,23,300
2138401,19,4,23,70,22,0,92,257,54,403
2138402,67,7,74,8,18,0,26,325,29,380
2138403,3,0,3,21,23,0,44,107,12,163
2138404,12,0,12,60,21,6,87,204,29,320
2138405,90,9,99,46,14,3,63,299,44,406
2138406,180,39,219,6,9,0,15,467,90,572
2138407,0,0,0,0,0,0,0,0,0,0
2138408,11,7,18,54,29,3,86,216,44,346
2138409,6,4,10,77,52,0,129,286,56,471
2138410,10,0,10,56,13,0,69,171,21,261
2138411,4,4,8,31,35,0,66,159,29,254
2138412,8,0,8,32,24,0,56,191,10,257
2138413,8,0,8,33,30,0,63,222,14,299
2138414,15,4,19,53,36,4,93,301,78,472
2138415,37,6,43,19,9,3,31,164,62,257
2138416,14,7,21,51,23,0,74,254,63,391
2138417,40,9,49,26,21,6,53,229,42,324
2138418,17,12,29,66,37,3,106,306,55,467
2138419,33,9,42,40,18,0,58,290,32,380
2138420,24,9,33,43,24,3,70,289,42,401
2138421,10,0,10,60,28,0,88,222,32,342
2138422,3,0,3,36,18,0,54,133,9,196
2138423,51,0,51,154,44,4,202,468,24,694
2138424,8,0,8,90,24,7,121,253,17,391
2138425,3,3,6,101,32,0,133,211,28,372
2138426,3,3,6,36,22,7,65,185,30,280
2138427,18,9,27,18,9,0,27,214,27,268
2138428,15,7,22,27,15,0,42,164,32,238
2138429,18,4,22,69,19,4,92,264,35,391
2138430,28,11,39,30,15,0,45,237,34,316
2138431,20,6,26,62,39,0,101,301,58,460
2138432,3,6,9,64,29,6,99,159,30,288
2138433,5,0,5,22,18,0,40,124,16,180
2138434,25,3,28,47,30,0,77,345,40,462
2138435,27,7,34,45,40,6,91,279,38,408
2138436,0,6,6,96,18,3,117,174,23,314
2138437,7,0,7,25,24,0,49,182,8,239
2138438,0,0,0,39,16,0,55,199,12,266
2138439,0,6,6,51,12,0,63,134,13,210
2138440,6,7,13,36,27,4,67,228,58,353
2138441,6,7,13,62,27,6,95,227,33,355
2138442,11,0,11,44,26,0,70,225,30,325
2138443,15,5,20,63,28,3,94,293,31,418
2138444,15,5,20,23,15,3,41,212,29,282
2138445,11,6,17,27,21,0,48,178,33,259
2138446,11,4,15,26,27,3,56,170,17,243
2138447,11,3,14,41,36,3,80,283,19,382
2138448,0,0,0,169,40,5,214,242,9,465
2138449,6,0,6,33,18,9,60,132,15,207
2138450,7,8,15,59,22,6,87,223,34,344
2138501,0,0,0,45,22,0,67,163,6,236
2138502,4,0,4,48,24,3,75,151,7,233
2138503,6,0,6,79,29,0,108,251,29,388
2138504,3,0,3,62,27,6,95,225,29,349
2138505,0,0,0,43,29,0,72,149,0,221
2138506,0,0,0,43,33,0,76,162,16,254
2138507,3,0,3,25,13,0,38,120,35,193
2138508,0,0,0,59,47,3,109,255,36,400
2138509,3,0,3,47,28,3,78,134,6,218
2138510,3,0,3,75,21,6,102,132,15,249
2138511,3,0,3,61,16,0,77,160,12,249
2138512,0,0,0,75,20,10,105,122,4,231
2138513,0,0,0,98,12,9,119,155,11,285
2138514,6,3,9,61,34,0,95,239,33,367
2138515,0,0,0,51,17,0,68,137,9,214
2138516,65,0,65,113,31,9,153,281,24,458
2138517,8,0,8,81,45,6,132,281,25,438
2138518,0,0,0,48,26,9,83,168,25,276
2138519,0,0,0,75,32,3,110,230,4,344
2138520,52,13,65,36,18,3,57,233,42,332
2138521,0,0,0,59,12,7,78,146,10,234
2138522,3,0,3,62,22,3,87,155,15,257
2138523,0,0,0,108,29,3,140,213,24,377
2138524,5,0,5,49,22,0,71,152,23,246
2138525,0,0,0,43,25,7,75,232,24,331
2138526,4,0,4,43,6,6,55,146,27,228
2138527,0,0,0,120,27,7,154,203,24,381
2138528,4,0,4,82,35,6,123,228,19,370
2138529,9,3,12,130,56,6,192,347,27,566
2138530,3,0,3,70,13,0,83,126,17,226
2138531,3,0,3,52,26,0,78,198,9,285
2138532,0,0,0,68,30,3,101,242,3,346
2138533,6,3,9,73,17,0,90,225,15,330
2138534,0,0,0,65,29,0,94,199,12,305
2138535,0,0,0,92,38,6,136,271,12,419
2138536,0,0,0,54,22,3,79,158,7,244
2138537,0,0,0,155,34,6,195,283,28,506
2138538,0,0,0,51,21,0,72,162,11,245
2138539,0,3,3,43,16,0,59,168,15,242
2138540,3,3,6,51,32,3,86,189,12,287
2138541,6,0,6,59,21,3,83,134,7,224
2138542,6,0,6,78,29,10,117,146,21,284
2138543,8,0,8,44,22,6,72,169,26,267
2138544,0,0,0,43,11,9,63,118,3,184
2138545,0,0,0,35,24,0,59,102,4,165
2138546,0,0,0,60,22,0,82,186,19,287
2138547,0,0,0,26,22,6,54,129,12,195
2138601,0,0,0,34,7,0,41,63,0,104
2138602,6,34,40,41,21,4,66,163,72,301
2138603,3,0,3,30,22,4,56,146,18,220
2138604,0,0,0,57,24,6,87,189,24,300
2138605,0,3,3,32,6,4,42,132,27,201
2138606,48,6,54,48,22,3,73,249,21,343
2138607,0,0,0,45,16,0,61,138,18,217
2138608,13,0,13,47,25,0,72,187,35,294
2138609,3,4,7,67,24,3,94,146,16,256
2138610,6,0,6,45,21,3,69,171,9,249
2138611,9,0,9,31,18,0,49,115,12,176
2138612,6,0,6,80,37,0,117,291,23,431
2138613,5,4,9,60,24,0,84,197,11,292
2138614,0,3,6,73,36,3,112,195,23,330
2138615,0,0,0,30,15,3,48,146,12,206
2138616,4,0,4,47,22,0,69,209,21,299
2138617,6,3,9,51,22,0,73,145,9,227
2138618,11,0,11,36,13,6,55,137,27,219
2138619,6,0,6,52,19,3,74,187,29,290
2138620,6,3,9,46,21,4,71,139,21,231
2138621,6,0,6,68,51,3,122,242,6,370
2138622,0,0,0,39,10,3,52,153,27,232
2138623,5,3,8,53,44,3,100,276,38,414
2138624,0,0,0,6,3,0,9,32,388,429
2138701,3,0,3,63,21,0,84,176,28,288
2138702,6,6,12,41,18,3,62,232,32,326
2138703,3,0,3,41,27,0,68,129,17,214
2138704,3,0,3,42,26,0,68,119,18,205
2138705,12,3,15,64,8,0,72,157,19,248
2138706,3,3,6,53,11,0,64,173,16,253
2138707,6,0,6,59,16,0,75,159,8,242
2138708,5,0,5,49,25,0,74,181,6,261
2138709,6,0,6,17,6,0,23,115,3,141
2138710,7,3,10,33,9,0,42,166,22,230
2138801,0,0,0,69,20,6,95,222,7,324
2138802,0,4,4,51,15,12,78,176,41,295
2138803,15,3,18,24,37,0,61,224,32,317
2138804,12,0,12,87,39,5,131,306,20,457
2138805,3,6,12,86,33,3,122,244,29,395
2138806,9,0,9,93,23,4,120,232,18,370
2138807,33,59,92,91,28,0,119,323,93,535
2138808,0,0,0,63,21,3,87,244,29,360
2138809,5,0,5,41,26,6,73,185,31,289
2138810,0,0,0,74,25,4,103,142,33,278
2138811,3,0,3,63,25,6,94,138,0,232
2138812,8,0,8,90,33,3,126,246,22,394
2138813,4,0,4,96,32,9,137,244,13,394
2138814,4,3,7,66,32,4,102,216,12,330
2138815,3,0,3,49,22,0,71,125,18,214
2138816,6,0,6,69,42,4,115,265,30,410
2138817,14,7,21,130,47,10,187,363,42,592
2138818,0,0,0,111,24,3,138,152,18,308
2138819,0,0,0,53,19,3,75,174,6,255
2138820,0,3,3,33,21,3,57,98,18,173
2138821,20,6,26,56,31,9,96,291,26,413
2138822,15,0,15,50,39,3,92,262,30,384
2138823,10,0,10,130,42,6,178,336,33,547
2138824,6,3,9,65,26,0,91,222,27,340
2138825,3,3,6,49,30,0,79,159,18,256
2138826,0,0,0,79,11,0,90,177,11,278
2138827,0,0,0,40,15,6,61,97,7,165
2138828,0,0,0,133,54,5,192,316,41,549
2138829,0,0,0,84,46,0,130,177,19,326
2138830,5,3,8,66,26,0,92,188,25,305
2138831,23,7,30,28,24,6,58,216,41,315
2138832,4,3,10,64,30,3,97,245,22,364
2138833,15,0,15,54,28,3,85,216,17,318
2138834,26,0,26,39,15,3,57,198,16,271
2138835,39,0,39,57,22,6,85,285,20,390
2138836,14,3,17,64,23,5,92,269,23,384
2138837,15,3,21,42,31,0,73,185,18,276
2138901,3,0,3,30,24,3,57,132,9,198
2138902,3,0,3,36,15,0,51,103,15,169
2138903,3,0,3,56,23,6,85,157,16,258
2138904,3,0,3,67,21,3,91,165,12,268
2138905,0,0,0,42,21,0,63,118,10,191
2138906,3,0,3,21,8,0,29,136,12,177
2138907,7,23,33,42,12,0,54,242,67,363
2138908,0,4,4,53,24,0,77,183,10,270
2138909,0,0,0,36,5,7,48,132,22,202
2138910,0,0,0,57,24,0,81,136,12,229
2138911,0,3,3,51,15,3,69,145,17,231
2138912,3,0,3,51,16,4,71,110,8,189
2139001,4,0,4,39,13,6,58,136,12,206
2139002,24,0,24,40,15,0,55,170,16,241
2139003,13,0,13,43,14,3,60,140,15,215
2139004,4,0,4,34,19,0,53,136,12,201
2139005,0,0,0,44,13,3,60,102,7,169
2139006,0,0,0,4,0,0,4,18,3,25
2139007,5,0,5,52,21,3,76,119,6,201
2139008,0,0,0,0,0,0,0,0,0,0
2139009,0,0,0,53,18,4,75,119,18,212
2139010,0,0,0,59,21,3,83,145,3,231
2139011,0,0,0,34,13,0,47,130,8,185
2139012,0,0,0,53,7,0,60,127,6,193
2139013,0,0,0,40,15,0,55,164,12,231
2139014,16,6,22,22,24,3,49,144,24,217
2139015,25,0,25,26,0,7,33,133,9,175
2139016,18,0,18,81,16,4,101,222,21,344
2139017,22,4,26,47,11,0,58,214,45,317
2139018,5,0,5,9,12,6,27,63,9,99
2139019,49,3,52,51,40,6,97,278,22,397
2139020,21,6,27,16,21,3,40,142,18,200
2139021,6,0,6,37,16,0,53,178,14,245
2139022,16,6,22,35,18,3,56,199,21,276
2139023,14,3,17,23,6,0,29,137,12,178
2139024,10,0,10,24,12,0,36,149,21,206
2139025,3,0,3,18,4,0,22,90,14,126
2139026,0,0,0,49,11,3,63,97,18,178
2139027,9,0,9,43,19,6,68,155,9,232
2139028,26,0,26,34,10,3,47,167,19,233
2139029,0,0,0,33,8,0,41,102,15,158
2139030,0,0,0,0,0,0,0,0,0,0
2139101,3,6,9,30,4,0,34,90,6,130
2139102,8,4,12,59,29,3,91,289,56,436
2139103,7,3,10,67,37,6,110,291,34,435
2139104,21,3,24,35,24,3,62,215,20,297
2139105,4,0,4,41,16,3,60,167,16,243
2139106,4,0,4,53,14,0,67,183,24,274
2139107,3,0,3,61,18,0,79,233,21,333
2139108,3,0,3,38,18,3,59,124,7,190
2139109,41,3,44,50,18,0,68,189,18,275
2139110,4,0,4,72,27,3,102,244,12,358
2139201,0,0,0,29,10,0,39,83,9,131
2139202,20,8,28,49,29,9,87,247,30,364
2139203,0,0,0,39,16,0,55,103,20,178
2139204,8,8,16,49,27,6,82,239,18,339
2139205,3,0,3,47,21,0,68,179,13,260
2139206,0,0,0,47,11,4,62,138,17,217
2139207,0,0,0,36,10,3,49,88,3,140
2139208,4,3,7,64,13,0,77,172,31,280
2139209,5,0,5,57,20,5,82,170,20,272
2139210,10,0,10,46,18,0,64,174,9,247
2139211,0,0,0,51,17,0,68,232,38,338
2139212,6,0,6,52,16,0,68,185,18,271
2139213,0,0,0,49,18,0,67,161,24,252
2139214,0,0,0,40,16,3,59,184,18,261
2139215,0,0,0,40,11,5,56,155,9,220
2139216,0,3,3,50,16,0,66,180,22,268
2139217,8,3,11,56,25,0,81,212,21,314
2139218,7,0,7,40,23,6,69,209,18,296
2139219,5,0,5,53,29,3,85,183,20,288
2139220,8,0,8,74,40,3,117,292,52,461
2139221,3,0,3,40,12,0,52,110,20,182
2139222,10,0,10,51,22,0,73,195,37,305
2139223,28,3,31,45,31,11,87,220,30,337
2139224,0,3,3,39,14,0,53,154,12,219
2139225,58,6,64,22,12,3,37,171,25,233
2139226,0,0,0,30,12,6,48,91,7,146
2139301,0,0,0,49,12,3,64,90,13,167
2139302,0,0,0,53,13,0,66,134,0,200
2139303,3,3,6,45,10,0,55,184,17,256
2139304,3,0,3,30,18,0,48,92,9,149
2139305,8,0,8,56,22,4,82,213,26,321
2139306,8,0,8,41,20,3,64,187,15,266
2139307,0,0,0,44,24,0,68,132,3,203
2139308,6,0,6,33,3,3,39,153,18,210
2139309,0,4,4,22,17,0,39,125,24,188
2139310,36,10,46,62,20,10,92,271,36,399
2139401,8,3,11,56,20,0,76,212,37,325
2139402,5,0,5,68,23,6,97,218,9,324
2139403,6,0,6,43,25,0,68,129,8,205
2139404,0,0,0,66,38,7,111,207,37,355
2139405,51,5,56,36,27,9,72,321,58,451
2139406,12,0,15,38,20,0,58,180,22,260
2139407,4,3,7,69,25,4,98,225,33,356
2139408,11,3,14,55,16,4,75,224,18,317
2139409,20,10,30,49,18,5,72,261,36,369
2139410,16,7,23,62,20,7,89,268,32,389
2139411,11,0,11,70,16,3,89,152,16,257
2139412,16,3,19,44,25,0,69,211,23,303
2139413,0,0,0,29,4,0,33,106,9,148
2139414,6,0,6,34,13,0,47,88,10,145
2139415,0,0,0,33,11,6,50,109,18,177
2139416,14,3,17,34,13,3,50,188,21,259
2139417,0,3,3,19,4,3,26,121,15,162
2139418,9,0,9,24,10,0,34,132,10,176
2139419,7,3,10,66,15,3,84,240,22,346
2139420,16,3,19,30,14,0,44,168,43,255
2139421,18,0,18,17,8,0,25,184,24,233
2139501,7,3,10,59,31,3,93,173,16,282
2139502,0,3,3,69,20,4,93,171,25,289
2139503,0,0,0,45,15,0,60,144,16,220
2139504,23,0,23,106,27,0,133,232,25,390
2139505,10,6,16,46,16,0,62,210,33,305
2139506,3,0,3,103,39,3,145,244,13,402
2139507,3,0,3,70,19,3,92,196,18,306
2139508,0,0,0,45,13,3,61,89,21,171
2139509,0,0,0,38,30,6,74,110,15,199
2139510,8,0,11,190,73,13,276,479,62,817
2139511,0,0,0,25,6,0,31,76,3,110
2139512,0,0,0,60,11,3,74,97,8,179
2139513,0,0,0,73,35,0,108,216,24,348
2139514,3,0,3,40,21,3,64,162,18,244
2139515,6,0,6,23,13,0,36,92,24,152
2139516,0,0,0,58,29,6,93,141,17,251
2139517,0,0,0,66,22,6,94,115,4,213
2139518,0,0,0,0,0,0,0,0,0,0
2139519,0,0,0,0,0,0,0,0,0,0
2139520,7,0,7,22,11,6,39,94,9,142
2139601,5,3,8,35,17,0,52,150,13,215
2139602,0,0,0,22,13,0,35,70,6,111
2139603,0,0,0,64,31,7,102,211,21,334
2139604,0,0,0,49,23,3,75,157,21,253
2139605,3,0,3,92,25,7,124,296,25,445
2139606,3,0,3,104,30,7,141,212,13,366
2139607,0,0,0,68,20,3,91,132,12,235
2139608,15,0,15,36,22,3,61,215,27,303
2139609,3,0,3,51,15,3,69,135,8,212
2139610,0,0,0,14,7,0,21,76,0,97
2139611,42,0,42,29,21,4,54,146,22,222
2139612,8,0,8,40,23,0,63,170,7,240
2139613,3,0,3,48,18,0,66,166,21,253
2139614,0,0,0,58,17,0,75,169,25,269
2139615,0,0,0,26,16,0,42,62,3,107
2139701,6,0,6,94,28,0,122,228,26,376
2139702,5,0,5,110,29,9,148,258,37,443
2139703,0,0,0,42,20,6,68,147,24,239
2139704,4,0,4,42,25,0,67,136,34,237
2139705,3,0,3,84,27,9,120,208,27,355
2139706,6,0,6,91,16,9,116,195,47,358
2139707,0,0,0,69,18,3,90,143,13,246
2139708,8,6,14,72,38,6,116,256,45,417
2139709,17,4,21,63,44,0,107,287,45,439
2139710,7,3,10,41,22,0,63,170,41,274
2139711,6,0,6,15,12,0,27,174,32,233
2139712,3,0,3,54,31,3,88,192,41,321
2139713,6,0,6,40,15,6,61,202,33,296
2139714,3,3,6,80,36,3,119,177,25,321
2139715,6,0,9,56,32,0,88,275,35,398
2139716,26,6,32,73,37,6,116,340,31,487
2139717,7,0,7,96,39,8,143,284,58,485
2139718,3,0,3,81,27,0,108,168,46,322
2139719,0,0,0,61,42,3,106,235,12,353
2139720,46,4,50,37,23,0,60,230,30,320
2139721,9,0,9,60,33,0,93,203,40,336
2139722,3,0,3,71,21,9,101,152,52,305
2139723,0,0,0,62,16,4,82,112,22,216
2139724,9,0,9,39,19,0,58,237,35,330
2139725,16,7,23,84,27,0,111,248,100,459
2139726,8,3,11,35,21,7,63,171,37,271
2139727,4,0,4,74,32,0,106,261,35,402
2139728,3,3,6,65,35,6,106,176,28,310
2139729,8,3,11,65,31,3,99,250,49,398
2139730,9,0,9,59,21,10,90,161,19,270
2139731,18,3,21,74,17,3,94,209,50,353
2139732,6,3,9,50,24,5,79,242,86,407
2139733,15,6,21,62,28,6,96,165,94,355
2139734,7,4,11,60,31,4,95,246,40,381
2139735,5,0,5,20,9,0,29,104,20,153
2139736,3,3,6,30,17,0,47,150,25,222
2139737,0,0,0,49,21,12,82,183,15,280
2139738,6,4,10,33,23,0,56,171,21,248
2139739,13,3,16,41,33,6,80,232,30,342
2139740,6,0,6,25,14,0,39,155,10,204
2139741,4,0,4,72,34,0,106,215,15,336
2139742,6,3,9,31,18,3,52,190,23,265
2139743,3,3,6,64,24,0,88,254,60,402
2139744,16,5,21,113,28,6,147,305,39,491
2139745,4,0,4,41,10,0,51,140,45,236
2139746,13,0,13,92,35,4,131,259,34,424
2139747,3,4,7,33,10,4,47,107,8,162
2139748,13,0,13,46,30,0,76,194,11,281
2139749,8,6,14,31,23,6,60,210,35,305
2139750,4,0,4,127,30,3,160,249,24,433
2139751,0,0,0,156,44,0,200,398,29,627
2139752,0,0,0,202,60,4,266,407,38,711
2139753,33,0,33,46,32,0,78,274,39,391
2139754,3,0,3,47,27,3,77,218,21,316
2139755,7,5,12,88,16,0,104,217,30,351
2139756,3,3,6,39,25,6,70,116,24,210
2139757,11,0,11,68,21,0,89,255,32,376
2139758,8,0,8,48,15,0,63,144,16,223
2139759,0,0,0,42,15,9,66,125,11,202
2139760,96,6,102,55,31,4,90,365,34,489
2139761,6,3,9,50,29,0,79,217,21,317
2139762,8,8,16,71,26,6,103,181,27,311
2139763,0,0,0,43,19,0,62,111,9,182
2139764,3,0,3,63,16,3,82,224,21,327
2139765,7,3,10,49,15,4,68,168,27,263
2139766,5,7,12,32,24,0,56,184,19,259
2139767,3,0,3,30,10,0,40,120,27,187
2139768,9,0,9,38,25,0,63,164,6,233
2139769,3,0,3,13,9,3,25,62,17,104
2139770,0,4,4,41,12,0,53,120,10,183
2139771,0,0,0,103,25,0,128,274,35,437
2139772,0,0,0,115,38,10,163,263,45,471
2139773,6,0,6,39,19,9,67,140,21,228
2139774,0,0,0,79,40,9,128,193,15,336
2139801,0,0,0,34,18,3,55,104,7,166
2139802,26,6,32,64,33,3,100,315,28,443
2139803,3,0,3,65,16,0,81,180,24,285
2139804,0,0,0,0,0,0,0,0,0,0
2139805,0,0,0,0,0,0,0,3,3,6
2139806,9,0,9,44,23,4,71,183,27,281
2139807,4,0,4,39,11,0,50,145,21,216
2139808,0,0,0,0,3,0,3,9,0,12
2139809,0,0,0,30,0,0,30,58,3,91
2139810,17,0,17,31,12,0,43,117,17,177
2139811,6,0,6,75,19,0,94,213,16,323
2139812,6,0,6,46,17,6,69,195,15,279
2139813,3,0,3,51,23,0,74,155,25,254
2139814,10,0,10,29,14,4,47,122,20,189
2139815,0,0,0,83,30,6,119,205,29,353
2139901,0,0,0,0,0,0,0,0,0,0
2139902,3,0,3,43,7,0,50,150,23,223
2139903,4,0,4,20,16,0,36,111,10,157
2139904,43,3,46,24,12,3,39,189,22,250
2139905,0,5,5,46,6,0,52,123,17,192
2139906,0,3,3,45,10,0,55,128,26,209
2139907,0,0,0,31,0,0,31,113,17,161
2139908,0,0,0,66,12,0,78,171,12,261
2139909,0,0,0,94,20,3,117,188,38,343
2139910,6,0,6,73,23,3,99,228,27,354
2139911,0,4,4,121,26,9,156,355,34,545
2139912,3,0,3,52,26,0,78,199,31,308
2139913,11,0,11,38,18,3,59,184,27,270
2139914,23,0,23,53,28,11,92,238,20,350
2139915,9,0,9,54,23,9,86,176,21,283
2139916,3,0,3,42,9,0,51,130,8,189
2139917,0,0,0,44,15,0,59,157,14,230
2140001,12,6,18,34,16,0,50,144,20,214
2140002,4,0,4,34,9,3,46,94,12,152
2140003,3,0,3,41,10,3,54,114,0,168
2140004,5,0,5,28,16,3,47,116,7,170
2140005,7,3,10,24,9,0,33,132,22,187
2140006,31,3,34,61,29,0,90,230,30,350
2140007,15,3,18,42,20,3,65,242,21,328
2140008,3,0,6,27,15,0,42,168,30,240
2140009,3,0,3,46,20,0,66,173,15,254
2140010,6,0,6,18,11,0,29,111,3,143
2140011,3,0,3,85,29,0,114,220,7,341
2140012,6,6,12,35,26,0,61,188,23,272
2140013,31,0,31,27,17,6,50,207,9,266
2140014,8,0,8,36,13,3,52,159,28,239
2140015,23,3,26,43,22,3,68,182,25,275
2140016,0,0,0,53,22,9,84,169,3,256
2140017,4,4,8,59,15,3,77,159,14,250
2140018,16,9,25,64,12,3,79,246,42,367
2140019,8,0,8,61,19,0,80,172,6,258
2140020,15,0,15,38,20,5,63,188,12,263
2140021,0,0,0,35,8,0,43,151,18,212
2140101,6,0,6,28,16,0,44,114,11,169
2140102,5,0,5,20,10,6,36,119,11,166
2140103,17,0,17,33,12,0,45,157,16,218
2140104,20,3,23,34,16,6,56,133,21,210
2140105,5,0,5,24,18,6,48,144,21,213
2140106,10,0,10,53,33,6,92,267,38,397
2140107,0,0,0,36,22,0,58,170,36,264
2140108,3,4,7,43,16,0,59,106,4,169
2140109,3,0,3,23,12,0,35,81,0,116
2140110,0,0,0,43,37,3,83,175,10,268
2140111,0,0,0,27,9,3,39,111,0,150
2140112,3,0,3,60,17,3,80,154,5,239
2140113,0,0,0,51,15,3,69,167,17,253
2140114,4,0,4,81,53,3,137,249,20,406
2140115,3,0,3,17,7,0,24,57,6,87
2140116,3,0,3,40,15,0,55,103,4,162
2140117,0,0,0,44,28,3,75,148,41,264
2140118,0,0,0,74,22,9,105,156,11,272
2140119,0,3,3,37,11,0,48,94,15,157
2140120,13,0,13,55,17,6,78,222,21,321
2140121,42,8,50,30,13,0,43,189,16,248
2140122,9,8,17,36,33,0,69,244,49,362
2140123,3,0,3,34,7,3,44,118,12,174
2140201,10,0,10,45,21,3,69,153,22,244
2140202,10,10,20,29,17,3,49,183,23,255
2140203,3,7,10,50,15,3,68,148,20,236
2140204,17,7,24,86,26,4,116,259,47,422
2140205,0,0,0,16,4,0,20,73,3,96
2140206,3,3,6,54,22,0,76,153,15,244
2140207,4,0,4,27,4,0,31,86,15,132
2140208,11,0,11,46,7,0,53,213,44,310
2140209,0,0,0,46,12,6,64,157,33,254
2140210,0,0,0,25,9,3,37,84,3,124
2140211,3,3,6,12,9,0,21,81,17,119
2140212,0,4,4,48,21,3,72,238,44,354
2140213,57,3,60,53,20,3,76,273,30,379
2140301,6,0,6,36,18,0,54,138,61,253
2140302,10,3,13,44,24,3,71,214,50,335
2140303,0,0,0,0,0,0,0,0,0,0
2140304,20,3,23,20,12,0,32,162,35,229
2140305,3,0,3,66,31,0,97,204,58,359
2140306,0,0,0,32,16,4,52,155,25,232
2140307,0,0,0,27,6,0,33,86,41,160
2140308,0,0,0,64,9,0,73,165,52,290
2140309,12,6,18,34,11,0,45,131,25,201
2140310,0,6,6,40,7,3,50,112,38,200
2140311,6,6,12,77,35,0,112,227,116,455
2140312,0,0,0,0,0,0,0,0,0,0
2140401,44,8,52,54,32,0,86,289,37,412
2140402,7,3,10,67,53,12,132,339,32,503
2140403,9,0,9,33,15,9,57,123,8,188
2140404,3,0,3,41,15,6,62,131,21,214
2140405,0,0,0,71,23,6,100,209,37,346
2140406,0,0,0,47,13,3,63,106,13,182
2140407,7,0,7,41,29,0,70,197,14,281
2140408,3,6,9,34,21,3,58,188,31,277
2140409,0,0,0,38,14,3,55,123,24,202
2140410,11,6,17,87,38,8,133,275,24,432
2140411,4,0,4,19,10,3,32,103,12,147
2140412,0,0,0,48,25,4,77,190,19,286
2140413,12,3,15,60,15,3,78,228,39,345
2140414,13,7,23,85,31,4,120,244,28,392
2140415,8,6,14,46,22,3,71,177,27,275
2140416,18,3,21,76,26,0,102,271,45,418
2140417,6,0,6,79,31,0,110,195,27,332
2140418,0,0,0,42,15,0,57,133,6,196
2140419,4,0,4,89,30,10,129,249,25,403
2140420,43,0,43,92,36,7,135,299,11,445
2140421,6,0,6,51,19,4,74,162,45,281
2140422,0,6,6,96,39,5,140,195,33,368
2140423,0,3,3,47,20,3,70,117,13,200
2140424,9,4,13,54,34,0,88,166,28,282
2140425,11,7,18,86,31,3,120,269,44,433
2140426,3,0,3,61,37,4,102,200,27,329
2140427,9,3,12,24,12,3,39,124,15,178
2140501,6,0,6,44,15,4,63,182,31,276
2140502,0,0,0,21,6,0,27,69,13,109
2140503,3,3,6,44,21,6,71,166,18,255
2140504,3,0,3,50,17,0,67,134,22,223
2140505,0,4,4,93,25,12,130,293,43,466
2140506,0,0,0,21,12,3,36,94,12,142
2140507,0,0,0,51,10,3,64,132,17,213
2140508,3,0,3,45,3,3,51,129,9,189
2140509,6,0,6,36,11,7,54,103,9,166
2140510,0,0,0,20,19,0,39,73,9,121
2140511,4,0,4,33,22,0,55,158,12,225
2140512,0,0,0,55,24,0,79,151,13,243
2140513,16,4,20,28,7,0,35,162,23,220
2140514,0,0,0,32,15,4,51,121,5,177
2140515,3,0,3,72,20,0,92,165,22,279
2140516,6,0,6,42,10,3,55,143,13,211
2140517,19,0,19,23,10,0,33,133,18,184
2140518,3,6,9,65,17,3,85,213,24,322
2140519,0,4,4,54,21,6,81,168,29,278
2140520,3,0,3,70,27,0,97,172,22,291
2140521,7,0,7,46,29,0,75,163,14,252
2140522,0,0,0,36,17,0,53,87,9,149
2140523,0,0,0,34,5,0,39,113,14,166
2140601,7,6,13,43,34,6,83,195,45,323
2140602,10,6,16,69,53,8,130,310,52,492
2140603,10,0,10,50,15,0,65,156,39,260
2140604,19,3,22,66,19,0,85,248,37,370
2140605,6,0,6,23,17,11,51,112,21,184
2140606,0,0,0,44,15,0,59,119,15,193
2140607,4,0,7,112,43,3,158,242,41,441
2140608,0,0,0,0,0,0,0,3,0,3
2140609,11,5,16,44,13,0,57,169,16,242
2140610,7,4,11,26,19,0,45,117,12,174
2140611,28,5,33,37,10,0,47,193,24,264
2140612,9,0,9,51,40,3,94,186,23,303
2140613,3,0,3,38,13,3,54,138,15,207
2140614,4,3,7,20,17,3,40,143,24,207
2140615,0,0,0,37,20,0,57,168,21,246
2140616,8,4,12,77,28,4,109,227,21,357
2140617,3,0,3,82,37,6,125,314,33,472
2140618,8,0,8,45,24,3,72,140,24,236
2140619,7,0,7,86,26,3,115,208,44,367
2140620,83,7,90,44,18,0,62,274,43,379
2140621,4,0,4,63,28,3,94,221,42,357
2140622,0,0,0,70,23,0,93,149,26,268
2140623,5,3,8,59,26,3,88,190,42,320
2140624,3,0,3,55,18,3,76,163,18,257
2140625,10,0,10,57,28,0,85,155,27,267
2140626,13,3,16,75,49,0,124,250,38,412
2140627,3,0,3,100,27,3,130,230,12,372
2140628,0,0,0,0,0,0,0,0,0,0
2140629,0,4,4,133,31,11,175,237,48,460
2140630,3,0,3,69,35,6,110,188,23,321
2140631,0,0,0,53,30,3,86,161,10,257
2140632,3,0,3,21,0,0,21,57,0,78
2140633,6,0,6,26,18,0,44,108,24,176
2140634,0,0,0,100,33,14,147,297,30,474
2140635,6,0,6,142,31,9,182,249,12,443
2140636,3,0,3,37,8,0,45,99,12,156
2140637,0,0,0,30,7,0,37,103,6,146
2140638,6,0,6,33,25,0,58,138,11,207
2140639,0,0,0,63,22,9,94,138,27,259
2140640,0,0,0,91,12,3,106,173,14,293
2140701,7,5,12,43,21,0,64,162,32,258
2140702,6,3,9,66,27,3,96,205,18,319
2140703,3,0,3,56,22,0,78,166,11,255
2140704,0,0,0,78,28,0,106,199,23,328
2140705,6,0,6,36,22,0,58,162,24,244
2140706,6,0,6,43,30,0,73,192,26,291
2140707,7,0,7,53,23,6,82,189,30,301
2140708,10,6,16,45,32,3,80,179,30,289
2140709,11,3,14,60,34,4,98,251,22,371
2140710,7,3,10,62,15,4,81,219,47,347
2140711,0,0,0,95,40,3,138,318,42,498
2140712,3,0,3,58,23,4,85,162,26,273
2140713,3,0,3,50,33,6,89,152,18,259
2140714,0,0,0,0,0,0,0,0,0,0
2140715,3,3,6,72,22,0,94,147,21,262
2140716,3,0,3,67,30,5,102,185,21,308
2140717,5,0,5,55,26,0,81,174,12,267
2140718,6,3,9,82,33,0,115,202,29,346
2140719,11,3,14,74,48,3,125,265,18,408
2140720,0,0,0,27,12,3,42,109,15,166
2140721,44,3,47,81,26,8,115,257,18,390
2140722,12,7,19,81,49,0,130,276,19,425
2140723,3,0,3,70,21,3,94,172,15,281
2140724,74,18,92,29,9,0,38,280,42,360
2140725,7,0,7,45,27,6,78,169,27,274
2140726,0,0,0,80,34,0,114,165,15,294
2140727,3,0,3,68,9,0,77,125,18,220
2140728,0,0,0,41,6,7,54,100,8,162
2140729,0,0,0,39,3,0,42,88,16,146
2140730,6,3,9,49,21,3,73,125,20,218
2140801,13,3,16,62,23,0,85,189,22,296
2140802,0,0,0,39,19,0,58,91,10,159
2140803,5,0,5,65,19,0,84,213,15,312
2140804,0,3,3,43,22,0,65,102,3,170
2140805,3,0,3,45,26,0,71,160,11,242
2140806,5,0,5,44,9,4,57,147,7,211
2140807,0,0,0,66,21,3,90,170,35,295
2140808,0,0,0,75,30,3,108,191,17,316
2140809,0,0,0,44,13,0,57,85,6,148
2140810,0,0,0,28,18,0,46,132,24,202
2140811,0,0,0,53,11,0,64,135,18,217
2140812,4,0,4,47,22,0,69,123,14,206
2140813,0,0,3,21,23,0,44,75,9,128
2140901,6,0,6,47,19,3,69,188,25,282
2140902,0,0,0,51,17,0,68,123,6,197
2140903,18,37,55,25,21,0,46,225,80,351
2140904,17,0,17,54,20,3,77,272,36,385
2140905,6,0,6,68,21,9,98,240,12,350
2140906,0,6,10,44,20,0,64,198,20,282
2140907,3,0,3,85,18,0,103,187,10,300
2140908,3,3,6,35,12,6,53,179,26,258
2140909,3,0,3,56,21,6,83,204,21,308
2140910,3,0,3,89,29,0,118,247,25,390
2140911,0,0,0,0,0,0,0,0,0,0
2141001,3,0,3,52,22,3,77,269,10,356
2141002,4,0,4,45,23,0,68,169,14,251
2141003,0,0,0,57,11,3,71,186,36,293
2141004,3,3,6,51,20,0,71,150,15,236
2141005,4,3,7,27,24,0,51,157,22,230
2141006,3,0,3,57,15,4,76,212,24,312
2141007,4,0,4,38,13,0,51,151,42,244
2141008,39,6,45,28,26,0,54,296,37,387
2141009,0,0,0,37,9,0,46,138,36,220
2141010,0,0,0,34,15,0,49,97,16,162
2141011,3,3,6,15,8,0,23,100,22,145
2141012,9,3,12,37,34,0,71,188,27,286
2141013,0,3,3,13,15,0,28,58,6,92
2141014,3,0,3,50,17,0,67,154,12,233
2141101,7,0,7,56,9,3,68,179,16,263
2141102,0,0,0,30,27,3,60,152,11,223
2141103,4,0,4,49,20,0,69,127,22,218
2141104,0,0,0,23,14,0,37,114,5,156
2141105,6,3,9,60,17,0,77,255,20,352
2141106,43,0,46,59,21,4,84,209,22,315
2141107,0,3,3,73,23,0,96,231,38,365
2141108,10,3,13,89,7,3,99,261,46,406
2141109,8,4,12,84,29,3,116,304,50,470
2141110,13,13,26,40,23,0,63,349,93,505
2141111,13,0,13,23,6,0,29,127,20,176
2141112,0,3,3,42,15,0,57,149,22,228
2141113,6,0,6,32,15,3,50,232,20,302
2141114,6,0,6,44,16,12,72,192,19,283
2141115,3,0,3,77,22,9,108,264,21,393
2141116,3,0,3,36,4,0,40,127,21,188
2141117,0,0,0,48,17,0,65,90,9,164
2141201,4,0,4,34,9,7,50,155,21,226
2141202,5,0,5,33,22,3,58,162,20,240
2141203,0,6,6,64,21,0,85,188,27,300
2141204,6,0,6,54,14,0,68,136,9,213
2141205,7,0,7,33,0,3,36,129,18,183
2141206,0,0,0,50,19,0,69,129,18,216
2141207,6,3,9,57,10,0,67,190,18,275
2141208,3,3,6,39,15,0,54,95,7,156
2141209,3,0,3,64,15,3,82,181,16,279
2141301,6,0,6,66,36,9,111,170,16,297
2141302,3,0,3,75,16,0,91,177,16,284
2141303,0,0,0,24,11,3,38,85,0,123
2141304,0,0,0,34,12,3,49,197,10,256
2141305,3,0,3,10,8,0,18,65,0,83
2141306,3,0,3,39,8,0,47,67,22,136
2141307,0,0,3,87,27,0,114,221,24,359
2141308,0,0,0,113,21,4,138,213,7,358
2141309,3,0,3,27,21,3,51,227,21,299
2141310,3,0,3,17,5,0,22,85,0,107
2141311,3,0,3,31,22,0,53,85,0,138
2141312,3,0,3,50,18,3,71,109,16,196
2141313,0,0,0,57,6,6,69,142,15,226
2141314,0,0,0,87,37,3,127,193,20,340
2141315,0,0,0,3,12,0,15,106,9,130
2141316,0,0,0,41,6,0,47,137,21,205
2141317,9,0,9,34,22,3,59,124,12,195
2141318,6,3,9,42,25,4,71,227,15,313
2141319,38,21,59,51,30,10,91,275,54,420
2141320,0,0,0,39,14,3,56,112,24,192
2141321,10,3,13,38,35,0,73,181,19,273
2141322,21,9,30,33,16,3,52,196,29,277
2141323,19,10,29,54,37,9,100,242,39,381
2141324,12,6,18,52,27,3,82,215,18,315
2141325,0,0,0,40,18,0,58,120,32,210
2141326,0,0,0,43,29,0,72,118,17,207
2141327,4,0,4,76,23,0,99,164,18,281
2141328,3,0,3,30,8,6,44,129,6,179
2141329,3,0,3,64,38,9,111,202,23,336
2141330,7,0,7,98,34,9,141,280,18,439
2141331,5,6,11,95,35,0,130,254,42,426
2141332,45,12,57,62,26,4,92,287,42,421
2141333,14,5,19,75,37,3,115,218,36,369
2141334,3,3,6,30,19,0,49,135,22,206
2141335,0,0,0,79,18,4,101,231,38,370
2141336,4,0,4,40,38,0,78,165,23,266
2141337,0,0,0,0,0,0,0,0,0,0
2141338,3,0,3,13,6,0,19,116,21,156
2141401,6,0,6,43,24,0,67,260,67,394
2141402,17,4,21,25,27,3,55,213,25,293
2141403,3,3,6,27,6,0,33,100,19,152
2141404,15,6,21,52,22,3,77,215,34,326
2141405,69,0,69,38,26,3,67,266,21,354
2141406,7,4,11,59,33,8,100,256,69,425
2141407,4,3,7,55,18,3,76,225,24,325
2141408,4,8,12,55,20,0,75,214,60,349
2141409,29,3,32,48,30,0,78,305,53,436
2141410,0,0,0,67,12,6,85,117,0,202
2141411,3,3,6,59,34,0,93,302,76,471
2141412,3,0,3,127,47,13,187,355,75,617
2141413,58,8,66,39,20,8,67,247,26,340
2141414,0,0,0,46,18,0,64,151,16,231
2141415,0,3,3,45,18,3,66,106,31,203
2141416,5,0,8,47,28,3,78,143,31,252
2141417,17,3,20,50,21,3,74,272,57,403
2141418,0,0,0,0,0,0,0,20,15,35
2141501,9,3,12,59,22,3,84,242,45,371
2141502,3,0,3,63,24,0,87,169,23,279
2141503,0,0,0,45,20,0,65,150,15,230
2141504,3,0,3,54,25,0,79,180,35,294
2141505,0,0,0,15,6,0,21,119,15,155
2141506,0,3,3,108,19,3,130,175,22,327
2141507,6,4,10,89,30,9,128,243,30,401
2141508,0,0,0,63,18,0,81,201,25,307
2141509,3,0,3,89,33,3,125,214,21,360
2141510,4,0,4,24,15,0,39,131,11,181
2141511,8,0,8,34,33,3,70,234,21,325
2141512,0,0,0,111,36,9,156,193,23,372
2141513,78,16,94,90,31,0,121,417,54,592
2141514,0,0,0,50,21,9,80,134,9,223
2141515,6,8,14,44,23,4,71,194,46,311
2141516,4,0,4,87,26,5,118,280,43,441
2141517,3,0,3,103,37,9,149,252,25,426
2141518,0,0,0,23,6,3,32,56,9,97
2141519,0,0,0,19,18,9,46,233,29,308
2141520,6,0,6,44,21,3,68,111,21,200
2141601,3,0,3,61,32,6,99,214,25,338
2141602,0,0,4,127,20,6,153,205,17,375
2141603,3,0,3,40,5,0,45,112,26,183
2141604,22,3,25,96,14,9,119,218,21,358
2141605,58,9,67,34,12,0,46,251,29,326
2141606,8,3,11,57,27,3,87,222,35,344
2141607,4,0,4,62,36,0,98,193,13,304
2141608,0,0,0,61,31,3,95,251,25,371
2141609,3,3,6,123,33,7,163,223,27,413
2141610,3,0,3,78,19,5,102,168,6,276
2141611,0,0,0,116,25,7,148,195,18,361
2141612,9,0,9,44,13,0,57,142,9,208
2141613,0,0,0,0,0,0,0,0,0,0
2141614,0,0,0,37,16,0,53,127,24,204
2141615,9,3,12,43,18,0,61,175,12,248
2141616,4,0,4,84,24,9,117,182,21,320
2141617,0,0,0,58,17,3,78,115,10,203
2141618,6,0,6,29,14,0,43,166,28,237
2141619,13,6,19,55,17,0,72,242,30,344
2141620,8,0,8,55,28,0,83,210,9,302
2141621,3,0,3,65,28,0,93,241,48,382
2141622,0,0,0,129,42,6,177,338,16,531
2141623,12,7,19,86,24,6,116,295,32,443
2141624,4,3,7,31,9,3,43,177,28,248
2141625,6,3,9,62,16,0,78,140,38,256
2141626,8,0,8,73,15,3,91,184,53,328
2141627,6,0,6,55,18,0,73,163,44,280
2141628,3,0,3,72,19,0,91,198,32,321
2141629,90,6,96,22,15,0,37,231,44,312
2141630,7,4,11,65,31,6,102,192,24,318
2141631,3,5,8,56,12,0,68,151,27,246
2141632,6,6,12,97,30,7,134,236,58,428
2141633,7,3,10,16,16,0,32,132,30,194
2141634,9,0,9,48,16,0,64,244,21,329
2141635,7,0,7,74,28,6,108,290,26,424
2141636,5,3,11,61,31,3,95,207,48,350
2141637,0,3,3,78,22,6,106,202,12,320
2141638,10,0,10,81,33,0,114,264,26,404
2141639,0,3,3,117,31,6,154,234,25,413
2141640,3,0,3,55,5,0,60,94,21,175
2141641,0,0,0,64,23,5,92,213,34,339
2141642,3,0,3,64,25,5,94,180,47,321
2141643,3,0,3,24,14,0,38,126,21,185
2141644,12,0,12,72,21,0,93,206,15,314
2141701,6,3,9,63,33,6,102,236,22,360
2141702,8,3,11,80,29,0,109,235,13,357
2141703,6,6,12,76,32,6,114,198,40,352
2141704,0,0,0,59,27,3,89,225,35,349
2141705,0,0,0,78,24,3,105,228,34,367
2141706,0,3,3,82,16,3,101,175,32,308
2141707,4,0,4,130,22,9,161,289,30,480
2141708,0,0,0,33,24,0,57,182,24,263
2141709,3,0,3,73,13,6,92,198,6,296
2141710,0,0,0,43,6,0,49,90,19,158
2141711,5,0,5,43,17,0,60,103,6,169
2141712,4,0,7,131,24,8,163,233,47,443
2141713,3,0,3,89,35,6,130,210,18,358
2141714,3,0,3,41,26,0,67,132,15,214
2141715,78,8,86,54,31,0,85,307,26,418
2141716,3,0,3,79,17,9,105,171,12,288
2141717,0,0,0,203,58,4,265,402,81,748
2141718,0,0,0,60,16,0,76,150,12,238
2141719,4,0,4,94,51,0,145,327,29,501
2141720,9,4,13,86,45,4,135,291,46,472
2141721,7,0,7,36,10,5,51,146,30,227
2141722,4,0,4,78,36,3,117,225,20,362
2141723,7,0,7,59,28,0,87,226,40,353
2141724,6,0,6,52,15,0,67,166,43,276
2141725,4,0,4,98,24,0,122,285,81,488
2141726,12,4,16,71,19,6,96,239,47,382
2141727,6,3,9,48,17,0,65,168,34,267
2141728,0,3,3,49,7,3,59,158,33,250
2141729,6,0,6,53,15,0,68,118,10,196
2141730,4,0,4,121,22,7,150,266,53,469
2141731,58,0,58,50,19,3,72,351,45,468
2141732,7,0,7,68,23,6,97,318,32,447
2141733,3,0,3,43,16,3,62,99,10,171
2141734,0,0,0,28,15,0,43,167,31,241
2141735,0,0,0,45,15,5,65,99,15,179
2141736,3,0,3,62,29,3,94,228,20,342
2141737,0,0,0,39,19,6,64,111,13,188
2141738,0,0,0,37,6,3,46,160,29,235
2141739,3,4,7,45,13,0,58,126,13,197
2141740,3,4,7,49,13,4,66,148,29,243
2141741,0,0,0,44,16,0,60,137,12,209
2141742,0,0,0,49,20,3,72,177,27,276
2141743,12,3,15,49,27,6,82,240,50,372
2141744,14,0,14,64,30,3,97,279,45,421
2141745,6,3,9,77,23,4,104,232,24,360
2141746,6,6,12,46,14,0,60,134,36,230
2141747,6,0,6,66,28,0,94,209,26,329
2141748,0,0,0,44,25,0,69,165,21,255
2141749,6,0,6,69,29,0,98,246,17,361
2141750,41,0,41,93,24,0,117,316,25,458
2141751,3,0,3,53,28,0,81,201,6,288
2141801,0,4,4,41,24,3,68,97,7,172
2141802,0,0,0,53,18,3,74,118,20,212
2141803,3,0,3,90,34,4,128,203,15,346
2141804,0,0,0,31,9,0,40,85,3,128
2141805,0,0,0,82,32,9,123,205,25,353
2141806,0,0,0,46,18,3,67,156,21,244
2141807,3,0,3,44,19,0,63,118,7,188
2141808,3,0,3,39,13,3,55,176,21,252
2141809,3,0,3,92,31,3,126,261,25,412
2141810,3,0,3,49,13,0,62,144,9,215
2141811,0,0,0,38,22,3,63,117,9,189
2141812,0,0,0,29,19,0,48,120,18,186
2141813,3,0,3,44,15,0,59,154,0,213
2141901,0,0,0,30,5,3,38,107,12,157
2141902,0,0,0,28,3,3,34,94,13,141
2141903,9,23,32,42,13,3,58,180,57,295
2141904,6,3,9,78,12,3,93,210,41,344
2141905,3,0,3,41,12,0,53,162,11,226
2141906,3,0,3,62,26,4,92,220,24,336
2141907,3,0,3,68,28,3,99,263,31,393
2141908,3,0,3,56,17,5,78,175,12,265
2141909,3,3,6,32,19,0,51,162,6,219
2141910,0,0,0,87,37,3,127,256,24,407
2141911,4,0,4,30,21,0,51,103,10,164
2141912,0,0,0,54,16,6,76,136,6,218
2141913,5,0,5,49,14,3,66,135,7,208
2141914,0,0,0,82,27,9,118,217,19,354
2141915,3,0,3,49,4,0,53,88,211,352
2141916,0,0,0,35,26,0,61,158,18,237
2141917,3,0,3,57,13,0,70,125,15,210
2141918,3,3,6,62,20,0,82,145,21,248
2141919,15,6,21,48,39,0,87,228,25,340
2141920,0,4,4,59,14,0,73,189,7,269
2141921,10,3,13,48,27,0,75,132,30,237
2141922,11,3,14,36,12,4,52,183,26,261
2141923,4,3,7,25,9,3,37,132,12,181
2141924,3,0,3,43,22,3,68,137,27,232
2141925,6,0,6,43,15,3,61,133,9,203
2141926,3,0,3,65,21,3,89,259,20,368
2141927,14,4,18,48,24,0,72,207,26,305
2141928,31,0,31,36,9,0,45,139,11,195
2141929,0,0,0,85,44,3,132,248,34,414
2142001,6,0,6,42,15,3,60,137,22,219
2142002,7,0,7,53,26,0,79,237,40,356
2142003,3,0,6,43,3,3,49,114,15,178
2142004,3,0,3,34,21,0,55,213,21,289
2142005,3,0,3,44,25,5,74,201,17,292
2142006,0,0,0,44,18,0,62,119,15,196
2142007,4,0,4,96,16,3,115,194,15,324
2142008,0,0,0,34,13,0,47,151,10,208
2142009,6,3,9,18,3,5,26,99,12,137
2142010,27,0,34,36,7,0,43,228,21,292
2142011,6,0,6,27,15,0,42,159,12,213
2142012,10,0,10,22,27,0,49,145,24,218
2142013,3,0,3,63,25,0,88,223,30,341
2142014,3,0,3,40,13,0,53,88,0,141
2142015,4,0,4,55,16,3,74,153,22,249
2142016,4,0,4,28,12,0,40,113,15,168
2142017,0,0,0,49,17,0,66,144,3,213
2142018,6,3,9,43,6,0,49,122,15,186
2142019,32,0,32,21,12,0,33,169,21,223
2142020,3,0,3,57,19,0,76,194,12,282
2142021,0,0,0,32,5,0,37,81,10,128
2142022,0,0,0,77,21,3,101,205,19,325
2142023,0,0,0,25,19,0,44,126,3,173
2142024,29,0,29,52,20,3,75,223,11,309
2142025,0,0,0,45,10,0,55,137,3,195
2142026,6,0,6,61,13,3,77,144,18,239
2142027,6,0,6,37,8,0,45,95,7,147
2142028,0,3,3,9,13,0,22,118,15,155
2142029,4,0,4,40,21,6,67,230,18,315
2142030,3,3,6,80,31,6,117,227,12,356
2142031,0,0,0,26,13,0,39,116,21,176
2142101,42,4,46,63,29,0,92,249,25,366
2142102,0,5,5,37,19,3,59,157,20,236
2142103,6,0,6,68,21,6,95,191,16,302
2142104,6,3,9,59,22,3,84,204,17,305
2142105,10,3,13,61,18,3,82,305,30,417
2142106,77,12,89,22,13,0,35,214,18,267
2142107,3,3,6,45,22,0,67,212,48,327
2142108,16,3,19,58,23,0,81,224,43,348
2142109,0,0,0,54,41,5,100,167,12,279
2142110,4,3,7,48,23,3,74,192,12,278
2142111,3,3,6,78,31,6,115,202,15,332
2142112,26,3,29,32,23,6,61,273,23,357
2142113,5,0,5,36,13,0,49,134,15,198
2142114,6,0,6,37,14,0,51,127,7,185
2142115,9,3,12,47,23,0,70,257,26,353
2142116,13,0,13,59,25,0,84,231,18,333
2142117,0,3,3,54,26,0,80,185,18,283
2142118,0,3,3,53,32,6,91,133,10,234
2142119,6,3,9,75,17,12,104,258,37,399
2142120,7,6,13,78,34,6,118,269,33,420
2142121,3,0,3,22,12,3,37,108,32,177
2142122,6,0,6,50,21,0,71,168,6,245
2142123,6,0,6,58,28,0,86,170,21,277
2142124,3,0,3,31,27,3,61,123,13,197
2142125,6,0,6,47,20,6,73,204,22,299
2142126,3,3,6,50,23,3,76,233,19,328
2142127,12,3,15,57,19,9,85,207,20,312
2142128,15,6,21,41,19,7,67,196,22,285
2142201,0,0,0,0,0,0,0,0,0,0
2142202,6,4,10,41,24,3,68,274,26,368
2142203,7,3,10,29,12,0,41,198,27,266
2142204,4,6,10,62,28,12,102,189,25,316
2142205,13,0,13,37,13,6,56,169,21,246
2142206,6,0,9,68,21,3,92,189,42,323
2142207,0,0,0,0,0,0,0,0,0,0
2142208,6,0,6,51,22,3,76,151,12,239
2142209,4,0,4,92,18,5,115,181,34,330
2142210,0,0,0,67,28,0,95,206,21,322
2142211,3,3,6,78,31,3,112,230,58,400
2142212,0,0,0,66,24,3,93,163,24,280
2142213,7,3,10,76,25,7,108,257,30,395
2142214,11,0,11,60,29,3,92,232,29,353
2142215,3,3,6,43,26,0,69,157,28,254
2142216,0,0,0,0,0,0,0,0,0,0
2142217,6,0,6,49,12,6,67,121,9,197
2142218,3,0,3,115,22,7,144,194,20,358
2142219,3,0,3,54,31,3,88,211,26,325
2142220,6,3,9,82,37,0,119,243,50,412
2142221,3,0,3,55,33,9,97,192,27,316
2142222,43,6,49,40,24,0,64,217,26,307
2142223,4,0,4,47,18,0,65,189,15,269
2142224,4,0,4,39,23,3,65,122,32,219
2142225,0,0,0,55,18,0,73,183,20,276
2142226,5,0,5,58,30,0,88,175,3,266
2142227,6,0,6,93,30,3,126,323,25,474
2142228,5,0,5,33,13,0,46,165,5,216
2142229,0,0,0,38,18,0,56,118,3,177
2142230,0,0,0,51,17,0,68,105,6,179
2142231,0,0,0,53,7,3,63,145,9,217
2142232,47,3,50,38,25,3,66,268,35,369
2142301,0,0,0,66,23,4,93,164,14,271
2142302,31,10,41,28,4,4,36,199,21,256
2142303,4,0,4,65,29,0,94,172,5,271
2142304,5,5,10,35,16,0,51,135,17,203
2142305,21,6,27,22,24,0,46,191,21,258
2142306,24,3,27,55,26,0,81,271,37,389
2142307,0,3,3,35,9,0,44,61,9,114
2142308,3,0,3,37,15,0,52,169,20,241
2142309,3,0,3,65,19,4,88,190,15,293
2142310,6,0,6,66,19,0,85,147,10,242
2142311,4,0,4,34,20,4,58,150,7,215
2142312,6,0,6,56,12,0,68,120,10,198
2142313,0,0,0,38,12,0,50,119,15,184
2142314,6,0,6,39,6,0,45,117,12,174
2142315,3,0,3,51,16,3,70,184,13,267
2142316,5,0,5,90,21,3,114,210,21,345
2142317,0,0,0,57,13,3,73,171,15,259
2142318,0,0,0,21,15,0,36,113,7,156
2142319,7,3,10,71,12,3,86,190,21,297
2142320,6,0,6,50,10,0,60,82,6,148
2142321,0,0,0,43,6,6,55,79,4,138
2142322,0,0,0,36,18,3,57,86,4,147
2142401,8,3,11,35,24,3,62,197,27,286
2142402,6,0,6,39,11,0,50,132,26,208
2142403,6,0,6,52,22,12,86,195,15,296
2142404,17,0,17,54,21,0,75,206,9,290
2142405,4,3,7,55,23,6,84,186,21,291
2142406,6,6,12,33,14,3,50,126,19,195
2142407,34,6,40,63,30,12,105,330,34,469
2142408,4,0,4,40,17,0,57,134,0,191
2142409,3,3,6,38,13,3,54,144,31,229
2142410,3,0,3,43,6,0,49,105,12,166
2142411,0,0,0,25,26,6,57,147,22,226
2142501,68,9,77,51,20,3,74,285,42,401
2142502,3,3,6,75,30,4,109,274,42,425
2142503,9,0,9,99,14,0,113,218,13,344
2142504,14,0,14,52,15,0,67,202,11,280
2142505,7,0,7,104,57,10,171,321,15,507
2142506,3,0,3,34,22,3,59,114,10,183
2142507,6,6,12,126,48,8,182,268,36,486
2142508,0,0,0,31,19,0,50,137,3,190
2142509,0,0,0,73,26,9,108,192,7,307
2142510,4,0,4,55,22,0,77,196,42,315
2142511,0,0,0,35,22,0,57,148,17,222
2142512,3,4,7,42,18,3,63,160,11,234
2142513,11,7,18,51,22,0,73,166,21,260
2142514,8,6,14,45,18,0,63,193,28,284
2142515,11,5,16,44,14,4,62,147,31,240
2142516,8,3,11,23,11,0,34,134,16,184
2142517,3,0,3,42,27,3,72,169,15,256
2142518,6,0,6,62,22,3,87,154,15,256
2142519,51,5,56,50,33,0,83,273,21,377
2142520,6,9,15,21,15,0,36,135,18,189
2142521,15,5,20,31,18,0,49,185,29,263
2142522,12,0,12,46,33,7,86,208,3,297
2142523,5,0,5,93,31,0,124,248,24,396
2142524,3,6,9,89,32,9,130,243,33,406
2142525,11,0,11,79,23,7,109,250,32,391
2142526,4,3,7,83,39,7,129,252,25,406
2142527,14,0,14,95,39,9,143,291,15,449
2142528,35,6,41,22,9,0,31,149,27,207
2142529,3,0,3,19,27,0,46,220,20,286
2142530,8,3,11,96,40,5,141,237,9,387
2142531,0,0,0,28,7,0,35,70,6,111
2142601,6,0,6,64,25,0,89,253,21,363
2142602,0,0,0,31,9,3,43,111,22,176
2142603,9,0,9,90,35,6,131,229,26,386
2142604,3,0,3,43,17,0,60,140,13,213
2142605,3,3,6,55,29,0,84,197,21,302
2142606,0,0,0,27,7,0,34,104,6,144
2142607,0,0,0,32,14,3,49,98,12,159
2142608,0,0,0,42,14,3,59,73,6,138
2142609,3,3,6,94,30,7,131,258,23,412
2142610,0,0,0,32,15,6,53,113,15,181
2142611,4,0,4,41,9,3,53,151,19,223
2142612,3,4,7,41,20,4,65,137,15,217
2142613,0,0,0,61,15,3,79,138,6,223
2142614,0,0,0,54,16,6,76,114,3,193
2142615,7,0,7,72,42,0,114,195,25,334
2142616,3,0,3,67,28,3,98,160,22,280
2142617,6,3,9,55,28,3,86,137,18,241
2142701,10,0,10,27,12,3,42,135,22,199
2142702,5,4,9,24,12,0,36,179,37,252
2142703,5,0,5,50,9,0,59,192,7,258
2142704,27,3,30,60,40,4,104,262,41,407
2142705,4,0,4,74,28,0,102,148,23,273
2142706,13,3,16,31,18,0,49,129,20,198
2142707,3,0,3,27,4,0,31,94,8,133
2142708,6,0,6,71,18,3,92,193,13,298
2142709,0,0,0,49,7,3,59,116,18,193
2142710,0,0,0,60,24,4,88,168,11,267
2142711,0,0,0,23,12,3,38,74,10,122
2142712,0,3,3,76,26,0,102,166,21,289
2142713,3,0,3,51,12,3,66,146,17,229
2142714,0,0,0,37,15,3,55,157,11,223
2142715,26,8,34,52,19,12,83,255,45,383
2142716,17,5,22,83,18,0,101,188,20,309
2142717,9,0,9,24,11,3,38,104,20,162
2142718,3,0,3,41,13,3,57,93,15,165
2142801,0,0,0,58,3,0,61,131,18,210
2142802,0,0,0,48,18,0,66,105,33,204
2142803,0,0,0,68,24,3,95,159,13,267
2142804,0,0,0,52,15,3,70,121,9,200
2142805,0,0,0,96,15,3,114,203,31,348
2142806,0,0,0,31,13,0,44,102,9,155
2142807,0,0,0,46,16,6,68,107,16,191
2142808,0,0,0,59,14,0,73,124,14,211
2142809,0,0,0,42,20,0,62,127,12,201
2142810,4,0,4,73,17,4,94,140,15,249
2142811,0,0,0,49,4,0,53,89,0,142
2142812,4,0,4,86,27,0,113,248,44,405
2142813,3,0,3,64,7,0,71,173,15,259
2142814,6,6,12,66,13,0,79,166,37,282
2142815,4,4,8,50,24,0,74,110,9,193
2142816,11,3,14,52,3,0,55,184,18,257
2142817,0,4,4,40,3,0,43,96,14,153
2142818,6,3,9,41,18,3,62,145,22,229
2142819,3,0,3,33,23,0,56,162,32,250
2142820,12,0,12,43,7,3,53,178,12,243
2142821,6,0,6,57,15,3,75,111,6,192
2142822,5,3,8,29,7,3,39,90,13,142
2142823,33,6,39,22,9,0,31,138,13,182
2142824,0,3,3,32,16,3,51,104,21,176
2142825,4,0,4,66,14,0,80,113,5,198
2142826,0,0,0,59,18,4,81,116,6,203
2142901,4,0,4,33,9,0,42,87,15,144
2142902,6,0,6,67,23,0,90,190,30,310
2142903,0,0,0,30,31,0,61,194,19,274
2142904,22,10,32,43,18,3,64,189,40,293
2142905,3,0,3,51,14,6,71,112,10,193
2142906,0,0,0,59,23,6,88,130,12,230
2142907,3,0,3,48,11,5,64,82,21,167
2142908,6,4,10,64,28,0,92,162,18,272
2142909,4,0,4,56,21,0,77,154,18,249
2142910,7,5,12,48,23,9,80,133,8,221
2142911,0,3,3,58,10,0,68,137,15,220
2142912,0,0,0,9,6,0,15,17,3,35
2142913,6,0,6,49,22,0,71,140,13,224
2142914,6,0,6,42,17,3,62,150,12,224
2142915,3,0,3,42,12,0,54,109,4,167
2142916,0,0,0,77,20,3,100,128,13,241
2142917,0,0,0,63,28,0,91,160,20,271
2142918,0,0,0,46,6,0,52,116,19,187
2142919,0,0,0,94,30,9,133,185,17,335
2142920,3,0,3,21,18,0,39,62,3,104
2142921,3,3,6,15,11,0,26,79,23,128
2142922,6,0,6,32,8,0,40,97,13,150
2142923,9,0,9,49,18,0,67,145,6,218
2142924,0,3,3,80,22,6,108,215,20,343
2143001,0,3,3,57,17,3,77,146,12,235
2143002,3,0,3,39,16,3,58,132,0,190
2143003,6,0,6,54,27,6,87,184,21,292
2143004,3,0,3,89,38,4,131,194,20,345
2143005,5,3,8,48,24,0,72,151,18,241
2143006,6,0,6,74,32,9,115,161,7,283
2143007,13,6,19,41,16,3,60,144,16,220
2143008,4,0,4,80,12,0,92,187,12,291
2143009,0,0,0,20,14,6,40,102,6,148
2143010,0,0,0,75,22,6,103,124,13,240
2143011,0,0,0,0,0,0,0,0,0,0
2143012,0,0,0,43,19,3,65,123,15,203
2143013,0,0,3,50,21,3,74,144,33,251
2143014,0,0,0,73,22,9,104,137,19,260
2143015,3,0,3,104,21,0,125,214,12,351
2143016,0,0,0,60,12,3,75,152,35,262
2143017,0,0,0,47,9,7,63,150,15,228
2143018,0,0,0,39,3,0,42,111,8,161
2143019,3,0,3,87,27,4,118,182,15,315
2143020,6,0,6,32,15,0,47,124,18,189
2143021,30,20,50,36,26,3,65,192,41,298
2143022,3,3,6,42,17,6,65,191,16,272
2143023,5,3,8,82,47,0,129,199,24,352
2143024,17,4,21,46,35,9,90,200,29,319
2143025,20,6,26,56,29,0,85,236,44,365
2143026,5,3,8,16,15,0,31,118,22,171
2143027,0,0,0,71,32,0,103,167,12,282
2143028,6,3,9,56,31,0,87,188,26,301
2143101,11,0,11,51,23,3,77,266,29,372
2143102,8,16,24,59,20,3,82,229,69,380
2143103,3,0,3,42,9,0,51,128,10,189
2143104,3,3,6,31,20,3,54,115,24,193
2143105,4,0,4,50,14,0,64,122,9,195
2143106,0,0,0,63,28,0,91,235,41,367
2143107,3,0,3,33,6,3,42,81,31,154
2143108,0,3,3,62,27,6,95,259,40,394
2143109,3,6,9,48,25,6,79,222,27,328
2143110,0,3,3,30,15,0,45,140,26,211
2143201,12,0,12,86,35,4,125,226,17,368
2143202,3,0,3,74,43,6,123,179,28,330
2143203,0,0,0,58,20,13,91,176,15,282
2143204,6,0,6,38,21,0,59,129,23,211
2143205,0,3,3,54,24,0,78,105,13,196
2143206,4,0,4,48,15,3,66,176,30,272
2143207,3,0,3,174,42,9,225,324,20,569
2143208,6,3,9,70,12,5,87,139,6,232
2143209,0,0,0,21,10,0,31,88,5,124
2143210,3,0,3,48,27,0,75,161,27,263
2143211,3,0,3,51,31,0,82,152,9,243
2143212,6,0,6,57,34,4,95,201,28,324
2143213,0,3,3,47,35,0,82,196,24,302
2143214,0,0,0,143,46,10,199,238,23,460
2143215,0,0,0,111,40,0,151,179,14,344
2143216,0,0,0,68,27,9,104,226,48,378
2143217,0,0,0,55,18,0,73,152,29,254
2143218,7,3,10,40,14,0,54,157,12,223
2143219,4,4,8,54,43,6,103,230,20,353
2143220,3,0,3,41,21,0,62,190,6,258
2143221,9,0,12,75,40,9,124,300,35,459
2143222,0,0,0,85,20,10,115,170,12,297
2143223,34,0,34,74,28,0,102,218,45,365
2143224,3,0,3,55,15,0,70,157,37,264
2143225,3,0,3,45,26,0,71,144,6,221
2143226,0,0,0,74,24,6,104,157,9,270
2143227,0,0,0,98,29,5,132,213,10,355
2143228,6,0,6,160,56,12,228,384,32,644
2143229,6,0,6,42,15,0,57,183,6,246
2143230,4,0,4,69,33,6,108,186,25,319
2143231,12,3,15,75,38,9,122,223,20,365
2143232,6,3,9,70,38,0,108,261,24,393
2143233,6,0,6,64,50,0,114,232,15,361
2143234,3,0,3,74,24,0,98,219,15,332
2143235,3,6,9,72,38,3,113,242,25,380
2143236,6,0,6,77,48,3,128,267,28,423
2143237,40,11,51,80,43,0,123,310,80,513
2143238,9,3,12,67,31,3,101,168,29,298
2143239,9,3,12,57,27,3,87,229,22,338
2143240,8,0,8,73,25,11,109,214,37,360
2143241,3,3,6,60,22,0,82,170,19,271
2143242,3,3,6,63,27,0,90,240,40,370
2143243,6,3,9,70,36,10,116,237,18,371
2143244,0,4,4,70,27,0,97,177,19,293
2143245,4,0,4,19,21,0,40,94,19,153
2143246,0,0,0,0,0,0,0,0,0,0
2143247,4,3,7,77,9,0,86,147,18,251
2143248,0,4,4,42,16,0,58,130,21,209
2143249,0,0,0,0,0,0,0,0,0,0
2143250,0,0,0,56,12,3,71,98,8,177
2143251,0,0,0,19,12,9,40,53,11,104
2143301,6,0,6,67,27,4,98,202,20,320
2143302,9,0,12,60,37,0,97,196,26,319
2143303,3,0,3,49,16,9,74,179,31,284
2143304,4,0,4,42,33,9,84,180,9,273
2143305,0,0,0,73,23,8,104,198,28,330
2143306,3,0,3,67,29,3,99,170,12,281
2143307,0,0,0,86,25,6,117,197,13,327
2143308,3,0,3,48,37,9,94,238,23,355
2143309,6,0,6,50,26,0,76,241,20,337
2143310,0,0,0,139,58,9,206,297,74,577
2143311,3,0,3,46,22,0,68,131,0,199
2143312,15,10,25,79,36,3,118,271,62,451
2143313,6,0,6,53,27,6,86,167,23,276
2143314,7,4,11,43,34,4,81,184,22,287
2143315,8,3,11,52,38,3,93,241,41,375
2143316,11,4,18,45,37,0,82,316,40,438
2143317,10,7,17,40,25,3,68,171,36,275
2143318,0,0,0,0,0,0,0,0,0,0
2143319,13,3,16,63,29,0,92,281,22,395
2143320,8,9,17,68,25,3,96,212,26,334
2143321,0,0,0,16,13,0,29,164,14,207
2143322,49,22,71,87,44,6,137,320,61,518
2143323,6,0,6,48,25,3,76,179,25,280
2143324,8,3,11,65,39,4,108,260,44,412
2143325,6,0,6,37,19,3,59,140,13,212
2143326,9,3,12,69,38,6,113,175,27,315
2143327,55,73,128,67,31,6,104,307,127,538
2143328,20,3,23,49,30,4,83,163,25,271
2143329,6,6,12,50,18,3,71,208,26,305
2143330,0,0,0,72,23,6,101,173,22,296
2143331,4,0,4,76,24,3,103,165,19,287
2143332,0,0,0,0,0,0,0,3,0,3
2143333,20,4,24,16,26,0,42,188,31,261
2143334,16,3,19,35,16,0,51,154,26,231
2949999,39,15,54,831,372,25,1228,4418,1623,7269
2979991,0,0,0,0,0,0,0,0,0,0
2979992,0,0,0,13,0,0,13,13,3,29
2979993,0,0,0,0,0,0,0,7,3,10
3100101,0,0,0,93,26,7,126,223,14,363
3100102,0,0,0,72,17,0,89,133,4,226
3100103,0,0,0,93,39,0,132,315,16,463
3100104,0,0,0,67,26,4,97,208,19,324
3100105,0,0,0,30,15,0,45,114,19,178
3100106,0,0,0,40,17,0,57,136,12,205
3100107,0,0,0,43,24,3,70,141,6,217
3100108,0,0,0,96,37,9,142,183,11,336
3100109,34,0,34,103,25,6,134,274,24,432
3100110,0,0,0,64,29,3,96,190,14,300
3100111,3,0,3,90,39,7,136,258,27,421
3100112,6,0,6,34,28,0,62,136,7,205
3100113,4,0,4,58,13,6,77,149,12,238
3100114,6,0,6,80,29,4,113,262,21,396
3100115,6,0,6,78,25,7,110,254,9,373
3100116,3,3,6,101,32,3,136,196,15,347
3100117,9,0,9,67,31,3,101,235,13,349
3100118,8,0,8,87,40,4,131,237,18,386
3100119,3,0,3,78,33,7,118,186,23,327
3100120,0,0,0,50,23,3,76,137,19,232
3100121,0,0,0,72,33,3,108,248,17,373
3100122,4,0,4,47,34,0,81,248,6,335
3100123,10,3,13,52,38,6,96,272,27,395
3100124,3,0,3,41,13,0,54,102,12,168
3100125,3,3,6,58,33,6,97,124,18,239
3100126,0,0,0,77,21,6,104,196,18,318
3100127,0,0,0,41,12,3,56,114,12,182
3100128,0,0,0,91,28,0,119,205,7,331
3100129,5,0,5,66,18,0,84,207,15,306
3100130,67,16,83,90,24,3,117,338,29,484
3100131,0,0,0,70,27,8,105,188,21,314
3100132,0,0,0,38,15,6,59,87,12,158
3100133,4,0,4,87,39,6,132,204,25,361
3100134,3,3,6,68,28,3,99,199,10,308
3100135,3,3,6,63,22,0,85,177,15,277
3100136,0,0,0,83,26,11,120,221,11,352
3100137,0,0,0,48,25,0,73,170,23,266
3100138,0,0,0,57,14,3,74,109,6,189
3100139,0,0,0,89,27,6,122,196,6,324
3100140,0,0,0,115,24,3,142,199,12,353
3100141,0,0,0,62,25,6,93,196,15,304
3100142,3,0,3,68,15,0,83,205,12,300
3100143,0,0,0,0,0,0,0,0,0,0
3100144,0,0,0,0,0,0,0,0,0,0
3100145,3,0,3,62,18,0,80,194,16,290
3100201,6,0,6,33,23,4,60,119,19,198
3100202,3,0,7,95,40,7,142,142,16,300
3100203,3,0,3,32,16,3,51,139,18,208
3100204,6,0,6,72,29,3,104,314,44,462
3100205,4,0,4,77,44,0,121,177,14,312
3100206,0,0,0,93,36,0,129,191,25,345
3100207,3,3,6,44,10,0,54,108,10,172
3100208,3,0,3,50,28,6,84,138,10,232
3100209,0,0,0,78,36,6,120,189,12,321
3100210,0,4,4,70,24,0,94,195,20,309
3100211,0,0,0,0,0,0,0,12,0,12
3100212,0,0,0,0,0,0,0,3,0,3
3100213,3,0,3,87,36,0,123,271,4,398
3100214,3,0,3,45,17,0,62,110,0,172
3100215,3,0,3,80,39,0,119,266,9,394
3100216,0,0,0,94,24,6,124,146,12,282
3100217,0,0,0,21,4,0,25,54,3,82
3100218,0,0,0,73,21,0,94,181,0,275
3100219,0,0,0,229,45,7,281,400,19,700
3100220,0,0,0,66,9,4,79,180,12,271
3100221,0,0,0,99,15,5,119,197,12,328
3100301,0,0,0,63,45,0,108,193,19,320
3100302,7,3,10,56,33,3,92,255,10,357
3100303,9,5,14,38,22,6,66,181,27,274
3100304,6,0,6,120,36,6,162,269,12,443
3100305,3,0,3,76,31,11,118,198,24,340
3100306,6,0,6,82,20,6,108,157,24,289
3100307,3,0,3,118,34,0,152,225,26,403
3100308,0,0,0,61,21,6,88,134,3,225
3100309,0,0,0,66,24,5,95,159,12,266
3100310,4,0,4,116,61,9,186,326,13,525
3100311,3,0,3,62,24,3,89,179,11,279
3100312,0,0,0,50,18,4,72,127,0,199
3100313,7,41,48,78,37,6,121,192,82,395
3100314,3,0,3,55,32,6,93,197,14,304
3100315,0,0,0,73,33,4,110,190,7,307
3100316,3,0,3,131,73,6,210,267,19,496
3100317,7,3,10,73,32,3,108,232,19,359
3100318,0,0,0,73,26,0,99,216,13,328
3100319,3,3,6,61,26,3,90,185,19,294
3100320,0,0,0,83,32,9,124,179,13,316
3100321,9,0,9,133,37,4,174,258,21,453
3100322,0,0,0,60,22,4,86,161,10,257
3100323,3,0,3,73,37,8,118,277,28,423
3100324,3,0,3,131,18,6,155,229,16,400
3100325,3,5,8,119,45,9,173,284,21,478
3100326,0,0,0,0,0,0,0,3,0,3
3100327,0,0,0,0,3,0,3,12,6,21
3100328,99,10,109,26,15,0,41,280,33,354
3100329,0,0,0,51,17,6,74,184,3,261
3100330,4,0,4,70,23,3,96,211,15,322
3100331,6,0,6,43,16,0,59,188,18,265
3100332,74,21,95,16,20,0,36,279,48,363
3100333,0,0,0,34,22,6,62,163,6,231
3100334,0,0,0,38,22,0,60,136,18,214
3100335,3,0,3,86,33,0,119,294,34,447
3100336,0,0,0,52,31,0,83,199,16,298
3100401,6,0,6,76,26,0,102,220,26,348
3100402,7,0,7,111,39,3,153,278,24,455
3100403,13,6,19,69,29,4,102,273,33,408
3100404,6,0,6,63,26,7,96,239,12,347
3100405,4,0,4,71,10,9,90,212,20,322
3100406,6,0,6,39,20,3,62,142,20,224
3100407,3,0,3,53,17,3,73,182,21,276
3100408,3,3,6,92,35,3,130,278,27,435
3100409,5,4,9,93,36,0,129,265,16,410
3100410,4,0,4,107,38,0,145,238,18,401
3100411,0,0,0,49,15,0,64,124,24,212
3100412,3,0,3,58,18,0,76,118,12,206
3100413,6,0,6,90,21,0,111,325,11,447
3100414,0,3,3,50,21,0,71,121,14,206
3100415,0,0,0,54,24,0,78,136,9,223
3100416,0,0,0,80,19,5,104,200,5,309
3100417,0,0,0,88,14,9,111,207,9,327
3100418,3,3,6,49,31,7,87,142,10,239
3100419,6,0,6,46,21,6,73,158,12,243
3100420,3,0,3,65,30,0,95,211,14,320
3100421,6,3,9,110,25,7,142,255,31,428
3100422,4,0,4,26,16,0,42,76,3,121
3100423,6,0,6,45,25,0,70,128,15,213
3100424,0,0,0,50,18,0,68,154,15,237
3100425,0,0,0,64,18,6,88,135,14,237
3100426,0,0,0,79,38,3,120,287,29,436
3100427,0,3,3,49,30,3,82,209,28,319
3100428,3,0,3,83,27,3,113,242,16,371
3100429,3,0,3,40,13,0,53,129,24,206
3100430,0,0,0,87,46,6,139,319,24,482
3100431,0,3,3,111,41,0,152,254,16,422
3100432,0,0,0,12,4,3,19,77,3,99
3100433,6,0,6,77,33,3,113,229,11,353
3100434,3,4,7,54,23,5,82,187,12,281
3100435,6,3,9,72,21,0,93,193,13,299
3100436,6,0,6,53,20,3,76,179,18,273
3100437,0,0,0,0,0,0,0,3,0,3
3100438,18,0,18,55,34,9,98,345,31,474
3100439,0,0,0,81,48,13,142,234,12,388
3100440,6,0,6,73,37,9,119,215,15,349
3100441,4,0,4,39,31,0,70,181,18,269
3100442,3,0,3,83,42,3,128,195,30,353
3100443,0,0,0,60,23,0,83,193,12,288
3100444,3,0,3,50,31,0,81,188,24,293
3100501,4,0,4,57,27,0,84,212,24,320
3100502,6,0,6,68,42,9,119,201,21,341
3100503,0,0,0,48,21,3,72,190,9,271
3100504,0,0,0,83,27,4,114,159,10,283
3100505,0,0,0,40,29,0,69,132,30,231
3100506,0,0,0,22,9,0,31,82,12,125
3100507,0,0,0,85,24,3,112,251,19,382
3100508,7,3,10,55,17,4,76,349,55,480
3100509,0,0,0,58,18,6,82,159,10,251
3100510,3,5,8,47,9,4,60,144,22,226
3100601,0,0,0,66,33,7,106,213,30,349
3100602,0,0,0,32,16,0,48,128,0,176
3100603,0,0,0,60,18,6,84,170,15,269
3100604,10,0,10,73,52,0,125,369,30,524
3100605,6,0,6,28,23,0,51,176,7,234
3100606,9,0,9,88,22,6,116,225,19,360
3100607,5,0,5,42,31,3,76,149,30,255
3100608,3,3,6,71,42,6,119,226,29,374
3100609,3,0,3,119,22,10,151,222,19,392
3100610,6,3,9,60,13,6,79,143,16,238
3100611,0,4,4,79,44,0,123,221,13,357
3100612,7,3,10,84,29,7,120,291,20,431
3100613,0,0,0,119,33,4,156,278,21,455
3100614,6,0,6,124,59,7,190,334,13,537
3100615,0,0,0,115,26,6,147,271,26,444
3100616,64,0,64,74,29,11,114,350,19,483
3100617,0,0,0,100,36,3,139,199,16,354
3100618,3,0,3,151,34,9,194,308,32,534
3100619,0,0,0,69,43,10,122,284,26,432
3100620,0,0,0,82,17,9,108,186,7,301
3100621,3,0,6,138,43,13,194,311,25,530
3100622,0,0,0,89,21,12,122,182,9,313
3100623,13,0,13,67,24,0,91,213,24,328
3100624,0,0,0,4,3,0,7,18,0,25
3100701,6,0,6,42,18,0,60,153,6,219
3100702,0,0,0,58,12,8,78,143,12,233
3100703,8,0,8,82,37,0,119,276,21,416
3100704,3,0,3,80,27,7,114,193,13,320
3100705,3,0,3,59,26,6,91,236,16,343
3100706,30,7,37,103,52,8,163,384,35,582
3100707,6,0,6,50,29,7,86,214,21,321
3100708,10,0,10,51,37,0,88,233,18,339
3100709,9,0,9,65,23,6,94,238,21,353
3100710,0,0,0,86,22,0,108,272,19,399
3100711,9,0,9,47,35,3,85,223,21,329
3100712,62,6,68,45,26,3,74,243,16,333
3100713,49,3,52,80,38,14,132,389,16,537
3100714,19,7,26,26,6,3,35,130,30,195
3100715,19,3,22,75,46,3,124,369,30,523
3100716,15,3,18,68,31,0,99,270,33,402
3100717,8,0,8,42,29,0,71,127,9,207
3100718,13,0,13,61,30,3,94,251,13,358
3100719,9,0,9,68,38,3,109,218,35,362
3100720,7,0,7,61,30,0,91,200,18,309
3100721,6,0,6,49,21,0,70,186,18,274
3100722,0,0,0,44,31,3,78,255,22,355
3100723,0,0,0,39,20,0,59,191,3,253
3100724,0,0,0,39,22,0,61,202,9,272
3100725,14,3,17,68,57,6,131,399,36,566
3100726,38,6,44,40,41,3,84,406,54,544
3100727,18,0,18,31,15,0,46,209,37,292
3100728,0,0,0,0,0,0,0,0,0,0
3100729,0,0,0,0,0,0,0,0,0,0
3100730,24,3,27,65,27,0,92,386,32,510
3100731,14,0,14,81,43,0,124,338,30,492
3100732,7,0,7,43,35,0,78,147,15,240
3100733,3,0,3,36,18,4,58,175,0,233
3100734,7,0,7,24,26,0,50,171,5,226
3100735,0,0,0,56,27,3,86,315,12,413
3100736,0,0,0,31,26,0,57,225,9,291
3100737,6,0,6,40,22,5,67,199,13,279
3100801,5,0,5,96,47,3,146,262,11,419
3100802,3,0,3,65,26,9,100,222,9,331
3100803,3,0,3,34,29,9,72,192,12,276
3100804,3,0,3,75,11,0,86,227,10,323
3100805,0,0,0,127,24,4,155,328,16,499
3100806,3,3,6,79,36,3,118,261,18,397
3100807,89,27,116,0,12,0,12,194,38,244
3100808,27,10,42,99,42,10,151,330,32,513
3100809,3,0,3,95,32,6,133,339,31,503
3100810,3,3,6,96,41,0,137,337,24,498
3100811,10,3,13,60,26,3,89,207,21,317
3100812,5,0,5,58,39,0,97,218,12,327
3100901,4,0,4,57,34,6,97,228,22,347
3100902,9,3,12,55,35,4,94,276,18,388
3100903,4,6,10,70,24,9,103,267,37,407
3100904,6,5,11,73,40,6,119,257,46,422
3100905,0,0,0,62,27,5,94,178,15,287
3100906,10,0,10,70,43,9,122,289,64,475
3100907,22,0,22,144,28,11,183,277,11,471
3100908,4,0,4,90,39,10,139,235,17,391
3100909,0,3,3,54,10,7,71,139,13,223
3100910,3,0,3,43,18,0,61,131,10,202
3100911,6,3,9,55,24,7,86,156,27,269
3100912,3,0,3,83,18,8,109,128,11,248
3100913,0,0,0,86,34,6,126,183,18,327
3100914,3,0,3,129,33,7,169,197,10,376
3100915,0,0,0,101,28,6,135,184,17,336
3100916,5,0,5,103,37,12,152,191,26,369
3100917,3,0,3,64,10,6,80,113,9,202
3100918,0,0,0,208,41,6,255,254,30,539
3100919,0,0,0,183,39,12,234,261,21,516
3100920,3,0,3,127,23,5,155,154,15,324
3100921,0,0,0,0,0,0,0,0,0,0
3100922,11,3,14,124,33,4,161,232,34,427
3100923,4,0,4,93,35,3,131,270,29,430
3100924,0,3,3,133,48,9,190,242,24,456
3100925,0,0,0,98,22,6,126,217,9,352
3100926,0,3,3,172,32,9,213,266,29,508
3100927,11,3,14,27,15,0,42,112,22,176
3100928,0,0,0,127,31,5,163,221,15,399
3100929,0,3,3,82,22,0,104,144,21,269
3100930,0,0,0,59,21,3,83,128,7,218
3101001,0,0,0,0,0,0,0,0,0,0
3101002,0,10,10,41,16,0,57,148,37,242
3101003,0,3,3,41,13,3,57,175,39,271
3101004,3,0,3,29,16,8,53,131,14,198
3101005,9,0,9,47,26,12,85,261,33,379
3101006,6,0,6,35,20,0,55,142,19,216
3101007,0,0,0,42,11,0,53,129,50,232
3101008,0,0,0,51,22,0,73,287,51,411
3101009,3,0,3,32,15,0,47,268,29,344
3101010,0,3,3,38,12,9,59,155,28,242
3101011,0,0,0,42,25,3,70,283,35,388
3101012,0,0,0,47,23,0,70,271,30,371
3101013,0,0,0,16,9,0,25,145,114,284
3101014,4,0,4,49,22,6,77,155,15,247
3101015,0,0,0,18,13,0,31,59,11,101
3101016,3,3,6,46,20,0,66,246,31,343
3101017,4,0,4,53,29,0,82,267,30,379
3101018,10,0,10,38,33,6,77,199,23,299
3101019,0,0,0,51,27,0,78,267,50,395
3101020,0,4,4,48,13,3,64,237,80,381
3101021,4,0,4,43,19,0,62,196,49,307
3101022,0,0,0,6,18,0,24,114,15,153
3101023,6,0,6,72,46,0,118,334,38,490
3101024,0,0,0,45,20,0,65,106,12,183
3101025,4,3,7,61,30,0,91,260,47,398
3101101,0,0,0,111,16,3,130,178,16,324
3101102,0,0,0,44,20,0,64,152,24,240
3101103,5,0,5,29,24,3,56,131,18,205
3101104,4,0,4,141,12,4,157,193,10,360
3101105,0,0,0,56,26,0,82,116,3,201
3101106,0,0,0,35,22,0,57,111,5,173
3101107,5,0,5,76,53,0,129,238,6,373
3101108,0,0,0,56,18,9,83,182,15,280
3101109,0,0,0,34,21,9,64,108,3,175
3101110,0,0,0,164,38,3,205,192,3,400
3101111,3,3,6,207,34,6,247,330,21,598
3101112,0,3,3,32,22,3,57,91,12,160
3101113,0,0,0,126,27,4,157,155,13,325
3101114,0,0,0,150,33,3,186,192,3,381
3101115,0,0,0,90,8,0,98,193,22,313
3101116,0,0,0,94,21,9,124,207,18,349
3101201,6,0,6,122,57,8,187,329,15,531
3101202,3,0,3,47,24,3,74,207,15,296
3101203,0,0,0,97,49,3,149,268,17,434
3101204,3,0,3,89,26,4,119,230,18,367
3101205,0,0,3,188,47,8,243,394,25,662
3101206,0,0,0,73,21,0,94,161,14,269
3101207,3,0,3,150,46,10,206,354,26,586
3101208,3,0,3,113,12,6,131,233,11,375
3101209,0,0,0,107,36,6,149,255,18,422
3101210,0,0,0,100,33,9,142,253,27,422
3101211,6,0,6,106,19,6,131,244,9,384
3101212,0,0,0,79,24,6,109,211,12,332
3101213,5,0,5,78,50,0,128,293,18,439
3101214,3,0,3,60,18,3,81,178,6,265
3101215,4,0,4,63,22,9,94,140,12,246
3101216,0,0,0,56,15,0,71,133,5,209
3101217,0,0,0,63,22,6,91,163,13,267
3101218,4,0,4,54,14,3,71,105,3,179
3101219,3,0,3,83,34,4,121,205,17,343
3101220,0,3,3,42,28,3,73,119,17,209
3101221,3,0,3,73,29,0,102,247,14,363
3101222,0,0,0,58,15,0,73,130,12,215
3101223,0,0,0,90,17,3,110,142,10,262
3101224,34,20,54,6,13,0,19,149,48,216
3101225,31,0,31,33,5,3,41,140,16,197
3101226,49,40,89,88,33,7,128,314,80,522
3101227,6,0,6,77,11,3,91,143,6,240
3101228,0,0,0,72,26,0,98,184,34,316
3101229,0,0,0,81,29,0,110,261,26,397
3101301,4,0,4,44,14,0,58,176,8,242
3101302,3,0,3,63,20,0,83,160,18,261
3101303,5,0,5,42,18,0,60,235,3,298
3101304,3,0,3,121,36,12,169,267,10,446
3101305,109,7,116,26,20,3,49,408,27,484
3101306,3,0,7,54,31,0,85,223,12,320
3101307,4,3,7,107,26,9,142,299,34,475
3101308,0,6,6,61,12,7,80,171,21,272
3101309,10,3,13,35,22,3,60,121,13,194
3101310,6,3,9,56,38,0,94,208,21,323
3101311,16,3,19,79,40,3,122,290,32,444
3101312,4,3,7,66,38,3,107,253,9,369
3101313,6,0,6,77,33,0,110,184,16,310
3101314,36,9,45,41,28,4,73,261,38,372
3101315,9,0,9,82,37,0,119,307,30,456
3101316,59,9,71,29,19,0,48,259,36,343
3101317,7,0,7,48,28,0,76,202,10,288
3101318,3,0,3,140,39,3,182,217,24,423
3101319,7,0,7,99,40,3,142,222,10,374
3101320,0,0,0,96,41,12,149,241,15,405
3101321,4,0,4,33,19,3,55,151,6,212
3101322,0,0,0,146,27,6,179,219,27,425
3101323,0,0,0,0,0,0,0,0,0,0
3101324,4,0,4,104,38,0,142,221,11,374
3101325,0,0,0,36,20,0,56,128,9,193
3101326,0,0,0,46,23,3,72,160,9,241
3101327,5,0,5,92,25,4,121,254,14,389
3101328,8,0,8,77,27,7,111,250,19,380
3101329,3,3,6,55,14,0,69,139,9,217
3101330,9,6,15,99,35,3,137,236,15,388
3101331,4,3,7,62,22,3,87,173,15,275
3101332,11,3,14,56,22,9,87,263,35,385
3101333,4,0,4,34,35,3,72,107,13,192
3101334,10,0,10,90,35,6,131,326,29,486
3101335,0,0,0,31,30,0,61,190,16,267
3101336,129,6,135,14,8,3,25,312,26,363
3101401,0,0,0,0,0,0,0,6,0,6
3101402,0,0,0,0,0,0,0,0,0,0
3101501,0,0,0,49,18,0,67,117,6,190
3101502,9,4,13,92,31,9,132,261,29,422
3101503,8,0,11,76,34,3,113,185,15,313
3101504,6,0,6,77,28,0,105,210,23,338
3101505,10,0,10,53,26,0,79,175,30,284
3101506,5,0,5,25,13,4,42,150,20,212
3101507,32,10,42,0,0,0,0,156,21,177
3101508,41,7,48,84,30,8,122,251,10,383
3101509,6,0,6,83,25,3,111,174,0,285
3101510,10,0,10,73,23,9,105,203,13,321
3101511,0,0,0,4,12,0,16,101,7,124
3101512,4,0,4,75,33,9,117,269,29,415
3101513,7,3,10,48,24,0,72,195,24,291
3101514,6,3,9,93,27,0,120,144,18,282
3101515,3,0,3,83,28,3,114,192,12,318
3101516,3,0,3,67,18,6,91,188,9,288
3101517,9,3,12,135,37,3,175,278,14,467
3101518,3,0,3,40,34,0,74,184,27,285
3101519,5,3,8,93,32,6,131,205,15,351
3101601,17,0,17,192,17,14,223,289,9,521
3101602,0,0,0,164,40,9,213,231,3,447
3101603,6,4,10,133,49,9,191,350,20,561
3101604,4,0,4,48,18,3,69,201,15,285
3101605,3,0,3,44,26,0,70,158,21,249
3101606,0,0,0,53,29,3,85,189,3,277
3101607,3,0,3,95,55,6,156,201,21,378
3101608,4,0,4,44,27,6,77,133,7,217
3101609,3,0,3,88,21,3,112,238,18,368
3101610,0,0,0,77,21,12,110,194,12,316
3101611,3,0,3,82,28,3,113,180,18,311
3101612,6,6,12,84,19,9,112,198,21,331
3101613,10,3,13,136,47,4,187,265,24,476
3101614,5,3,8,39,21,0,60,143,15,218
3101615,3,0,3,54,19,6,79,176,23,278
3101616,3,0,3,72,34,3,109,177,15,301
3101617,7,0,7,96,46,3,145,279,17,441
3101618,3,0,3,72,22,4,98,137,27,262
3101619,9,0,9,104,19,6,129,255,34,418
3101620,3,0,3,68,22,4,94,137,33,264
3101621,64,11,75,32,11,0,43,211,32,286
3101622,12,0,12,61,28,3,92,230,15,337
3101623,5,0,5,105,35,12,152,225,13,390
3101624,8,0,8,97,54,9,160,332,22,514
3101701,0,0,0,0,3,0,3,19,0,22
3101702,0,0,0,114,42,3,159,190,12,361
3101703,0,0,0,110,32,3,145,273,6,424
3101704,0,0,0,82,20,3,105,189,18,312
3101705,0,0,0,28,12,0,40,123,9,172
3101706,0,0,0,48,12,0,60,154,22,236
3101707,11,0,11,71,31,0,102,258,17,377
3101708,3,0,3,54,13,3,70,151,34,255
3101709,6,0,6,50,15,9,74,162,18,254
3101710,3,0,3,94,48,6,148,265,45,458
3101711,7,0,7,69,6,3,78,204,25,307
3101801,12,0,12,54,14,0,68,268,21,357
3101802,6,0,6,79,33,4,116,305,54,475
3101803,3,3,6,66,27,15,108,208,26,342
3101804,3,3,6,62,22,3,87,201,33,321
3101805,0,0,0,61,19,3,83,219,17,319
3101806,6,4,10,82,46,0,128,236,10,374
3101807,0,0,0,60,32,6,98,221,9,328
3101808,0,0,0,95,42,0,137,181,12,330
3101809,4,0,4,73,28,3,104,209,9,322
3101810,6,0,6,50,14,4,68,208,11,287
3101811,3,0,3,122,36,0,158,284,15,457
3101812,0,0,0,122,9,8,139,120,3,262
3101813,3,0,3,50,8,0,58,100,3,161
3101814,0,0,0,68,9,3,80,123,4,207
3101815,4,0,4,49,28,0,77,291,49,417
3101816,0,0,0,63,13,0,76,154,22,252
3101817,0,0,0,49,16,4,69,116,23,208
3101818,0,0,0,91,25,4,120,225,15,360
3101819,0,0,0,153,23,6,182,305,23,510
3101820,0,0,0,83,18,3,104,162,9,275
3101821,0,0,0,0,0,0,0,0,0,0
3101822,0,0,0,43,20,0,63,124,15,202
3101823,0,0,0,0,0,0,0,0,0,0
3101824,0,0,0,0,0,3,3,0,0,3
3101901,0,0,0,340,39,21,400,414,35,849
3101902,0,0,0,354,74,12,440,510,41,991
3101903,0,0,0,225,66,17,308,329,24,661
3101904,3,0,3,160,48,9,217,311,26,554
3101905,0,0,0,90,10,4,104,117,3,224
3101906,3,0,3,81,24,3,108,182,5,295
3101907,0,0,0,221,44,12,277,285,21,583
3101908,0,0,0,67,12,6,85,108,9,202
3101909,0,0,0,103,23,6,132,156,3,291
3101910,0,0,0,90,20,12,122,98,6,226
3101911,3,0,3,227,57,9,293,306,33,632
3101912,0,0,0,0,0,0,0,0,0,0
3102001,9,3,12,62,30,9,101,213,27,341
3102002,13,0,13,98,37,9,144,305,32,481
3102003,5,0,5,94,24,6,124,169,15,308
3102004,9,3,12,81,37,5,123,308,28,459
3102005,13,0,13,81,40,3,124,308,69,501
3102006,18,6,24,58,39,3,100,399,68,567
3102007,0,0,0,62,18,6,86,127,6,219
3102008,6,0,6,66,24,6,96,261,21,378
3102009,9,3,12,59,36,6,101,194,18,313
3102010,6,3,9,57,21,10,88,305,57,450
3102011,16,0,16,51,26,0,77,189,40,306
3102012,13,0,13,53,12,9,74,157,15,246
3102013,3,0,3,42,22,0,64,144,13,221
3102014,6,3,9,70,21,6,97,276,24,397
3102015,6,0,6,79,35,6,120,193,14,327
3102016,10,3,13,55,22,6,83,178,18,279
3102017,5,0,5,122,31,0,153,284,28,465
3102018,3,6,9,46,15,0,61,153,43,257
3102019,9,3,12,98,26,6,130,228,26,384
3102020,0,0,0,73,32,11,116,251,21,388
3102021,0,0,0,78,15,0,93,177,22,292
3102022,9,0,9,67,25,6,98,228,18,344
3102023,4,0,4,48,15,6,69,151,20,240
3102024,9,0,9,82,37,3,122,207,15,344
3102025,70,3,73,55,18,0,73,233,9,315
3102026,0,0,0,51,22,3,76,140,3,219
3102027,0,3,3,106,25,7,138,195,28,361
3102028,7,0,7,85,33,3,121,259,26,406
3102029,0,0,0,0,0,0,0,0,0,0
3102030,6,3,9,78,27,0,105,202,17,324
3102101,7,0,7,59,28,9,96,216,18,330
3102102,6,0,6,64,41,7,112,231,18,361
3102103,13,0,13,84,40,13,137,252,18,407
3102104,6,0,6,96,35,4,135,207,14,356
3102105,4,0,4,48,41,3,92,174,6,272
3102106,0,0,0,103,24,3,130,226,42,398
3102107,8,0,8,80,35,3,118,237,13,368
3102108,6,0,6,58,29,6,93,217,14,324
3102109,0,0,0,68,12,3,83,206,26,315
3102110,3,0,3,50,11,0,61,148,30,239
3102111,118,7,125,48,8,0,56,335,32,423
3102112,0,0,0,0,0,0,0,7,4,11
3102113,7,0,7,59,15,6,80,169,49,298
3102114,0,4,4,102,30,6,138,210,19,367
3102115,7,0,7,91,33,6,130,189,24,343
3102116,6,0,6,98,39,8,145,210,24,379
3102117,3,0,3,37,35,3,75,118,6,199
3102118,9,0,9,74,13,3,90,170,18,278
3102119,3,0,3,80,25,3,108,170,12,290
3102120,17,6,23,60,17,0,77,174,50,301
3102121,7,6,13,77,18,7,102,208,25,335
3102122,57,8,65,7,11,0,18,273,28,319
3102123,8,0,8,121,41,13,175,340,35,550
3102124,3,0,3,118,31,9,158,197,43,398
3102125,0,0,0,78,21,7,106,147,18,271
3102126,0,0,0,75,22,0,97,181,10,288
3102127,6,3,9,58,27,3,88,139,12,239
3102128,0,0,0,62,24,7,93,145,20,258
3102129,0,0,0,85,47,3,135,285,9,429
3102130,39,6,45,118,43,3,164,269,27,460
3102131,6,3,9,55,18,0,73,144,12,229
3102132,6,3,9,74,33,4,111,170,18,299
3102133,5,0,8,51,55,0,106,208,23,337
3102134,3,0,3,41,32,6,79,116,6,201
3102135,6,0,6,31,15,0,46,126,19,191
3102136,0,3,3,34,3,3,40,90,6,136
3102137,3,0,3,32,17,0,49,144,30,223
3102201,0,0,0,0,0,0,0,6,0,6
3102202,0,0,0,0,0,0,0,0,0,0
3102203,3,0,3,192,36,10,238,470,34,742
3102204,20,4,24,83,43,3,129,201,27,357
3102205,3,3,6,54,30,3,87,197,21,305
3102206,6,0,6,48,10,10,68,156,16,240
3102207,3,3,6,51,18,6,75,163,27,265
3102208,3,0,3,59,21,0,80,133,27,240
3102209,0,0,0,55,10,6,71,126,14,211
3102210,0,0,0,77,21,4,102,160,27,289
3102211,0,0,0,63,55,0,118,208,32,358
3102212,3,0,3,55,19,0,74,143,13,230
3102213,3,0,3,41,34,0,75,186,3,264
3102214,0,3,3,58,29,0,87,157,18,262
3102215,3,0,3,87,51,0,138,295,15,448
3102216,0,0,4,159,27,3,189,289,29,507
3102217,0,0,0,46,18,3,67,169,3,239
3102218,6,0,6,134,39,7,180,324,22,526
3102219,0,0,0,0,3,0,3,9,0,12
3102301,6,0,6,81,39,3,123,254,29,406
3102302,7,0,7,63,22,4,89,182,21,292
3102303,0,0,0,60,23,0,83,162,6,251
3102304,3,0,3,103,28,12,143,295,3,441
3102305,0,0,0,69,15,3,87,176,9,272
3102306,0,0,0,73,9,3,85,118,0,203
3102307,3,0,3,56,21,3,80,230,6,316
3102308,6,0,6,99,25,3,127,235,9,371
3102309,3,3,6,61,30,3,94,232,32,358
3102310,0,0,0,69,22,6,97,154,3,254
3102311,0,0,0,97,23,0,120,203,9,332
3102312,0,0,0,93,22,0,115,210,3,328
3102313,0,0,0,89,35,3,127,210,18,355
3102314,0,0,0,61,29,0,90,101,6,197
3102315,0,0,0,155,39,3,197,222,12,431
3102316,3,0,3,65,29,0,94,160,10,264
3102317,84,12,96,9,10,0,19,185,24,228
3102318,6,0,6,46,36,0,82,226,12,320
3102319,6,0,6,71,37,0,108,245,30,383
3102401,10,3,13,84,47,0,131,325,18,474
3102402,65,3,71,121,21,3,145,305,28,478
3102403,7,0,7,49,24,3,76,215,22,313
3102404,28,6,34,65,14,0,79,280,41,400
3102405,0,0,0,216,70,5,291,608,39,938
3102406,3,0,3,43,24,0,67,215,9,291
3102407,0,0,0,47,25,0,72,214,15,301
3102408,8,7,15,98,47,6,151,367,39,557
3102409,15,0,15,69,27,0,96,271,7,374
3102410,113,41,154,0,9,0,9,273,61,343
3102411,4,3,7,68,48,9,125,296,30,451
3102412,15,3,18,50,33,0,83,280,22,385
3102413,3,0,3,42,34,0,76,198,10,284
3102414,6,0,6,58,46,0,104,284,7,395
3102415,10,0,10,37,37,0,74,232,4,310
3102416,0,0,0,0,0,0,0,0,0,0
3102417,6,3,9,54,40,0,94,203,19,316
3102501,11,0,11,62,38,6,106,239,12,357
3102502,3,3,6,92,57,7,156,314,18,488
3102503,12,0,15,109,45,9,163,393,34,590
3102504,6,0,6,48,22,7,77,148,6,231
3102505,3,0,3,66,29,3,98,262,9,369
3102506,7,0,7,44,15,0,59,174,12,245
3102507,16,0,16,50,24,3,77,286,30,393
3102508,5,0,5,62,20,6,88,289,30,407
3102509,7,5,12,53,24,0,77,299,89,465
3102510,11,0,11,89,32,3,124,344,24,492
3102511,7,3,10,49,27,3,79,230,19,328
3102512,13,7,20,71,31,4,106,272,34,412
3102513,0,0,0,53,31,7,91,177,9,277
3102514,6,0,6,91,43,0,134,177,6,317
3102515,5,0,5,67,14,4,85,202,30,317
3102516,10,0,10,33,18,6,57,171,14,242
3102517,7,0,7,43,27,3,73,169,7,249
3102518,3,0,3,61,31,6,98,221,15,334
3102519,5,3,8,104,38,3,145,294,24,463
3102601,0,0,0,32,17,0,49,113,4,166
3102602,3,0,3,116,31,0,147,212,4,363
3102603,0,0,0,69,26,0,95,105,0,200
3102604,0,0,0,82,24,0,106,161,6,273
3102605,5,3,8,65,39,7,111,218,9,338
3102606,0,0,0,56,24,12,92,147,6,245
3102607,0,0,0,143,57,15,215,326,12,553
3102608,6,0,6,73,38,0,111,213,12,336
3102609,6,0,6,69,25,0,94,162,6,262
3102610,0,0,0,61,16,0,77,223,4,304
3102611,0,0,0,71,33,0,104,187,9,300
3102612,0,0,0,78,35,3,116,210,3,329
3102613,10,0,10,78,44,3,125,239,10,374
3102614,8,0,8,92,20,9,121,180,18,319
3102615,0,0,3,65,22,0,87,180,6,273
3102616,3,0,3,79,36,3,118,267,3,388
3102617,0,0,0,49,28,0,77,145,6,228
3102618,0,0,0,91,37,3,131,137,4,272
3102701,0,0,0,79,38,6,123,265,12,400
3102702,13,0,13,43,43,0,86,269,23,378
3102703,52,12,64,69,25,3,97,385,41,523
3102704,5,0,5,36,25,3,64,148,12,224
3102705,7,3,10,77,55,0,132,279,12,423
3102706,11,0,11,52,33,0,85,239,40,364
3102707,4,6,10,61,40,4,105,243,24,372
3102708,3,0,3,49,13,3,65,194,21,280
3102709,3,0,3,80,28,13,121,250,13,384
3102710,0,3,3,40,19,6,65,205,15,285
3102711,12,3,15,59,27,6,92,222,15,329
3102712,0,3,3,43,9,3,55,136,10,201
3102713,7,0,7,52,27,0,79,185,8,272
3102714,7,0,7,90,40,3,133,205,14,352
3102715,4,0,4,47,34,0,81,165,9,255
3102716,0,0,0,52,25,9,86,171,12,269
3102717,3,0,3,79,26,0,105,257,21,383
3102718,8,0,8,86,41,0,127,307,34,468
3102719,114,15,129,21,9,0,30,444,111,585
3102720,0,0,0,0,0,0,0,0,0,0
3102721,0,0,0,63,15,3,81,134,29,244
3102722,8,0,8,53,22,3,78,164,18,260
3102723,4,0,4,60,19,5,84,165,0,249
3102724,4,0,4,81,41,6,128,212,21,361
3102725,0,0,0,53,24,0,77,137,6,220
3102726,10,6,16,80,26,10,116,173,9,298
3102727,5,0,5,50,11,3,64,119,28,211
3102728,6,0,6,57,33,0,90,138,9,237
3102729,6,0,6,71,30,5,106,194,26,326
3102730,8,3,11,65,33,0,98,182,24,304
3102731,8,0,8,69,42,10,121,241,18,380
3102732,0,0,0,39,12,0,51,132,6,189
3102733,9,3,12,36,20,6,62,177,21,260
3102801,11,3,17,99,30,7,136,415,63,614
3102802,64,217,281,3,18,0,21,236,331,588
3102803,9,0,9,77,40,3,120,295,37,452
3102804,9,0,9,28,28,3,59,104,6,169
3102805,9,3,12,47,54,0,101,447,92,640
3102806,6,0,6,54,14,3,71,181,20,272
3102807,0,5,5,32,7,0,39,237,21,297
3102808,8,0,8,19,11,5,35,245,20,300
3102809,10,6,16,59,14,0,73,283,57,413
3102810,11,0,11,42,16,3,61,216,30,307
3102811,8,0,8,46,17,0,63,269,31,363
3102812,0,0,0,3,0,0,3,6,6,15
3102813,10,0,10,72,17,0,89,319,39,447
3102814,17,5,25,53,18,3,74,303,73,450
3102815,8,0,8,60,19,3,82,165,44,291
3102816,6,0,6,34,21,0,55,321,55,431
3102817,17,0,17,76,18,0,94,327,29,450
3102818,6,3,12,77,25,3,105,239,18,362
3102819,3,3,6,24,10,0,34,207,45,286
3102901,6,0,6,37,23,3,63,121,6,190
3102902,3,3,6,80,39,0,119,256,27,402
3102903,3,0,3,59,31,6,96,150,24,270
3102904,4,0,4,61,38,0,99,214,18,331
3102905,11,0,11,65,21,9,95,237,35,367
3102906,0,3,3,30,13,0,43,130,9,182
3102907,3,3,6,102,26,10,138,184,14,336
3102908,10,0,10,81,24,5,110,230,10,350
3102909,8,0,8,64,45,3,112,282,21,415
3102910,8,0,8,61,36,6,103,167,17,287
3102911,15,0,15,72,19,3,94,194,20,308
3102912,3,0,3,87,41,9,137,283,11,431
3102913,8,0,8,69,12,0,81,164,13,258
3102914,0,0,0,0,0,0,0,20,0,20
3102915,11,0,11,41,41,4,86,203,12,301
3102916,0,0,0,0,0,0,0,0,0,0
3102917,6,0,6,100,34,12,146,292,16,454
3103001,5,0,5,103,32,7,142,238,27,407
3103002,10,6,16,98,35,3,136,258,28,422
3103003,5,0,5,32,18,0,50,116,3,169
3103004,8,0,8,75,26,4,105,220,33,358
3103005,12,0,12,74,20,9,103,220,8,331
3103006,52,6,58,78,10,0,88,235,18,341
3103007,0,0,0,0,3,0,3,7,0,10
3103008,10,4,14,78,29,0,107,204,15,326
3103009,10,0,10,95,49,0,144,303,17,464
3103010,7,0,7,44,18,0,62,248,18,328
3103011,10,5,15,45,16,0,61,224,13,298
3103101,7,0,7,93,18,9,120,296,18,434
3103102,4,0,4,78,21,4,103,316,40,459
3103103,3,0,3,53,12,3,68,233,11,312
3103104,0,0,0,0,0,0,0,0,0,0
3103105,27,7,34,81,27,3,111,226,17,354
3103106,4,3,7,45,7,0,52,189,23,264
3103107,5,0,5,57,18,0,75,186,23,284
3103108,6,3,9,80,28,3,111,343,39,493
3103109,6,3,9,55,12,3,70,168,24,262
3103110,5,0,8,82,21,6,109,411,32,552
3103111,6,0,6,136,20,7,163,269,24,456
3103112,8,0,8,139,21,7,167,202,23,392
3103113,0,5,5,38,10,0,48,108,20,176
3103114,3,3,10,57,10,4,71,243,24,338
3103115,7,6,13,103,28,6,137,256,28,421
3103116,9,0,9,108,18,3,129,275,18,422
3103117,0,3,3,63,12,12,87,152,18,257
3103118,10,3,13,62,26,7,95,196,24,315
3103119,11,0,11,50,14,6,70,174,4,248
3103120,38,12,50,54,14,3,71,229,44,344
3103121,6,0,6,42,7,6,55,197,26,278
3103122,3,0,3,56,25,6,87,281,26,394
3103123,3,0,3,48,9,7,64,228,18,310
3103124,3,0,3,40,11,0,51,172,27,250
3103125,11,0,11,40,6,3,49,206,23,278
3103126,4,5,9,40,15,0,55,270,21,346
3103127,4,3,10,74,18,15,107,276,41,424
3103128,3,0,3,71,11,0,82,163,10,255
3103129,9,0,9,80,10,0,90,144,9,243
3103130,3,0,3,64,7,6,77,169,3,249
3103131,4,0,4,83,19,3,105,174,12,291
3103132,8,3,11,35,13,3,51,142,15,208
3103201,6,0,6,54,24,9,87,259,33,379
3103202,11,0,11,45,19,0,64,192,13,269
3103203,6,3,9,48,38,3,89,324,34,447
3103204,6,0,6,70,25,3,98,166,25,289
3103205,8,4,12,59,30,3,92,214,18,324
3103206,15,6,21,24,5,3,32,151,17,200
3103207,0,0,0,0,0,0,0,0,0,0
3103208,3,0,3,38,12,9,59,135,22,216
3103209,0,5,5,60,19,4,83,150,11,244
3103210,8,3,11,70,21,3,94,203,24,321
3103211,0,4,4,63,17,0,80,126,8,214
3103212,12,0,12,86,23,3,112,277,22,411
3103213,3,0,3,46,6,7,59,164,6,229
3103214,9,6,15,76,37,6,119,258,21,398
3103215,6,0,6,59,9,0,68,231,19,318
3103216,3,0,3,55,15,0,70,146,15,231
3103217,6,0,6,28,16,3,47,157,16,220
3103218,9,3,12,57,8,4,69,182,19,270
3103301,10,6,16,61,39,3,103,246,11,360
3103302,4,0,4,69,36,9,114,210,25,349
3103303,3,0,3,68,29,6,103,216,14,333
3103304,0,4,4,75,30,8,113,273,61,447
3103305,7,0,7,64,15,3,82,167,9,258
3103306,13,0,13,58,16,3,77,191,22,290
3103307,3,0,3,57,30,4,91,193,3,287
3103308,6,3,9,69,33,0,102,192,12,306
3103309,0,0,0,95,32,6,133,246,35,414
3103310,3,3,6,80,41,3,124,304,46,474
3103311,48,3,51,66,30,0,96,231,23,350
3103312,3,0,3,90,27,3,120,278,45,443
3103313,0,0,0,67,24,0,91,140,21,252
3103314,15,3,18,47,23,0,70,201,12,283
3103315,7,0,7,70,47,0,117,284,7,408
3103316,9,0,9,40,26,0,66,171,15,252
3103401,13,3,16,50,18,3,71,140,16,227
3103402,4,5,9,59,25,3,87,226,9,322
3103403,7,3,10,100,27,4,131,263,15,409
3103404,0,0,0,58,15,0,73,182,21,276
3103405,11,0,11,79,22,0,101,230,19,350
3103406,3,3,6,99,31,6,136,344,37,517
3103407,3,0,3,57,18,0,75,134,9,218
3103408,11,0,11,61,16,3,80,150,0,230
3103409,20,0,20,70,22,5,97,206,12,315
3103410,12,0,12,79,28,0,107,212,15,334
3103411,9,0,9,118,36,16,170,275,17,462
3103412,3,4,7,54,16,4,74,139,7,220
3103413,18,0,18,133,21,6,160,238,33,431
3103414,6,0,6,57,21,3,81,172,9,262
3103415,14,0,14,105,37,7,149,287,6,442
3103416,15,3,18,103,19,3,125,171,25,321
3103417,9,0,9,68,23,4,95,129,12,236
3103418,12,0,12,67,8,8,83,162,19,264
3103419,6,0,6,67,33,9,109,157,3,269
3103420,13,0,13,54,9,0,63,164,12,239
3103421,15,3,18,61,17,7,85,180,19,284
3103422,7,4,11,89,49,9,147,178,8,333
3103423,10,9,19,124,30,6,160,296,30,486
3103501,0,0,0,50,20,3,73,181,24,278
3103502,4,0,4,70,19,7,96,219,31,346
3103503,7,3,10,66,16,10,92,239,32,363
3103504,10,0,10,66,25,6,97,221,18,336
3103505,3,0,3,74,27,0,101,297,22,420
3103506,6,6,12,115,35,4,154,334,35,523
3103507,0,0,0,87,15,4,106,171,30,307
3103508,3,0,3,65,26,0,91,209,22,322
3103509,6,0,6,81,24,12,117,215,20,352
3103510,0,0,0,22,16,6,44,91,18,153
3103511,0,0,0,89,21,5,115,213,18,346
3103512,0,4,4,14,0,0,14,219,4,237
3103513,0,4,4,52,35,9,96,287,24,407
3103514,7,0,7,41,17,3,61,198,35,294
3103515,9,3,12,57,3,5,65,188,11,264
3103516,3,0,3,39,19,0,58,183,21,262
3103517,9,3,12,48,45,0,93,228,24,345
3103518,14,3,17,77,35,0,112,293,26,431
3103519,9,0,9,75,34,6,115,363,52,530
3103520,8,0,8,63,39,0,102,308,64,474
3103521,0,0,0,0,0,0,0,0,0,0
3103522,0,0,0,39,11,3,53,113,11,177
3103601,0,0,0,6,3,0,9,32,28,69
3103701,3,3,6,31,3,0,34,166,23,223
3103702,0,0,0,0,0,0,0,3,0,3
3103801,0,0,0,50,15,3,68,124,6,198
3103802,14,3,17,80,19,0,99,318,28,445
3103803,6,0,6,89,31,0,120,306,32,458
3103804,6,3,9,77,27,6,110,230,15,355
3103805,8,0,8,102,25,5,132,221,19,372
3103806,0,4,4,55,15,4,74,276,26,376
3103807,0,0,0,46,15,0,61,268,22,351
3103808,9,0,9,70,25,6,101,401,59,561
3103809,5,0,5,70,10,3,83,160,18,261
3103810,4,7,11,56,21,9,86,146,19,251
3103811,11,0,11,52,12,0,64,130,11,205
3103812,3,6,12,63,18,3,84,252,24,360
3103813,5,0,5,0,0,0,0,25,0,25
3103814,16,4,20,83,42,4,129,248,48,425
3103815,3,0,3,32,16,0,48,135,37,220
3103816,6,0,6,104,21,9,134,222,28,384
3103901,0,0,0,0,0,0,0,0,0,0
3103902,0,0,0,0,0,0,0,0,0,0
3103903,4,0,4,28,14,3,45,150,10,205
3103904,5,0,5,57,31,0,88,163,15,266
3103905,3,0,3,59,28,3,90,202,20,312
3103906,0,0,0,71,27,4,102,204,36,342
3103907,18,0,18,106,51,12,169,407,28,604
3103908,0,0,0,86,26,0,112,190,13,315
3103909,0,0,0,0,0,0,0,25,3,28
3103910,0,0,0,0,0,0,0,0,0,0
3103911,6,0,6,36,11,0,47,173,8,228
3103912,5,0,5,36,6,0,42,135,12,189
3103913,6,0,6,30,8,7,45,155,18,218
3103914,93,5,98,140,46,6,192,492,37,721
3103915,7,0,7,63,17,0,80,206,9,295
3103916,11,4,15,78,26,3,107,327,19,453
3103917,4,4,8,75,45,0,120,245,46,411
3103918,7,3,10,79,34,0,113,262,18,393
3103919,15,0,15,79,17,0,96,264,24,384
3103920,6,3,9,72,24,0,96,309,33,438
3103921,15,0,15,85,28,3,116,339,27,482
3103922,4,0,4,119,34,12,165,270,36,471
3103923,0,0,0,119,18,4,141,178,31,350
3104001,5,3,8,45,19,0,64,288,12,364
3104002,0,0,0,49,29,3,81,111,15,207
3104003,6,0,6,58,22,0,80,417,27,524
3104004,3,4,7,71,21,0,92,403,46,541
3104005,9,3,12,94,28,0,122,416,50,588
3104006,0,3,3,64,17,0,81,476,31,588
3104007,6,5,11,62,17,3,82,230,28,340
3104008,6,0,6,67,27,0,94,308,26,428
3104009,8,0,8,57,22,0,79,310,12,401
3104010,7,3,10,96,16,3,115,208,17,340
3104011,7,0,7,53,26,3,82,310,21,413
3104012,4,0,4,68,17,6,91,149,6,246
3104013,3,0,3,55,17,3,75,216,18,309
3104014,3,4,7,48,13,3,64,323,37,424
3104015,7,7,17,74,30,3,107,483,65,655
3104016,0,0,0,0,0,0,0,0,0,0
3104017,7,0,7,62,22,3,87,297,25,409
3104018,4,0,4,38,22,0,60,121,6,187
3104019,7,3,10,61,19,0,80,307,40,427
3104020,19,0,19,69,28,7,104,314,5,423
3104021,3,0,3,34,18,0,52,241,24,317
3104022,0,0,0,31,9,3,43,248,21,312
3104023,67,8,75,66,33,0,99,549,41,689
3104101,0,5,5,48,28,6,82,208,16,306
3104102,3,0,3,88,66,5,159,285,30,474
3104103,6,0,6,60,32,6,98,232,13,343
3104104,7,0,7,43,32,0,75,185,11,271
3104105,3,0,3,51,33,0,84,190,0,274
3104106,6,0,6,32,26,3,61,173,18,252
3104107,0,0,0,48,17,6,71,149,18,238
3104108,4,0,4,107,31,4,142,239,21,402
3104109,0,0,0,54,34,3,91,225,34,350
3104110,0,0,0,48,26,3,77,148,53,278
3104111,0,0,0,123,32,6,161,230,3,394
3104112,0,0,0,93,27,6,126,231,47,404
3104113,0,0,0,56,21,11,88,175,30,293
3104114,0,0,0,73,12,3,88,122,15,225
3104115,0,0,0,92,5,0,97,175,21,293
3104116,0,0,0,223,58,0,281,509,58,848
3104117,0,0,0,115,44,0,159,286,22,467
3104118,3,3,6,96,27,6,129,173,16,318
3104119,0,0,0,91,28,3,122,195,14,331
3104120,0,0,0,35,21,7,63,131,15,209
3104121,4,0,4,151,52,10,213,320,32,565
3104122,0,0,0,64,25,0,89,137,0,226
3104123,6,0,6,67,32,0,99,261,12,372
3104124,0,0,0,36,12,6,54,106,15,175
3104125,6,0,6,72,25,0,97,239,23,359
3104126,6,3,9,169,68,8,245,430,28,703
3104127,8,8,16,60,41,0,101,244,38,383
3104128,0,0,0,101,34,0,135,236,30,401
3104129,3,0,3,48,37,3,88,193,18,299
3104130,3,0,3,94,46,3,143,267,23,433
3104131,0,0,0,102,38,9,149,281,21,451
3104132,4,0,4,40,12,6,58,149,21,228
3104133,6,0,9,94,52,5,151,286,21,458
3104134,3,0,3,52,26,9,87,168,19,274
3104135,4,0,4,148,53,12,213,459,35,707
3104136,0,0,0,63,38,3,104,215,21,340
3104201,6,3,9,85,24,6,115,175,12,302
3104202,3,0,3,69,27,6,102,181,18,301
3104203,8,61,69,75,28,9,112,336,187,635
3104204,6,0,6,58,19,3,80,171,15,266
3104205,8,3,14,42,24,4,70,222,34,326
3104206,0,0,0,39,15,3,57,146,18,221
3104207,5,0,5,53,17,3,73,202,19,294
3104208,7,5,12,74,26,0,100,213,22,335
3104209,0,0,0,54,37,4,95,159,22,276
3104210,4,0,4,73,27,0,100,172,9,281
3104211,11,0,11,101,34,6,141,280,11,432
3104212,9,0,9,76,29,0,105,219,18,342
3104213,6,0,6,96,21,6,123,208,22,353
3104214,4,0,4,94,17,3,114,236,12,362
3104215,5,3,8,80,21,0,101,212,21,334
3104216,6,6,12,92,12,3,107,226,28,361
3104217,6,5,11,109,38,6,153,261,29,443
3104218,0,0,0,61,11,0,72,149,13,234
3104219,4,0,4,69,29,0,98,181,29,308
3104220,9,0,9,98,33,0,131,271,22,424
3104221,7,6,13,44,18,9,71,188,12,271
3104222,0,0,0,0,0,0,0,0,0,0
3104223,0,0,0,33,27,0,60,126,14,200
3104301,6,0,6,25,7,4,36,129,6,171
3104302,51,9,60,69,33,3,105,347,47,499
3104303,7,0,7,116,24,9,149,242,35,426
3104304,7,4,11,55,29,3,87,219,24,330
3104305,8,0,8,71,25,6,102,192,6,300
3104306,11,3,14,126,36,3,165,323,36,524
3104307,6,0,6,35,15,6,56,116,6,178
3104308,0,3,3,54,32,3,89,253,21,363
3104309,0,0,0,0,0,0,0,28,3,31
3104401,0,0,0,37,16,0,53,173,19,245
3104402,6,0,6,45,16,3,64,159,8,231
3104403,9,0,9,51,15,3,69,198,16,283
3104404,7,3,10,59,35,0,94,192,15,301
3104405,6,0,6,55,5,8,68,117,17,202
3104406,8,0,8,35,16,0,51,204,34,289
3104407,4,3,7,106,42,13,161,323,19,503
3104408,6,0,6,70,22,6,98,225,31,354
3104409,7,3,10,55,31,6,92,192,21,305
3104410,3,3,6,89,18,10,117,249,17,383
3104411,6,3,9,86,32,11,129,183,11,323
3104412,0,0,0,90,21,4,115,227,9,351
3104413,0,0,0,25,6,3,34,39,6,79
3104414,7,220,227,0,3,0,3,31,401,435
3104415,7,0,7,70,20,0,90,166,10,266
3104416,7,0,7,48,15,3,66,107,14,187
3104417,3,3,6,55,5,4,64,127,20,211
3104418,0,0,0,0,0,0,0,0,0,0
3104419,9,3,12,96,28,10,134,245,38,417
3104501,6,4,10,45,31,3,79,192,26,297
3104502,19,7,26,64,26,3,93,414,56,563
3104503,3,0,3,133,35,0,168,271,26,465
3104504,3,0,3,99,43,3,145,261,9,415
3104505,3,0,3,88,27,0,115,293,38,446
3104506,0,0,0,90,26,3,119,268,10,397
3104507,0,0,0,127,25,0,152,294,10,456
3104508,9,0,9,67,38,7,112,323,33,468
3104509,0,0,0,108,27,3,138,192,21,351
3104510,0,0,0,51,18,0,69,213,20,302
3104511,10,0,10,83,61,3,147,354,18,519
3104512,0,0,0,42,18,0,60,185,17,262
3104513,37,9,46,36,22,0,58,373,39,470
3104514,0,0,0,72,13,3,88,216,16,320
3104515,3,0,3,99,22,6,127,269,24,420
3104516,3,0,3,60,22,6,88,253,15,356
3104517,3,3,6,77,27,6,110,291,26,427
3104518,141,4,145,48,15,4,67,369,17,453
3104601,0,4,4,39,15,0,54,188,35,277
3104602,0,0,0,62,19,0,81,126,18,225
3104603,7,0,7,54,10,0,64,203,27,294
3104604,4,0,4,33,13,0,46,139,33,218
3104605,0,3,3,73,37,6,116,238,46,400
3104606,6,3,9,53,13,0,66,214,49,329
3104607,7,3,10,46,27,0,73,179,54,306
3104608,12,6,18,56,27,0,83,223,90,396
3104609,7,0,7,47,16,3,66,308,57,431
3104610,6,3,9,40,8,5,53,229,69,351
3104611,34,0,34,44,14,0,58,307,51,416
3104612,6,0,6,35,18,3,56,165,15,236
3104613,6,0,6,52,28,0,80,200,24,304
3104614,0,3,3,46,17,6,69,162,44,275
3104615,0,0,0,27,12,0,39,188,38,265
3104616,12,0,12,71,35,0,106,269,9,384
3104617,3,0,3,44,16,0,60,169,21,250
3104618,4,0,4,86,27,3,116,218,20,354
3104619,3,3,6,93,33,0,126,221,21,368
3104620,7,0,7,62,47,3,112,177,9,298
3104621,0,0,0,0,3,0,3,3,0,6
3104622,6,5,11,56,27,10,93,187,15,295
3104701,9,0,9,108,35,0,143,240,18,401
3104702,9,0,9,90,15,9,114,250,8,372
3104703,5,0,5,80,18,4,102,169,14,285
3104704,4,0,4,66,18,6,90,184,15,289
3104705,7,0,7,76,17,4,97,272,25,394
3104706,0,0,0,0,0,0,0,0,0,0
3104707,8,0,8,73,15,0,88,141,14,243
3104708,3,3,6,80,24,0,104,129,27,260
3104709,9,0,9,123,45,3,171,309,15,495
3104710,10,0,10,77,18,4,99,173,22,294
3104711,7,7,14,94,24,0,118,178,30,326
3104712,18,0,18,94,29,6,129,217,28,374
3104713,7,3,10,92,11,9,112,294,20,426
3104714,6,0,6,114,30,12,156,202,20,378
3104715,6,0,6,74,24,4,102,214,20,336
3104716,0,0,0,66,8,3,77,114,6,197
3104717,6,0,6,96,17,0,113,200,6,319
3104718,3,0,3,49,8,0,57,101,11,169
3104719,19,4,23,97,42,6,145,308,16,469
3104720,11,0,11,86,26,0,112,321,14,447
3104721,6,0,6,59,23,0,82,269,12,363
3104722,9,3,12,98,24,9,131,198,9,338
3104723,12,0,12,112,17,6,135,233,16,384
3104724,9,0,9,135,34,3,172,213,18,403
3104725,4,0,4,63,7,0,70,118,11,199
3104801,0,0,0,0,0,0,0,0,0,0
3104802,0,0,0,44,23,0,67,128,9,204
3104803,6,0,6,82,18,0,100,242,21,363
3104804,6,0,6,59,8,8,75,214,3,292
3104805,8,0,8,61,18,0,79,160,3,242
3104806,6,6,12,37,23,0,60,153,21,234
3104807,11,3,14,77,28,7,112,277,21,410
3104808,10,0,10,50,15,3,68,205,18,291
3104809,8,0,8,104,28,4,136,243,24,403
3104810,7,0,7,81,20,3,104,201,26,331
3104811,18,0,18,77,19,6,102,251,13,366
3104812,5,0,5,58,34,5,97,216,22,335
3104813,6,0,6,6,12,0,18,128,10,156
3104814,0,0,0,4,3,0,7,16,9,32
3104901,4,0,4,63,39,0,102,298,8,408
3104902,0,0,0,0,0,0,0,3,3,6
3104903,3,0,3,76,35,4,115,231,16,362
3104904,0,0,0,76,16,12,104,201,12,317
3104905,3,0,3,59,15,0,74,193,7,274
3104906,0,0,0,84,23,6,113,200,15,328
3104907,5,0,5,72,35,3,110,228,25,363
3104908,6,0,6,63,20,3,86,147,19,252
3104909,3,0,3,78,25,0,103,125,24,252
3104910,7,0,7,129,40,9,178,282,33,493
3104911,0,6,6,68,10,4,82,126,17,225
3104912,12,5,17,54,18,0,72,166,21,259
3104913,3,0,3,72,24,0,96,274,27,397
3104914,88,7,95,61,29,0,90,367,43,500
3104915,7,0,7,64,17,0,81,144,12,237
3104916,11,5,16,55,16,4,75,200,18,293
3104917,6,4,10,47,34,0,81,258,24,363
3104918,14,5,19,92,38,5,135,287,19,441
3104919,8,3,11,48,27,0,75,307,31,413
3104920,8,0,8,66,35,6,107,313,15,435
3104921,4,0,4,49,37,0,86,170,6,262
3104922,5,0,5,83,43,3,129,298,101,528
3104923,17,3,20,81,30,6,117,330,34,481
3104924,13,0,13,120,25,3,148,397,46,591
3105001,5,0,5,64,19,0,83,297,18,398
3105002,6,0,6,58,25,0,83,262,17,362
3105003,6,0,6,65,24,6,95,317,19,431
3105004,6,3,9,62,24,6,92,244,12,348
3105005,3,3,6,47,23,6,76,174,24,274
3105006,0,4,4,44,28,3,75,191,11,277
3105007,0,0,0,58,42,3,103,209,18,330
3105008,9,3,12,74,26,0,100,239,27,366
3105009,6,3,9,53,24,6,83,200,18,301
3105010,0,0,0,66,28,0,94,312,18,424
3105011,6,0,6,45,14,0,59,197,15,271
3105012,0,0,0,68,26,0,94,240,16,350
3105013,0,0,0,31,13,0,44,68,0,112
3105014,3,3,6,90,30,0,120,253,19,392
3105015,57,22,79,50,24,6,80,314,57,451
3105016,0,0,0,0,0,0,0,0,0,0
3105101,0,0,0,51,24,0,75,183,4,262
3105102,4,0,4,81,34,3,118,276,32,426
3105103,7,3,10,73,47,0,120,295,13,428
3105104,10,0,10,52,40,9,101,227,12,340
3105105,4,0,4,57,17,9,83,203,6,292
3105106,27,0,27,85,32,6,123,352,9,484
3105107,0,0,0,75,12,0,87,161,8,256
3105108,3,0,3,57,12,0,69,150,13,232
3105109,0,0,0,49,7,0,56,92,4,152
3105110,0,0,0,137,22,3,162,251,20,433
3105111,0,0,0,34,20,3,57,154,9,220
3105112,0,0,0,71,12,0,83,119,19,221
3105113,0,0,0,97,28,6,131,315,16,462
3105114,0,0,0,43,12,6,61,169,0,230
3105115,0,0,0,49,9,3,61,97,3,161
3105116,8,0,8,41,24,3,68,134,7,209
3105117,3,0,3,65,22,0,87,179,15,281
3105118,18,7,25,61,27,3,91,277,41,409
3105119,8,0,8,61,50,0,111,287,21,419
3105120,9,0,9,67,21,4,92,198,15,305
3105121,16,0,16,96,26,3,125,366,17,508
3105122,0,0,0,49,19,6,74,184,3,261
3105123,0,0,0,26,34,0,60,105,6,171
3105124,8,0,8,66,25,0,91,175,15,281
3105125,6,0,6,73,43,3,119,360,13,492
3105126,5,0,5,42,40,0,82,297,6,385
3105127,8,0,8,78,38,6,122,265,10,397
3105128,3,0,3,85,22,5,112,299,9,420
3105129,0,0,0,0,0,0,0,3,0,3
3105130,0,3,3,39,24,3,66,137,6,209
3105131,3,3,6,46,28,0,74,184,12,270
3105132,45,7,52,55,30,0,85,360,34,479
3105133,0,0,0,0,0,0,0,0,0,0
3105134,0,0,0,57,16,0,73,159,4,236
3105135,3,0,3,87,12,3,102,204,6,312
3105136,0,0,0,44,14,8,66,138,3,207
3105137,3,0,3,104,31,9,144,226,13,383
3105138,0,0,0,87,29,0,116,228,24,368
3105139,0,0,0,84,36,4,124,227,18,369
3105140,0,0,0,58,25,0,83,188,11,282
3105141,0,0,0,100,26,0,126,243,24,393
3105201,6,0,6,59,4,0,63,267,64,394
3105202,3,3,6,79,19,3,101,301,34,436
3105203,3,0,3,35,15,3,53,206,24,283
3105204,6,3,9,79,20,3,102,300,32,434
3105205,3,0,3,47,28,3,78,370,55,503
3105206,3,3,6,38,20,0,58,313,28,399
3105207,8,0,8,28,12,0,40,225,15,280
3105208,3,4,10,38,9,3,50,241,31,322
3105209,0,0,0,46,26,0,72,276,27,375
3105210,3,0,3,52,21,0,73,179,10,262
3105211,6,0,6,78,13,9,100,185,7,292
3105212,6,0,6,47,11,3,61,233,30,324
3105213,7,3,10,57,14,7,78,270,41,389
3105214,4,0,4,46,9,0,55,161,23,239
3105215,0,0,0,28,10,0,38,160,9,207
3105216,3,3,6,37,0,4,41,215,33,289
3105217,38,0,38,47,20,0,67,278,23,368
3105218,8,0,8,53,12,3,68,186,31,285
3105219,3,3,6,88,26,3,117,458,52,627
3105220,0,6,6,87,33,3,123,480,63,666
3105221,3,0,3,94,37,9,140,411,39,590
3105222,3,0,3,80,23,3,106,172,12,290
3105223,4,0,4,65,22,6,93,164,15,272
3105224,6,0,6,67,18,3,88,237,26,351
3105225,6,0,6,47,18,0,65,239,15,319
3105301,9,0,9,34,26,0,60,300,12,372
3105302,13,3,16,36,31,0,67,381,36,484
3105303,9,0,9,85,20,6,111,240,33,384
3105304,0,0,0,0,0,0,0,0,0,0
3105305,4,0,4,60,17,9,86,162,3,251
3105306,9,0,9,70,17,0,87,446,36,569
3105307,8,0,8,36,12,0,48,290,34,372
3105308,0,3,3,58,29,0,87,420,49,556
3105309,3,3,6,53,18,3,74,183,31,288
3105310,10,4,14,22,37,3,62,277,38,377
3105311,3,3,6,38,20,9,67,191,18,276
3105312,5,0,5,62,24,0,86,306,32,424
3105313,0,0,0,37,16,3,56,195,20,271
3105314,3,0,3,50,23,0,73,218,13,304
3105315,0,0,0,41,17,0,58,218,35,311
3105316,19,4,23,57,24,3,84,402,40,526
3105317,0,0,0,35,9,0,44,163,25,232
3105318,7,0,7,28,21,0,49,206,41,296
3105319,4,0,4,60,18,0,78,203,25,306
3105320,0,3,3,97,26,9,132,169,21,322
3105321,7,0,7,52,24,0,76,234,16,326
3105322,9,0,9,55,15,3,73,159,16,248
3105323,6,0,6,26,18,0,44,279,24,347
3105324,3,0,3,36,21,3,60,277,17,354
3105325,0,0,0,63,19,0,82,169,7,258
3105326,7,0,7,84,26,4,114,404,25,543
3105327,6,4,10,53,8,5,66,160,15,241
3105328,13,0,13,80,21,0,101,203,3,307
3105329,8,3,11,96,22,6,124,218,21,363
3105330,15,0,15,62,26,4,92,210,22,324
3105331,3,0,3,84,23,6,113,210,7,330
3105332,7,6,13,72,24,3,99,204,19,322
3105333,6,0,6,92,19,6,117,178,6,301
3105334,6,0,6,72,27,4,103,212,9,324
3105335,0,0,0,54,28,3,85,153,6,244
3105336,16,3,19,158,43,14,215,247,6,468
3105337,3,0,3,48,21,0,69,256,18,343
3105401,3,3,6,25,15,4,44,81,6,131
3105402,3,0,3,48,6,4,58,194,28,280
3105403,3,0,3,56,27,6,89,318,21,428
3105404,10,5,15,98,23,7,128,310,22,460
3105405,6,3,9,48,15,6,69,160,18,247
3105406,7,3,10,54,13,0,67,331,21,419
3105407,8,4,12,51,18,3,72,253,19,344
3105408,6,3,9,50,24,6,80,278,23,381
3105409,6,3,9,34,6,9,49,215,25,289
3105410,8,3,11,61,33,8,102,337,30,469
3105501,0,0,0,48,18,3,69,233,22,324
3105502,6,3,9,68,18,6,92,188,33,313
3105503,6,0,6,25,9,0,34,168,27,229
3105504,3,0,3,41,16,0,57,282,20,359
3105505,10,0,10,81,36,0,117,338,24,479
3105506,6,3,9,48,18,0,66,280,35,381
3105507,7,3,10,43,23,0,66,203,17,286
3105508,0,3,3,71,33,6,110,287,33,430
3105509,3,3,6,49,7,0,56,161,15,232
3105510,33,3,36,29,13,0,42,240,9,291
3105511,3,4,7,44,24,0,68,187,35,290
3105512,3,0,3,45,23,3,71,238,31,340
3105513,4,0,4,29,4,0,33,139,26,198
3105514,18,0,18,8,16,0,24,155,18,197
3105515,9,0,9,58,15,9,82,162,3,247
3105516,0,0,0,43,8,3,54,159,12,225
3105517,7,9,16,69,21,0,90,282,52,424
3105518,6,3,9,48,28,3,79,378,59,516
3105519,3,3,6,31,22,3,56,283,37,376
3105520,0,0,0,33,9,3,45,126,17,188
3105521,0,0,0,31,9,5,45,202,27,274
3105522,6,3,9,59,27,6,92,385,32,509
3105523,0,0,0,78,41,3,122,210,13,345
3105601,6,0,6,74,15,3,92,271,26,389
3105602,3,3,6,39,8,0,47,124,15,186
3105603,6,3,9,87,20,3,110,213,26,349
3105604,6,3,9,43,15,0,58,107,18,183
3105605,6,3,9,60,6,3,69,103,18,190
3105606,3,0,3,37,13,0,50,113,6,169
3105607,3,0,3,100,18,6,124,164,9,297
3105608,6,0,6,89,18,7,114,245,24,383
3105609,4,0,7,64,27,0,91,127,12,230
3105610,0,3,3,78,21,0,99,169,18,286
3105611,3,3,6,38,12,6,56,148,9,213
3105612,6,6,12,72,20,3,95,210,26,331
3105613,10,0,10,104,19,6,129,223,9,361
3105614,11,3,14,122,21,0,143,253,14,410
3105615,4,0,4,86,22,3,111,179,12,302
3105616,3,0,3,71,20,8,99,193,19,311
3105617,3,5,8,52,21,3,76,220,33,329
3105618,0,51,51,67,23,3,93,160,93,346
3105619,0,0,0,52,18,3,73,185,5,263
3105620,5,0,5,63,23,0,86,163,5,254
3105621,0,0,0,65,26,12,103,211,24,338
3105701,0,3,3,72,33,0,105,164,9,278
3105702,3,0,3,41,14,8,63,136,13,212
3105703,4,0,4,43,13,0,56,146,8,210
3105704,5,0,5,60,30,3,93,266,28,387
3105705,10,3,13,73,30,9,112,394,38,544
3105706,10,0,10,80,23,4,107,264,30,401
3105707,0,0,0,51,15,3,69,136,18,223
3105708,5,0,5,33,9,0,42,143,10,195
3105709,7,3,10,85,26,0,111,228,21,360
3105710,8,0,8,70,26,4,100,157,19,276
3105711,6,0,6,38,25,3,66,144,13,223
3105712,11,0,11,58,27,0,85,255,20,360
3105713,3,0,3,55,31,0,86,191,21,298
3105714,3,0,3,91,27,3,121,312,40,473
3105715,5,3,8,31,22,3,56,117,9,182
3105716,3,3,6,52,15,7,74,194,32,300
3105801,6,0,6,17,3,0,20,119,21,160
3105802,0,0,0,0,0,0,0,42,18,60
3105803,0,0,0,0,0,3,3,12,0,15
3105804,0,3,3,22,6,0,28,234,50,312
3105805,5,0,5,42,21,3,66,228,18,312
3105806,6,0,6,76,23,6,105,262,56,423
3105807,6,0,6,53,20,3,76,280,59,415
3105808,6,3,9,53,10,9,72,258,46,376
3105809,3,0,3,57,25,3,85,238,27,350
3105810,4,0,4,56,18,10,84,304,52,440
3105811,6,0,6,26,8,3,37,163,9,209
3105812,6,4,10,49,10,3,62,279,29,370
3105813,16,0,16,47,30,3,80,640,92,812
3105901,6,0,6,55,21,9,85,124,19,228
3105902,3,0,3,41,16,0,57,169,25,251
3105903,0,0,0,0,0,0,0,0,0,0
3105904,0,0,0,36,3,5,44,202,20,266
3105905,0,0,0,57,22,4,83,337,41,461
3105906,4,0,4,94,14,7,115,165,9,289
3105907,3,0,3,46,13,6,65,100,18,183
3105908,0,0,0,37,14,6,57,249,37,343
3105909,0,0,0,43,13,3,59,217,23,299
3105910,0,0,0,0,0,0,0,0,0,0
3105911,3,0,3,56,31,4,91,200,8,299
3105912,3,0,3,28,17,0,45,139,7,191
3105913,8,0,8,39,19,0,58,315,13,386
3105914,3,0,3,39,20,3,62,301,26,389
3105915,4,0,4,32,13,0,45,173,23,241
3105916,3,0,3,47,25,0,72,237,28,337
3105917,0,0,0,66,17,7,90,162,13,265
3105918,0,0,0,96,11,5,112,207,19,338
3105919,12,0,12,83,18,3,104,237,9,350
3105920,4,0,4,60,18,0,78,134,6,218
3105921,6,0,6,43,15,6,64,127,9,200
3105922,26,0,26,73,35,3,111,319,12,442
3105923,5,0,5,51,22,6,79,173,8,260
3105924,7,0,7,141,49,3,193,453,70,716
3106001,0,0,0,71,14,3,88,183,6,277
3106002,0,0,0,108,12,3,123,289,18,430
3106003,3,0,3,69,20,0,89,204,9,302
3106004,0,0,0,85,40,3,128,297,23,448
3106005,3,0,3,53,16,3,72,214,4,290
3106006,6,0,6,130,32,0,162,382,16,560
3106007,0,0,3,141,36,3,180,393,25,598
3106008,3,0,3,45,12,0,57,212,12,281
3106009,9,0,9,77,41,0,118,269,24,411
3106010,3,0,3,52,34,0,86,219,6,311
3106011,6,0,6,87,32,7,126,262,7,395
3106012,3,0,3,104,28,6,138,388,22,548
3106013,0,0,0,63,26,0,89,237,0,326
3106014,6,0,6,70,58,3,131,307,0,438
3106015,0,0,0,39,43,0,82,156,15,253
3106016,0,0,0,49,15,0,64,159,16,239
3106017,0,0,0,81,27,0,108,272,12,392
3106018,0,0,0,132,38,4,174,291,32,497
3106019,8,0,8,127,31,3,161,396,101,658
3106020,0,0,0,57,12,0,69,217,17,303
3106021,20,63,83,66,11,0,77,299,123,499
3106022,3,0,3,36,15,6,57,165,22,244
3106023,5,0,5,82,36,0,118,277,8,403
3106024,0,0,0,59,20,6,85,204,5,294
3106025,7,0,7,47,14,3,64,128,4,196
3106026,0,0,0,63,33,6,102,373,15,490
3106027,0,0,0,27,4,0,31,160,8,199
3106028,0,0,0,101,33,3,137,251,14,402
3106029,0,0,0,46,16,0,62,215,39,316
3106030,0,0,0,29,11,0,40,222,47,309
3106031,6,0,6,60,39,6,105,287,37,429
3106032,0,0,0,0,0,0,0,0,0,0
3106101,8,3,11,77,56,0,133,394,43,570
3106102,0,3,3,73,15,3,91,264,48,403
3106103,0,0,0,30,20,0,50,178,15,243
3106104,12,6,18,75,29,3,107,316,39,462
3106105,11,3,14,55,39,0,94,375,18,487
3106106,5,0,5,63,35,3,101,194,7,302
3106107,6,0,6,52,18,0,70,300,32,402
3106108,9,0,9,56,17,4,77,252,12,341
3106109,14,0,14,44,23,5,72,371,23,466
3106110,0,0,0,27,4,0,31,149,12,192
3106111,6,0,6,62,34,3,99,346,20,465
3106112,9,0,9,76,46,6,128,366,22,516
3106201,0,0,0,0,3,0,3,19,0,22
3106202,0,0,0,59,14,9,82,167,12,261
3106203,0,0,0,104,25,3,132,222,6,360
3106204,3,0,3,64,34,0,98,176,18,292
3106205,7,3,10,71,22,3,96,193,16,305
3106206,0,0,0,77,38,5,120,227,14,361
3106207,9,0,9,103,47,0,150,350,47,547
3106208,6,0,6,71,41,9,121,237,8,366
3106209,0,0,0,45,24,3,72,128,13,213
3106210,8,0,8,60,30,0,90,244,10,344
3106211,5,0,5,72,33,6,111,224,18,353
3106212,4,0,4,64,32,6,102,165,9,276
3106213,0,0,0,61,29,3,93,213,6,312
3106214,4,0,4,44,29,3,76,146,0,222
3106215,6,0,6,50,32,3,85,222,18,325
3106216,3,0,3,59,17,8,84,180,8,272
3106217,0,0,0,68,56,0,124,257,3,384
3106218,3,0,3,94,34,6,134,234,12,380
3106219,7,6,13,101,43,6,150,372,24,546
3106220,11,0,11,100,50,6,156,356,25,537
3106221,0,0,0,0,0,0,0,0,0,0
3106222,3,3,6,27,25,0,52,110,3,165
3106301,0,0,0,99,5,0,104,126,0,230
3106302,3,0,3,93,27,0,120,351,14,485
3106303,3,0,3,52,30,0,82,170,3,255
3106304,0,0,0,52,22,8,82,174,12,268
3106305,3,0,6,92,30,3,125,307,29,461
3106306,5,3,8,109,33,0,142,256,20,418
3106307,0,0,0,100,30,3,133,246,8,387
3106308,0,0,0,95,27,3,125,349,27,501
3106309,0,0,0,0,0,0,0,0,0,0
3106310,69,3,72,87,15,0,102,370,17,489
3106311,7,0,7,67,15,0,82,212,21,315
3106312,4,0,4,60,15,0,75,198,12,285
3106313,5,0,5,57,24,5,86,207,28,321
3106314,11,0,11,99,29,3,131,302,14,447
3106315,9,0,9,70,34,0,104,238,7,349
3106316,6,6,12,73,18,0,91,238,29,358
3106317,4,0,4,80,15,6,101,167,12,280
3106318,24,4,28,46,23,0,69,319,35,423
3106319,9,3,12,68,21,3,92,233,18,343
3106320,9,9,18,39,11,3,53,219,68,340
3106321,6,3,9,109,36,4,149,277,18,444
3106322,8,3,11,118,33,9,160,217,22,399
3106323,11,3,14,67,25,4,96,338,32,466
3106324,0,0,0,43,16,4,63,195,3,261
3106325,3,0,3,45,21,0,66,293,16,375
3106326,7,0,7,86,19,0,105,216,10,331
3106327,4,6,10,104,33,8,145,373,31,549
3106328,3,4,7,64,23,5,92,141,8,241
3106329,4,3,7,81,25,4,110,304,15,429
3106330,14,3,17,125,26,6,157,380,21,558
3106331,6,0,6,42,27,3,72,125,9,206
3106332,6,3,9,37,18,0,55,235,25,315
3106401,3,0,3,71,45,4,120,264,14,398
3106402,0,0,0,72,23,6,101,201,33,335
3106403,6,0,6,43,23,0,66,107,15,188
3106404,4,0,4,56,25,9,90,172,0,262
3106405,3,0,3,145,45,12,202,282,11,495
3106406,0,0,0,85,14,0,99,146,12,257
3106407,0,0,3,112,30,6,148,191,19,358
3106408,3,3,6,19,18,0,37,161,23,221
3106409,0,0,0,29,24,0,53,117,28,198
3106410,7,3,10,25,18,3,46,139,22,207
3106411,3,0,3,33,18,7,58,185,39,282
3106501,6,0,6,40,9,6,55,130,47,232
3106502,4,0,4,63,53,3,119,247,19,385
3106503,3,6,9,57,36,0,93,268,57,418
3106504,7,81,88,67,30,0,97,239,158,494
3106505,9,0,9,63,30,6,99,195,15,309
3106506,3,3,6,41,23,3,67,189,17,273
3106507,6,0,6,52,39,6,97,180,62,339
3106508,14,0,14,77,36,0,113,301,35,449
3106509,3,4,7,33,15,0,48,263,84,395
3106510,63,8,71,40,15,0,55,387,73,515
3106511,0,0,0,0,3,0,3,0,3,6
3106512,96,15,111,29,29,3,61,274,58,393
3106513,6,3,9,72,31,4,107,208,70,385
3106514,9,0,9,58,6,0,64,322,17,403
3106515,5,0,5,44,19,0,63,316,91,470
3106516,10,6,16,52,38,3,93,326,35,454
3106517,6,3,9,61,37,4,102,429,51,582
3106518,0,3,3,52,12,0,64,232,38,334
3106519,6,0,6,58,11,8,77,204,28,309
3106520,8,0,8,79,32,0,111,263,17,391
3106601,6,0,6,120,30,7,157,282,15,454
3106602,3,0,3,56,30,3,89,202,12,303
3106603,4,0,4,52,25,0,77,149,12,238
3106604,3,0,3,65,28,4,97,172,6,275
3106605,6,0,6,69,30,0,99,234,6,339
3106606,3,4,7,27,17,3,47,169,7,223
3106607,6,0,6,83,41,3,127,296,3,426
3106608,10,0,10,70,59,3,132,309,24,465
3106609,0,0,0,37,7,0,44,238,12,294
3106610,3,0,3,66,28,3,97,228,10,335
3106611,6,0,6,107,51,3,161,271,9,441
3106612,4,0,4,98,43,6,147,224,0,371
3106613,65,42,107,57,21,0,78,281,63,422
3106614,4,0,4,85,25,7,117,241,11,369
3106615,4,0,4,94,36,3,133,212,12,357
3106616,11,0,11,100,37,6,143,290,13,446
3106617,3,3,6,102,54,0,156,364,13,533
3106618,0,3,3,78,25,6,109,219,15,343
3106619,0,0,0,69,15,4,88,164,10,262
3106620,0,0,0,44,30,0,74,120,0,194
3106621,6,3,9,58,31,0,89,220,14,323
3106622,0,0,0,46,16,3,65,136,13,214
3106623,0,0,3,38,16,0,54,111,0,165
3106624,0,0,0,79,16,3,98,167,13,278
3106625,6,0,6,59,18,3,80,271,12,363
3106701,3,3,6,40,9,3,52,203,42,297
3106702,3,0,3,43,9,0,52,179,23,254
3106703,6,3,9,85,18,3,106,264,19,389
3106704,6,3,9,58,31,3,92,270,31,393
3106705,3,0,3,50,13,0,63,187,16,266
3106706,0,4,4,68,15,0,83,182,28,293
3106707,0,0,0,38,23,3,64,180,17,261
3106708,7,0,7,56,26,7,89,182,24,295
3106709,7,0,7,68,22,0,90,220,26,336
3106710,6,0,6,51,32,0,83,252,18,353
3106711,0,0,0,0,3,0,3,5,0,8
3106712,7,3,10,34,12,0,46,127,28,201
3106713,4,3,7,37,9,3,49,207,30,286
3106714,3,0,3,25,11,0,36,133,34,203
3106801,8,7,15,82,21,0,103,266,46,415
3106802,4,3,7,89,21,0,110,222,24,356
3106803,0,0,0,88,44,4,136,376,32,544
3106804,11,3,14,44,21,0,65,339,34,438
3106805,12,0,12,47,27,5,79,327,44,450
3106806,0,0,0,3,0,0,3,8,0,11
3106807,3,3,9,72,16,6,94,341,52,487
3106808,6,6,12,87,19,7,113,362,44,519
3106809,9,0,9,72,6,0,78,208,26,312
3106810,7,3,10,75,19,7,101,225,17,343
3106811,11,3,14,59,34,6,99,334,70,503
3106812,6,0,6,65,20,0,85,383,49,517
3106813,4,0,4,54,16,0,70,181,15,266
3106814,15,0,15,118,24,6,148,287,8,443
3106815,3,0,3,41,18,0,59,130,8,197
3106816,6,0,6,105,18,0,123,204,7,334
3106817,7,3,10,81,10,4,95,155,6,256
3106818,24,3,27,77,33,4,114,267,36,417
3106819,7,0,7,94,32,6,132,291,29,452
3106820,3,4,7,34,3,0,37,109,11,157
3106821,8,3,11,93,19,5,117,266,53,436
3106822,10,0,10,85,30,0,115,273,19,407
3106901,4,0,4,72,21,0,93,341,27,461
3106902,0,0,0,25,9,0,34,133,45,212
3106903,6,0,6,38,16,0,54,312,98,464
3106904,3,0,3,45,6,0,51,207,39,297
3106905,31,7,38,26,17,0,43,243,53,339
3106906,3,3,6,57,25,0,82,216,38,336
3106907,51,3,54,32,12,0,44,234,18,296
3106908,3,0,3,34,13,0,47,122,3,172
3106909,3,0,3,58,34,0,92,240,26,358
3106910,0,0,0,35,29,3,67,184,16,267
3106911,6,3,9,33,29,6,68,205,28,301
3106912,4,0,4,48,16,0,64,256,47,367
3106913,4,5,9,52,27,0,79,247,38,364
3107001,9,0,9,62,16,0,78,157,29,264
3107002,3,0,3,57,8,3,68,165,23,256
3107003,0,0,0,35,22,0,57,145,23,225
3107004,3,0,3,42,19,3,64,127,23,214
3107005,3,0,3,53,24,0,77,199,27,303
3107006,0,0,0,0,0,0,0,0,0,0
3107007,4,0,4,101,26,0,127,225,52,404
3107008,0,0,0,0,19,0,19,491,15,525
3107009,0,0,0,51,46,3,100,326,56,482
3107010,7,0,7,85,23,4,112,242,37,391
3107011,83,3,86,20,18,3,41,243,21,305
3107012,7,0,7,82,22,6,110,267,30,407
3107013,9,0,9,71,28,4,103,241,36,380
3107014,6,0,6,47,21,3,71,180,18,269
3107015,0,0,0,31,15,3,49,116,3,168
3107016,11,7,18,81,27,8,116,264,41,421
3107017,3,0,3,79,11,3,93,220,4,317
3107018,14,0,14,80,39,6,125,202,15,342
3107019,3,3,6,72,22,3,97,172,15,284
3107101,6,0,6,76,28,7,111,191,14,316
3107102,0,0,0,102,13,7,122,196,12,330
3107103,12,0,12,103,35,5,143,211,29,383
3107104,0,0,0,30,13,0,43,117,11,171
3107105,0,0,0,96,48,0,144,283,17,444
3107106,4,3,7,58,23,0,81,141,14,236
3107107,9,4,13,109,61,9,179,306,21,506
3107108,0,0,0,58,12,3,73,124,6,203
3107109,10,0,10,113,37,6,156,328,23,507
3107110,8,0,8,89,20,6,115,173,12,300
3107111,8,3,11,119,17,11,147,262,21,430
3107112,11,0,11,50,17,3,70,141,0,211
3107113,11,0,11,121,36,0,157,248,27,432
3107114,11,0,11,77,41,0,118,217,6,341
3107115,10,0,10,65,22,3,90,242,35,367
3107116,12,0,12,65,24,0,89,204,18,311
3107117,9,0,9,142,33,4,179,299,39,517
3107118,3,3,6,77,18,3,98,150,9,257
3107119,22,3,25,91,11,10,112,270,24,406
3107120,18,4,22,76,20,7,103,177,19,299
3107121,8,6,14,106,31,4,141,191,15,347
3107122,3,3,6,107,31,6,144,284,38,466
3107201,5,0,5,77,38,0,115,280,35,430
3107202,5,0,5,61,38,0,99,291,10,400
3107203,66,7,73,138,41,3,182,397,57,636
3107204,4,0,4,150,33,13,196,417,99,712
3107205,7,0,7,94,36,3,133,307,12,452
3107206,4,0,4,33,22,0,55,150,12,217
3107207,0,0,0,74,29,0,103,177,27,307
3107208,4,0,4,64,20,0,84,162,9,255
3107209,6,0,6,66,31,3,100,203,30,333
3107210,0,0,0,69,35,9,113,230,35,378
3107211,4,0,4,70,44,0,114,226,27,367
3107212,5,0,5,68,46,6,120,222,31,373
3107213,3,0,3,86,40,3,129,306,51,486
3107214,4,0,4,126,28,13,167,330,26,523
3107215,3,3,6,88,28,3,119,287,36,442
3107216,0,0,0,59,27,0,86,215,75,376
3107301,0,0,0,0,7,0,7,19,3,29
3107302,0,0,0,56,30,0,86,247,10,343
3107303,3,0,3,65,25,0,90,203,18,311
3107304,0,0,0,43,11,3,57,153,10,220
3107305,3,0,3,79,22,0,101,252,14,367
3107306,0,0,0,181,36,3,220,616,103,939
3107307,0,3,3,92,33,0,125,288,22,435
3107308,0,0,0,26,21,3,50,175,6,231
3107309,0,5,5,44,21,3,68,192,12,272
3107310,3,0,3,84,19,0,103,225,0,328
3107311,3,0,3,94,21,0,115,262,26,403
3107312,0,0,0,61,8,0,69,165,24,258
3107313,0,3,3,80,20,0,100,172,37,309
3107314,0,0,0,0,0,0,0,0,0,0
3107315,4,0,4,83,23,0,106,297,34,437
3107316,3,0,3,85,14,3,102,286,13,401
3107317,0,0,0,36,15,3,54,92,14,160
3107318,3,0,3,69,28,0,97,198,12,307
3107319,3,0,3,70,36,0,106,219,20,345
3107320,0,0,0,81,23,0,104,232,5,341
3107321,0,0,0,94,29,6,129,239,15,383
3107322,0,0,0,89,26,4,119,294,15,428
3107323,0,0,0,91,17,4,112,288,11,411
3107324,3,0,3,101,21,6,128,296,10,434
3107325,3,3,6,124,41,3,168,380,33,581
3107326,0,0,0,71,21,0,92,226,9,327
3107327,3,0,3,85,36,0,121,222,9,352
3107328,6,0,6,95,37,0,132,267,13,412
3107329,0,0,0,126,34,3,163,284,0,447
3107330,0,0,0,136,50,6,192,317,32,541
3107331,5,0,5,121,52,0,173,432,22,627
3107332,0,0,0,95,27,0,122,236,17,375
3107333,0,0,0,126,26,0,152,322,15,489
3107334,3,0,3,147,28,5,180,441,96,717
3107335,44,23,67,120,38,10,168,407,70,645
3107336,6,0,6,195,47,12,254,488,60,802
3107337,6,0,6,104,14,0,118,252,39,409
3107401,0,0,0,0,0,0,0,0,0,0
3107402,0,0,0,95,25,10,130,213,18,361
3107403,3,0,3,164,37,10,211,285,4,500
3107404,0,0,0,32,21,0,53,110,12,175
3107405,0,0,0,23,6,0,29,121,13,163
3107406,3,0,3,375,108,20,503,836,54,1393
3107407,4,0,4,54,23,3,80,234,10,324
3107408,0,0,0,0,0,0,0,3,0,3
3107501,0,0,0,95,30,0,125,258,23,406
3107502,3,3,6,134,30,3,167,369,26,562
3107503,0,0,0,158,41,0,199,230,12,441
3107504,0,0,0,88,18,9,115,168,12,295
3107505,0,0,0,157,51,7,215,216,21,452
3107506,6,0,6,150,29,0,179,314,42,535
3107507,0,0,0,155,26,6,187,263,26,476
3107508,41,0,41,66,23,0,89,248,16,353
3107509,0,0,0,102,9,6,117,163,9,289
3107510,0,0,0,117,30,3,150,257,20,427
3107511,3,0,3,102,21,4,127,305,9,441
3107512,0,0,0,57,11,0,68,116,13,197
3107513,0,0,0,52,34,0,86,206,15,307
3107514,0,0,0,0,0,0,0,0,0,0
3107515,0,0,0,145,40,4,189,191,26,406
3107516,0,0,0,84,22,7,113,173,5,291
3107517,0,0,0,82,18,6,106,157,12,275
3107518,3,0,3,69,26,4,99,162,6,267
3107519,0,0,0,98,28,3,129,211,12,352
3107520,0,0,0,72,22,6,100,109,21,230
3107521,0,0,0,42,24,0,66,137,9,212
3107522,3,3,6,194,38,4,236,293,33,562
3107523,0,0,0,114,23,3,140,225,11,376
3107524,0,0,0,136,34,8,178,213,11,402
3107525,3,0,3,134,26,6,166,203,12,381
3107526,0,0,0,124,17,4,145,187,12,344
3107527,0,0,0,94,26,3,123,179,10,312
3107528,74,24,98,33,9,0,42,224,47,313
3107529,3,0,3,80,21,0,101,179,27,307
3107530,4,0,4,71,20,5,96,122,4,222
3107531,0,0,0,56,29,0,85,160,0,245
3107532,0,0,0,40,9,0,49,48,6,103
3107601,0,3,3,32,9,0,41,166,24,231
3107602,3,0,3,3,0,0,3,3,0,6
3107603,0,0,0,20,6,0,26,127,17,170
3107604,3,0,3,36,34,0,70,164,18,252
3107605,0,0,0,0,0,0,0,0,0,0
3107606,0,0,0,23,9,3,35,132,23,190
3107607,4,3,7,77,23,3,103,277,40,420
3107608,0,0,0,67,36,5,108,253,49,410
3107609,0,0,0,49,16,3,68,135,17,220
3107610,0,3,3,69,35,3,107,181,26,314
3107611,3,0,3,40,17,3,60,193,28,281
3107612,0,0,0,42,16,0,58,117,26,201
3107613,3,0,3,40,21,0,61,173,31,265
3107614,3,0,3,51,34,0,85,224,18,327
3107615,0,0,0,39,23,0,62,156,17,235
3107616,8,4,12,26,6,3,35,146,37,218
3107617,4,0,4,65,14,3,82,189,34,305
3107618,0,0,0,100,26,0,126,258,44,428
3107619,3,3,6,50,21,0,71,168,21,260
3107620,0,0,0,51,15,0,66,163,26,255
3107621,19,8,27,22,6,0,28,106,46,180
3107622,4,0,4,41,27,0,68,173,21,262
3107623,11,12,23,42,21,0,63,201,41,305
3107624,3,0,3,20,28,6,54,114,19,187
3107625,0,0,0,3,0,0,3,0,0,3
3107626,0,0,0,33,14,6,53,176,31,260
3107627,36,3,39,17,6,0,23,161,33,217
3107628,0,0,0,55,13,0,68,194,9,271
3107629,3,0,3,46,22,0,68,270,18,356
3107630,0,0,0,0,0,0,0,4,0,4
3107631,0,0,0,0,0,0,0,6,0,6
3107632,0,0,0,0,0,0,0,12,0,12
3107701,3,0,3,122,41,3,166,281,7,454
3107702,3,0,3,102,31,6,139,272,4,415
3107703,5,0,5,86,24,3,113,237,18,368
3107704,6,0,6,97,42,7,146,241,25,412
3107705,3,0,3,101,42,4,147,291,42,480
3107706,0,0,0,47,12,0,59,113,43,215
3107707,3,0,3,151,49,4,204,350,31,585
3107708,0,0,0,125,21,6,152,287,22,461
3107709,0,0,0,51,6,0,57,101,44,202
3107710,3,0,3,126,37,0,163,320,17,500
3107711,0,0,0,19,15,0,34,86,29,149
3107712,0,0,0,44,18,0,62,147,37,246
3107713,0,0,0,48,5,3,56,85,20,161
3107714,0,0,0,72,9,3,84,164,22,270
3107715,0,0,0,42,3,3,48,119,0,167
3107716,77,22,99,57,31,0,88,353,42,483
3107717,0,0,0,91,31,3,125,247,18,390
3107801,0,0,0,48,18,6,72,151,24,247
3107802,6,0,6,89,33,12,134,264,23,421
3107803,3,0,3,92,24,3,119,271,35,425
3107804,5,0,5,106,27,7,140,280,25,445
3107805,3,0,3,60,24,0,84,164,15,263
3107806,3,0,3,108,35,0,143,278,18,439
3107807,0,3,3,58,9,3,70,136,14,220
3107808,0,0,0,83,25,4,112,178,25,315
3107809,3,0,3,60,7,3,70,95,4,169
3107810,0,3,3,91,19,3,113,389,36,538
3107811,3,0,3,55,29,0,84,213,13,310
3107812,0,0,0,86,10,0,96,300,30,426
3107813,0,0,0,60,20,3,83,136,6,225
3107814,6,0,6,105,22,3,130,381,32,543
3107815,4,0,4,71,33,0,104,256,12,372
3107816,3,0,3,70,15,0,85,212,20,317
3107817,3,0,3,59,23,3,85,255,22,362
3107818,0,0,0,47,7,3,57,153,7,217
3107819,0,0,0,54,14,5,73,174,13,260
3107820,3,0,3,61,9,0,70,194,21,285
3107821,3,0,3,53,30,0,83,229,12,324
3107822,0,0,0,81,18,0,99,261,19,379
3107823,3,0,3,71,9,6,86,192,10,288
3107824,0,4,4,64,22,6,92,255,26,373
3107825,0,0,0,62,12,0,74,217,17,308
3107826,0,0,0,77,15,3,95,277,15,387
3107827,3,0,3,94,17,0,111,251,19,381
3107828,3,0,3,61,11,0,72,267,15,354
3107829,11,0,11,59,32,4,95,250,18,363
3107830,0,0,0,26,20,6,52,153,15,220
3107831,0,0,0,54,16,0,70,151,9,230
3107832,3,0,3,91,33,0,124,259,31,414
3107901,8,0,8,55,14,6,75,215,24,314
3107902,8,4,12,69,9,0,78,245,32,355
3107903,16,0,16,70,21,6,97,374,40,511
3107904,0,0,0,37,9,0,46,217,21,284
3107905,7,3,10,49,21,6,76,314,58,448
3107906,0,0,0,30,20,0,50,114,10,174
3107907,3,0,3,35,32,0,67,216,14,297
3107908,8,0,8,34,25,0,59,260,29,348
3107909,6,0,6,71,15,0,86,301,23,410
3107910,9,0,9,60,20,3,83,255,23,361
3107911,0,0,0,53,23,6,82,249,15,346
3107912,3,0,3,53,19,3,75,218,19,312
3107913,3,6,9,52,39,0,91,249,27,367
3107914,4,3,7,32,24,0,56,172,15,243
3107915,11,0,11,62,23,3,88,436,24,548
3107916,4,0,4,32,13,0,45,255,26,326
3107917,7,0,7,28,13,0,41,150,6,197
3107918,7,7,14,82,33,4,119,316,59,494
3107919,7,0,7,80,27,3,110,244,14,368
3107920,3,0,3,48,26,0,74,222,9,305
3108001,5,0,5,38,14,0,52,172,12,236
3108002,0,0,0,21,6,3,30,104,9,143
3108003,0,0,0,46,14,0,60,140,13,213
3108004,4,0,4,74,32,6,112,293,14,419
3108005,3,3,6,61,19,7,87,334,21,442
3108006,0,0,4,100,20,0,120,292,25,437
3108007,4,0,4,55,23,7,85,421,27,533
3108008,3,0,3,93,37,6,136,268,9,413
3108009,3,0,3,82,21,7,110,249,24,383
3108010,3,0,3,94,16,8,118,303,23,444
3108011,9,0,9,79,37,6,122,316,24,462
3108012,3,0,3,46,15,0,61,143,6,210
3108013,3,0,3,104,45,3,152,324,41,517
3108014,6,0,6,86,36,0,122,204,14,340
3108015,11,38,49,44,9,3,56,209,87,352
3108016,9,0,9,66,44,3,113,275,23,411
3108017,0,0,0,77,41,0,118,283,32,433
3108018,6,0,6,79,25,6,110,269,13,392
3108019,0,0,0,59,32,0,91,231,18,340
3108020,0,0,0,44,21,0,65,162,21,248
3108021,3,0,3,35,9,0,44,150,13,207
3108022,6,0,6,77,22,0,99,303,24,426
3108023,98,7,105,49,27,6,82,373,47,502
3108024,3,0,3,62,16,0,78,244,25,347
3108025,7,3,10,56,38,0,94,339,28,461
3108026,4,0,4,37,21,3,61,215,9,285
3108027,6,0,6,40,30,0,70,270,29,369
3108028,0,0,0,62,38,3,103,270,27,400
3108029,5,0,5,68,37,0,105,307,38,450
3108030,0,4,4,53,20,6,79,228,20,327
3108031,0,0,0,97,31,6,134,270,18,422
3108032,10,3,13,17,9,6,32,176,16,224
3108033,0,3,3,56,37,3,96,217,12,325
3108034,0,0,0,23,22,3,48,169,15,232
3108035,6,0,6,62,33,0,95,240,26,361
3108036,0,0,0,69,53,0,122,224,23,369
3108037,3,0,3,30,22,0,52,153,4,209
3108038,13,0,13,70,23,3,96,257,13,366
3108039,3,0,3,116,30,0,146,261,31,438
3108101,8,0,8,88,37,0,125,199,5,329
3108102,3,0,3,75,40,3,118,184,6,308
3108103,3,0,3,59,24,9,92,169,0,261
3108104,5,0,5,100,44,11,155,254,16,425
3108105,56,0,56,78,41,6,125,367,6,498
3108106,0,0,0,67,33,0,100,284,16,400
3108107,0,0,0,58,34,0,92,230,11,333
3108108,0,0,0,64,37,0,101,211,12,324
3108109,3,0,6,82,29,0,111,180,6,297
3108110,0,0,0,0,0,0,0,0,0,0
3108111,0,0,0,0,0,0,0,0,0,0
3108112,4,0,4,82,39,9,130,283,19,432
3108113,18,6,24,58,24,7,89,207,18,314
3108114,0,0,0,43,13,3,59,140,19,218
3108115,0,4,4,91,29,0,120,215,44,379
3108116,0,0,0,46,27,3,76,116,9,201
3108117,5,0,5,82,11,7,100,189,5,294
3108118,5,0,5,52,35,6,93,175,10,278
3108119,4,0,4,76,34,0,110,196,13,319
3108120,6,0,6,86,41,0,127,172,3,302
3108201,3,0,3,47,11,4,62,100,8,170
3108202,0,0,0,46,15,0,61,133,3,197
3108203,3,0,3,34,20,0,54,153,3,210
3108204,8,6,14,65,38,0,103,215,15,333
3108205,4,0,4,34,18,0,52,122,6,180
3108206,0,3,3,59,25,3,87,113,3,203
3108207,3,0,3,86,36,0,122,300,6,428
3108208,3,0,3,68,17,7,92,182,12,286
3108209,8,3,11,64,27,3,94,221,15,330
3108210,0,0,0,81,28,0,109,239,16,364
3108211,0,0,0,91,22,3,116,251,16,383
3108212,3,0,3,62,27,9,98,206,18,322
3108213,3,0,3,87,34,3,124,302,25,451
3108214,3,0,3,58,22,7,87,180,10,277
3108215,6,0,6,58,30,3,91,114,12,217
3108216,3,0,3,60,31,3,94,148,12,254
3108217,0,0,0,60,15,3,78,200,13,291
3108218,0,0,0,37,17,3,57,124,11,192
3108219,3,6,9,70,28,0,98,217,24,339
3108220,4,0,4,73,18,0,91,176,20,287
3108301,0,0,0,0,0,0,0,3,0,3
3108302,3,5,8,107,39,0,146,296,13,455
3108303,0,0,0,76,19,9,104,133,6,243
3108304,8,0,8,69,33,3,105,261,20,386
3108305,0,0,0,62,8,5,75,148,18,241
3108306,0,0,0,60,10,7,77,137,9,223
3108307,0,0,0,40,16,0,56,122,3,181
3108308,6,0,6,78,13,0,91,136,7,234
3108309,6,0,6,65,24,0,89,217,23,329
3108310,0,4,4,84,9,6,99,169,12,280
3108311,4,0,4,94,29,4,127,278,27,432
3108401,6,0,6,123,36,5,164,295,11,470
3108402,0,0,0,65,9,0,74,145,4,223
3108403,4,0,4,156,16,5,177,153,0,330
3108404,0,0,0,170,38,10,218,239,4,461
3108405,0,0,0,0,0,0,0,0,0,0
3108406,0,0,0,0,0,0,0,0,0,0
3108407,0,0,0,49,18,5,72,131,3,206
3108408,0,0,0,121,19,9,149,255,12,416
3108409,233,22,255,27,4,0,31,447,40,518
3108410,0,0,0,50,18,0,68,122,20,210
3108411,6,6,12,95,20,6,121,278,24,423
3108412,4,0,4,136,21,7,164,165,9,338
3108413,0,0,0,114,19,0,133,280,21,434
3108414,0,0,0,50,19,6,75,144,9,228
3108415,3,0,3,52,18,6,76,120,3,199
3108416,6,0,6,41,30,0,71,224,12,307
3108417,3,0,3,99,18,6,123,218,18,359
3108418,3,0,3,82,25,5,112,221,9,342
3108419,0,0,0,34,9,0,43,90,15,148
3108420,0,0,0,3,3,0,6,0,0,6
3108421,6,0,6,86,36,0,122,207,12,341
3108422,3,0,6,98,48,6,152,209,18,379
3108423,3,0,3,110,30,0,140,161,4,305
3108424,3,0,6,90,43,4,137,234,4,375
3108425,6,3,9,99,33,0,132,227,19,378
3108501,0,0,0,82,22,4,108,275,14,397
3108502,4,0,4,42,18,6,66,168,15,249
3108503,3,0,8,53,27,7,87,195,21,303
3108504,3,3,6,69,24,9,102,189,22,313
3108505,4,0,4,53,29,0,82,238,7,327
3108506,3,0,3,74,26,3,103,197,10,310
3108507,0,0,0,102,22,4,128,264,11,403
3108508,0,0,0,39,29,6,74,171,8,253
3108509,0,0,0,78,30,4,112,249,7,368
3108510,3,0,3,49,15,0,64,195,15,274
3108511,0,0,3,68,35,3,106,228,18,352
3108601,8,0,8,80,25,4,109,223,18,350
3108602,5,0,5,180,55,6,241,330,15,586
3108603,3,0,3,59,14,5,78,121,9,208
3108604,0,3,3,100,15,9,124,168,13,305
3108605,0,3,3,98,37,9,144,265,16,425
3108606,3,3,6,103,31,13,147,304,23,474
3108607,5,0,5,195,18,8,221,237,24,482
3108608,3,0,3,166,39,0,205,297,18,520
3108609,0,3,3,100,22,6,128,188,6,322
3108610,0,0,0,59,18,0,77,127,6,210
3108611,0,0,0,48,22,6,76,139,12,227
3108612,0,0,0,76,41,0,117,256,18,391
3108613,6,3,9,93,30,3,126,242,21,389
3108614,4,0,4,96,29,0,125,295,28,448
3108615,0,0,0,68,38,3,109,219,9,337
3108616,8,0,8,217,47,7,271,337,18,626
3108617,6,0,6,154,39,8,201,282,24,507
3108701,0,0,0,0,3,0,3,33,0,36
3108702,0,3,3,69,20,9,98,175,9,282
3108703,0,0,0,74,28,0,102,176,16,294
3108704,7,0,10,70,24,6,100,167,14,281
3108705,4,3,7,82,49,6,137,341,32,510
3108706,24,77,101,28,31,3,62,134,121,317
3108707,0,0,0,51,16,5,72,107,0,179
3108708,0,0,0,56,26,4,86,161,17,264
3108709,0,0,0,41,12,0,53,98,9,160
3108710,0,0,0,84,17,0,101,181,18,300
3108711,0,0,0,97,19,6,122,189,18,329
3108712,0,0,0,33,15,0,48,117,0,165
3108713,3,0,3,54,27,6,87,189,14,290
3108714,0,0,0,60,15,12,87,150,3,240
3108715,6,0,6,47,36,6,89,157,7,253
3108716,3,0,3,108,37,6,151,305,14,470
3108717,6,0,6,72,18,6,96,212,10,318
3108718,4,0,4,37,12,3,52,171,4,227
3108719,13,94,107,28,6,3,37,150,138,325
3108720,9,0,9,64,13,9,86,226,3,315
3108801,4,0,4,85,33,0,118,193,12,323
3108802,0,0,0,48,13,0,61,129,6,196
3108803,3,0,3,68,16,4,88,184,14,286
3108804,0,0,0,64,19,6,89,263,0,352
3108805,3,0,3,95,48,7,150,277,9,436
3108806,6,0,6,69,28,5,102,210,8,320
3108807,4,0,4,48,14,3,65,126,12,203
3108808,6,0,6,59,21,3,83,270,9,362
3108809,3,0,3,89,53,7,149,298,9,456
3108810,7,0,7,74,33,0,107,266,12,385
3108811,3,0,3,91,41,6,138,293,16,447
3108812,0,0,0,95,52,3,150,342,25,517
3108813,3,0,3,54,22,3,79,208,8,295
3108814,30,51,84,68,30,6,104,234,100,438
3108815,7,0,7,114,28,5,147,336,12,495
3108816,9,0,9,34,16,0,50,158,3,211
3108817,3,0,3,98,29,4,131,297,12,440
3108818,0,0,0,64,13,0,77,136,3,216
3108819,4,0,4,98,26,6,130,261,7,398
3108820,3,0,3,101,47,5,153,256,4,413
3108821,6,0,6,42,22,0,64,172,6,242
3108822,3,0,3,39,20,3,62,192,15,269
3108823,4,0,4,98,32,6,136,257,18,411
3108824,0,0,0,56,12,0,68,125,3,196
3108901,0,0,0,113,49,4,166,237,24,427
3108902,9,0,9,201,36,10,247,304,28,579
3108903,3,0,3,49,7,4,60,133,18,211
3108904,7,3,10,127,52,5,184,276,6,466
3108905,0,0,0,64,11,4,79,174,17,270
3108906,6,0,6,102,20,12,134,212,7,353
3108907,6,0,6,69,25,6,100,196,10,306
3108908,0,0,0,48,6,0,54,97,9,160
3109001,6,0,6,107,37,11,155,261,5,421
3109002,5,0,5,94,18,8,120,195,4,319
3109003,4,0,4,29,9,0,38,109,18,165
3109004,17,0,17,39,15,0,54,160,0,214
3109005,9,0,13,101,48,6,155,299,28,482
3109006,3,0,3,66,31,0,97,178,21,296
3109007,11,3,14,82,53,6,141,285,27,453
3109008,3,0,3,64,30,0,94,192,12,298
3109009,11,0,11,72,26,3,101,244,12,357
3109010,6,0,6,109,37,7,153,318,32,503
3109011,10,9,19,115,37,3,155,290,37,482
3109012,15,0,15,73,19,3,95,224,8,327
3109013,7,0,7,33,18,3,54,118,11,183
3109014,8,0,8,32,20,6,58,159,16,233
3109015,0,0,0,40,17,6,63,89,9,161
3109016,0,0,0,89,21,9,119,185,24,328
3109017,6,0,6,119,39,10,168,302,11,481
3109018,6,0,6,132,59,10,201,346,21,568
3109019,6,0,6,115,40,12,167,328,15,510
3109101,107,5,112,10,18,0,28,240,23,291
3109102,0,0,0,32,15,0,47,92,12,151
3109103,3,0,3,100,7,11,118,161,9,288
3109104,6,0,6,51,19,0,70,210,16,296
3109105,0,0,0,113,45,6,164,260,26,450
3109106,3,0,3,179,38,8,225,246,15,486
3109107,3,0,3,127,19,3,149,202,6,357
3109108,7,0,7,125,33,9,167,274,15,456
3109109,3,0,3,68,26,8,102,186,9,297
3109110,3,3,6,105,27,0,132,228,11,371
3109111,6,0,6,120,27,0,147,277,6,430
3109112,0,0,0,75,18,0,93,149,6,248
3109201,0,0,4,39,21,0,60,113,12,185
3109202,8,3,11,108,34,9,151,223,15,389
3109203,0,0,0,70,11,4,85,98,9,192
3109204,6,3,9,52,15,0,67,150,24,241
3109205,8,3,11,106,32,6,144,188,13,345
3109206,0,0,0,68,18,3,89,140,3,232
3109207,7,0,7,76,10,0,86,151,9,246
3109208,5,3,8,107,25,6,138,246,9,393
3109209,40,6,46,97,43,6,146,308,31,485
3109210,5,0,5,80,22,3,105,135,9,249
3109211,5,0,5,104,39,3,146,284,28,458
3109212,0,0,0,30,10,0,40,98,4,142
3109213,3,0,3,71,32,9,112,248,10,370
3109214,6,0,6,119,18,6,143,256,18,417
3109215,6,0,6,85,13,12,110,166,16,292
3109216,8,0,8,104,50,6,160,248,40,448
3109301,16,3,19,54,31,4,89,353,21,463
3109302,7,0,7,55,15,0,70,153,15,238
3109303,0,0,0,57,27,0,84,295,34,413
3109304,0,0,0,0,0,0,0,0,0,0
3109305,6,31,37,60,27,5,92,183,85,360
3109306,11,0,11,90,36,4,130,232,17,379
3109307,0,0,0,86,18,9,113,179,15,307
3109308,14,74,88,57,22,5,84,176,134,394
3109309,0,3,3,97,29,15,141,195,14,350
3109310,3,3,6,44,12,3,59,140,15,214
3109311,7,3,10,83,29,3,115,212,13,340
3109312,6,0,6,89,27,8,124,192,11,327
3109401,3,3,9,53,24,3,80,350,56,486
3109402,4,0,4,78,29,6,113,216,15,344
3109403,0,0,0,53,18,3,74,141,0,215
3109404,8,5,13,112,25,10,147,313,11,471
3109405,0,0,0,0,0,0,0,0,0,0
3109406,3,0,3,41,24,3,68,173,7,248
3109407,4,0,4,77,26,0,103,250,18,371
3109408,0,0,0,67,18,3,88,294,19,401
3109409,6,0,6,34,18,0,52,277,22,351
3109410,5,0,5,20,19,0,39,227,12,278
3109411,3,0,3,41,22,0,63,324,56,443
3109412,3,0,3,47,26,0,73,267,21,361
3109413,6,0,6,45,31,0,76,241,17,334
3109414,3,6,9,33,27,3,63,171,40,274
3109415,16,0,16,50,25,0,75,449,82,606
3109416,6,0,6,31,12,0,43,195,26,264
3109417,3,5,8,47,23,0,70,340,104,514
3109418,5,0,5,47,15,0,62,168,17,247
3109419,3,0,3,54,21,0,75,148,3,226
3109420,0,0,0,85,31,11,127,189,17,333
3109421,8,0,8,44,13,3,60,190,16,266
3109422,4,0,4,18,6,0,24,91,13,128
3109423,3,0,3,36,15,0,51,174,12,237
3109424,13,0,13,46,30,0,76,189,6,271
3109425,3,0,3,88,20,6,114,429,50,593
3109426,0,0,0,17,10,0,27,176,7,210
3109427,4,3,7,36,10,4,50,214,20,284
3109428,37,0,37,48,12,0,60,339,23,422
3109429,4,0,4,63,14,6,83,188,5,276
3109430,6,0,6,37,21,0,58,199,3,260
3109431,9,0,9,62,21,3,86,242,9,337
3109501,7,3,10,58,31,7,96,364,34,494
3109502,10,3,13,57,30,3,90,191,6,287
3109503,8,0,8,92,26,4,122,223,20,365
3109504,6,0,6,70,25,6,101,217,40,358
3109505,6,0,6,49,17,5,71,117,26,214
3109506,3,0,3,48,14,0,62,139,31,232
3109507,6,0,6,92,6,4,102,152,15,269
3109508,3,0,3,50,11,3,64,94,9,167
3109509,19,3,22,48,14,0,62,351,33,446
3109510,9,0,9,65,26,5,96,230,25,351
3109511,7,0,7,64,17,5,86,150,8,244
3109512,3,0,3,80,15,9,104,219,20,343
3109513,8,0,8,54,16,3,73,104,5,182
3109514,5,4,9,77,12,8,97,126,25,248
3109601,5,0,5,25,24,0,49,485,28,562
3109602,4,0,4,17,20,0,37,286,36,359
3109603,13,0,13,23,30,0,53,434,7,494
3109604,0,0,0,18,3,0,21,258,36,315
3109605,0,0,0,32,3,0,35,361,41,437
3109606,0,0,0,42,3,0,45,385,36,466
3109607,0,0,0,29,12,0,41,241,13,295
3109608,0,0,0,45,11,0,56,362,30,448
3109609,3,0,3,89,23,6,118,270,17,405
3109610,11,0,11,47,23,6,76,310,30,416
3109611,9,0,9,30,21,0,51,232,47,330
3109612,0,0,0,50,21,0,71,214,17,302
3109613,8,0,8,53,22,0,75,190,29,294
3109614,10,0,10,47,13,0,60,255,34,349
3109615,0,0,0,9,80,0,89,1872,79,2040
3109616,6,3,9,28,19,0,47,336,27,410
3109617,3,0,3,13,6,0,19,202,7,228
3109618,8,0,8,37,44,0,81,372,34,487
3109619,0,3,3,9,25,0,34,244,25,303
3109620,0,0,0,21,18,0,39,301,17,357
3109621,6,0,6,48,24,3,75,249,24,348
3109622,3,0,6,20,22,0,42,246,18,306
3109623,3,0,3,75,32,0,107,238,27,372
3109701,3,0,3,55,18,0,73,249,13,335
3109702,7,0,7,25,13,0,38,149,13,200
3109703,6,0,6,22,24,0,46,229,9,284
3109704,6,0,6,42,31,0,73,464,47,584
3109705,0,0,0,35,3,3,41,179,15,235
3109706,3,0,3,44,12,3,59,346,18,423
3109707,6,0,6,21,19,0,40,212,5,257
3109708,0,0,0,15,16,6,37,313,26,376
3109709,0,0,0,41,17,3,61,370,27,458
3109710,8,0,11,52,26,0,78,331,12,421
3109711,4,0,4,5,8,0,13,244,41,298
3109712,8,0,8,41,31,3,75,287,20,382
3109713,0,0,0,21,10,0,31,234,19,284
3109714,3,0,3,59,20,0,79,250,15,344
3109715,6,3,9,28,14,5,47,192,6,245
3109716,0,3,3,22,20,0,42,261,12,315
3109717,0,0,0,32,20,0,52,357,15,424
3109718,0,0,0,53,12,0,65,178,21,264
3109719,6,0,6,54,22,3,79,151,12,242
3109720,5,0,5,86,38,6,130,300,12,442
3109721,56,14,70,24,15,0,39,258,31,328
3109801,15,0,15,52,21,0,73,174,10,257
3109802,4,0,4,76,25,5,106,206,14,326
3109803,6,0,6,118,30,4,152,330,20,502
3109804,0,0,0,18,13,0,31,688,54,773
3109805,3,0,3,127,15,0,142,164,13,319
3109806,13,0,13,115,26,9,150,468,23,641
3109807,0,3,3,28,13,0,41,146,12,199
3109808,12,6,18,95,28,4,127,277,12,416
3109809,15,6,21,86,21,7,114,269,15,398
3109810,4,0,4,38,10,3,51,176,10,237
3109811,9,4,13,64,10,0,74,174,16,264
3109812,11,3,14,67,26,0,93,407,26,526
3109813,4,0,4,32,3,0,35,141,4,180
3109814,8,0,8,93,33,3,129,296,14,439
3109815,9,0,9,57,24,6,87,241,24,352
3109816,9,0,9,54,18,3,75,339,32,446
3109817,6,0,6,41,11,0,52,178,14,244
3109901,0,0,0,10,0,0,10,7,3,20
3110001,7,3,10,81,30,0,111,202,30,343
3110002,0,0,0,97,45,6,148,240,0,388
3110003,0,0,4,89,40,3,132,304,46,482
3110004,9,0,9,69,27,4,100,179,32,311
3110005,3,3,6,43,3,3,49,157,34,240
3110006,4,3,7,43,10,0,53,125,18,196
3110007,0,0,0,0,0,0,0,6,0,6
3110008,105,20,125,0,11,0,11,292,35,338
3110009,14,3,17,66,15,0,81,207,13,301
3110010,3,0,3,67,40,3,110,280,12,402
3110011,6,0,6,102,39,4,145,239,23,407
3110012,3,3,6,73,33,6,112,238,16,366
3110013,0,0,0,56,41,3,100,209,21,330
3110014,6,3,9,50,24,0,74,160,6,240
3110015,3,0,3,90,26,6,122,179,5,306
3110016,6,3,9,52,29,0,81,179,7,267
3110017,128,3,131,26,18,3,47,255,19,321
3110018,0,3,3,42,8,4,54,114,14,182
3110019,5,0,5,72,5,0,77,178,5,260
3110101,7,3,13,91,12,6,109,193,27,329
3110102,10,0,10,77,24,9,110,216,21,347
3110103,14,6,24,82,15,6,103,162,12,277
3110104,8,0,8,75,20,6,101,170,0,271
3110105,8,0,8,57,24,3,84,161,6,251
3110106,8,0,8,80,14,0,94,203,3,300
3110107,6,0,6,90,31,3,124,273,27,424
3110108,0,0,0,0,12,0,12,47,4,63
3110109,0,3,3,77,36,4,117,223,8,348
3110110,8,8,16,81,23,6,110,163,13,286
3110111,8,0,8,59,19,0,78,154,10,242
3110112,14,0,14,80,26,6,112,239,17,368
3110113,3,0,3,57,11,0,68,113,15,196
3110114,8,0,8,88,34,4,126,157,18,301
3110115,0,0,0,127,13,6,146,205,15,366
3110116,0,0,0,112,17,0,129,153,15,297
3110117,4,0,4,97,24,7,128,199,19,346
3110118,6,0,6,22,12,3,37,182,12,231
3110119,10,0,10,67,36,3,106,222,10,338
3110120,70,3,73,73,12,7,92,326,26,444
3110201,0,0,0,0,0,0,0,0,0,0
3110301,3,0,3,40,12,3,55,104,18,177
3110302,0,0,0,71,25,0,96,194,3,293
3110303,3,0,3,142,37,12,191,272,17,480
3110304,3,0,3,71,42,5,118,217,10,345
3110305,0,0,0,79,26,5,110,179,3,292
3110306,0,0,0,92,50,0,142,287,20,449
3110307,6,3,9,56,31,4,91,165,9,265
3110308,3,0,3,84,43,10,137,232,10,379
3110309,12,0,12,107,28,9,144,249,22,415
3110310,6,0,6,57,26,3,86,136,12,234
3110311,5,0,5,103,37,3,143,255,12,410
3110312,6,0,6,45,32,3,80,148,3,231
3110313,3,0,3,99,56,8,163,208,12,383
3110314,8,0,8,89,28,7,124,256,9,389
3110315,6,0,6,52,21,6,79,145,12,236
3110316,0,0,0,67,18,9,94,125,0,219
3110317,0,0,0,60,19,0,79,186,10,275
3110318,3,0,3,72,29,0,101,173,15,289
3110319,0,3,3,54,21,6,81,182,15,278
3110320,6,0,6,40,18,3,61,167,9,237
3110321,0,0,0,52,20,3,75,137,12,224
3110322,0,3,3,57,22,9,88,159,18,265
3110323,7,3,10,76,29,6,111,195,21,327
3110324,4,0,4,69,14,0,83,137,12,232
3110325,3,77,80,52,7,3,62,117,120,299
3110326,0,0,0,51,28,4,83,162,9,254
3110327,0,0,0,103,27,6,136,196,14,346
3110328,3,0,3,100,40,0,140,260,9,409
3110329,0,0,0,53,21,6,80,255,6,341
3110330,3,0,6,53,29,3,85,152,6,243
3110331,5,0,5,46,23,4,73,166,12,251
3110332,0,0,0,55,27,0,82,250,12,344
3110333,4,0,4,80,49,7,136,304,23,463
3110334,0,0,0,115,33,6,154,231,6,391
3110335,6,0,6,90,44,3,137,274,10,421
3110336,7,0,7,85,24,3,112,228,19,359
3110337,7,0,7,47,15,0,62,185,20,267
3110338,3,0,6,94,48,3,145,301,40,486
3110339,0,0,0,64,27,0,91,167,15,273
3110340,0,0,0,33,21,3,57,137,6,200
3110401,0,0,0,77,36,0,113,205,4,322
3110402,0,0,0,141,27,6,174,180,7,361
3110403,4,0,4,165,25,0,190,165,12,367
3110404,0,0,0,146,28,5,179,182,15,376
3110405,0,3,3,150,34,6,190,190,30,410
3110406,0,0,0,135,19,8,162,179,0,341
3110407,59,8,67,75,65,3,143,378,22,543
3110408,0,0,0,116,36,10,162,223,0,385
3110409,0,0,0,36,21,3,60,150,0,210
3110410,0,0,0,58,43,0,101,251,11,363
3110411,6,3,9,70,38,3,111,187,3,301
3110412,3,0,3,70,27,7,104,167,0,271
3110413,0,0,0,77,13,6,96,140,7,243
3110414,0,0,0,35,16,0,51,111,12,174
3110415,0,0,0,66,21,10,97,143,6,246
3110416,0,0,0,61,20,3,84,156,6,246
3110417,0,0,0,94,42,4,140,168,17,325
3110418,0,0,0,63,34,9,106,115,9,230
3110419,3,0,3,95,44,8,147,295,15,457
3110420,6,0,6,60,37,3,100,233,15,348
3110421,6,0,6,61,26,3,90,196,10,296
3110501,0,0,0,41,15,0,56,316,73,445
3110502,0,0,0,29,15,0,44,493,229,766
3110503,0,0,0,11,0,0,11,171,26,208
3110504,0,0,0,9,3,0,12,210,67,289
3110505,0,0,0,9,10,0,19,222,108,349
3110506,0,0,0,28,19,0,47,344,26,417
3110507,4,0,4,71,43,3,117,745,82,944
3110508,0,0,0,0,0,0,0,156,48,204
3110509,3,3,6,29,14,0,43,407,68,518
3110510,0,0,0,32,3,3,38,563,178,779
3110511,5,0,5,11,20,0,31,527,188,746
3110512,0,0,0,13,7,3,23,240,127,390
3110513,0,3,3,3,0,0,3,13,3,19
3110514,4,0,4,94,36,0,130,525,89,744
3110515,0,0,0,53,26,0,79,312,66,457
3110516,0,3,3,26,19,0,45,221,87,353
3110517,0,0,0,15,6,0,21,196,52,269
3110518,0,0,0,27,3,0,30,140,16,186
3110519,0,0,0,7,6,0,13,116,21,150
3110601,0,0,0,12,8,0,20,103,16,139
3110602,0,0,0,33,17,4,54,489,155,698
3110603,3,0,3,28,12,3,43,286,62,391
3110604,0,0,0,15,21,0,36,423,86,545
3110605,0,0,0,10,12,0,22,302,39,363
3110606,0,0,0,67,24,0,91,629,56,776
3110607,0,0,0,15,10,0,25,289,48,362
3110608,35,3,38,10,5,0,15,319,130,464
3110609,0,0,0,6,21,0,27,341,58,426
3110610,0,0,0,25,14,3,42,331,78,451
3110611,0,0,0,19,8,0,27,329,39,395
3110701,0,0,0,38,29,0,67,254,26,347
3110702,0,0,0,40,20,3,63,227,18,308
3110703,3,0,3,71,12,0,83,213,43,339
3110704,6,0,6,58,13,0,71,295,28,394
3110705,0,39,39,28,18,0,46,180,87,313
3110706,0,5,5,39,17,0,56,251,86,393
3110707,12,0,12,60,29,6,95,427,52,574
3110708,6,0,6,52,27,6,85,327,40,452
3110709,4,0,4,54,14,3,71,204,6,281
3110710,6,0,6,54,17,4,75,262,12,349
3110711,3,0,3,44,26,0,70,299,36,405
3110712,0,0,0,25,8,0,33,138,14,185
3110713,0,0,0,22,6,0,28,190,9,227
3110714,3,3,6,27,13,4,44,185,40,269
3110715,3,3,6,44,12,3,59,263,39,361
3110801,3,6,9,29,19,4,52,342,106,500
3110802,3,0,3,10,6,0,16,141,12,169
3110803,3,0,3,15,9,0,24,228,22,274
3110804,59,43,102,15,13,0,28,285,148,461
3110805,7,0,7,35,12,0,47,364,31,442
3110806,6,0,6,23,40,0,63,320,25,408
3110807,0,4,4,27,21,3,51,306,20,377
3110808,0,0,0,25,10,0,35,235,47,317
3110809,4,0,4,24,34,3,61,400,54,515
3110810,0,0,0,29,29,0,58,415,88,561
3110811,0,0,0,32,18,0,50,262,27,339
3110812,3,0,3,21,9,0,30,258,76,364
3110813,0,0,0,45,15,3,63,257,71,391
3110814,9,0,9,47,33,0,80,417,68,565
3110815,6,3,9,28,22,3,53,245,50,348
3110816,0,0,0,33,11,3,47,259,22,328
3110817,0,0,0,19,7,3,29,163,33,225
3110901,3,5,8,18,27,0,45,249,25,319
3110902,0,0,0,33,14,0,47,232,49,328
3110903,6,0,6,30,9,6,45,337,36,418
3110904,0,0,0,42,18,3,63,160,27,250
3110905,6,3,9,38,9,3,50,162,24,236
3110906,3,0,3,10,25,0,35,237,11,283
3110907,0,0,0,24,21,0,45,180,32,257
3110908,0,0,0,36,12,0,48,238,31,317
3110909,57,5,62,14,13,0,27,314,29,370
3110910,6,3,9,41,37,0,78,405,74,557
3110911,7,0,7,11,5,0,16,207,63,286
3110912,0,0,0,26,19,0,45,271,24,340
3110913,3,0,3,45,24,6,75,254,21,350
3110914,12,52,64,42,24,3,69,284,109,462
3110915,8,6,14,33,35,3,71,336,39,446
3110916,0,0,0,13,10,0,23,185,15,223
3110917,8,0,8,70,36,3,109,388,27,524
3110918,62,6,68,45,33,0,78,437,37,552
3110919,16,5,21,40,21,9,70,223,50,343
3110920,3,0,3,18,7,4,29,153,12,194
3110921,4,0,4,31,18,3,52,361,72,485
3110922,0,0,0,32,11,0,43,247,23,313
3110923,23,0,23,27,18,9,54,253,7,314
3110924,5,0,5,44,21,3,68,201,29,298
3110925,6,4,10,13,9,0,22,186,39,247
3110926,5,0,8,26,24,0,50,280,54,384
3110927,0,0,0,31,12,3,46,110,6,162
3110928,6,6,12,27,37,0,64,355,58,477
3110929,0,0,0,58,37,3,98,367,32,497
3110930,0,0,0,43,19,0,62,235,10,307
3110931,0,0,0,24,19,0,43,231,5,279
3111001,6,0,6,17,17,0,34,159,38,231
3111002,4,0,4,51,11,0,62,242,39,343
3111003,0,0,0,29,14,0,43,653,86,782
3111004,0,0,0,28,6,3,37,270,29,336
3111005,0,0,0,47,34,0,81,643,60,784
3111006,0,0,0,10,0,0,10,163,13,186
3111007,6,3,9,65,24,0,89,527,126,742
3111008,6,3,9,64,26,4,94,301,45,440
3111009,3,0,3,35,25,0,60,252,67,379
3111010,0,0,0,35,36,0,71,238,55,364
3111011,6,3,9,40,28,0,68,319,66,453
3111101,3,0,3,20,3,0,23,197,48,268
3111102,0,0,0,52,9,0,61,359,49,469
3111103,0,0,0,15,3,0,18,304,34,356
3111104,0,0,0,9,9,0,18,148,27,193
3111105,0,0,0,37,3,0,40,360,60,460
3111106,0,0,0,18,12,0,30,338,70,438
3111107,0,0,0,41,19,0,60,402,76,538
3111108,3,0,3,38,21,0,59,252,39,350
3111109,6,0,6,51,26,0,77,382,57,516
3111110,0,0,0,27,27,0,54,364,97,515
3111111,0,0,0,22,15,3,40,227,33,300
3111112,3,0,3,16,13,0,29,220,53,302
3111113,6,3,9,28,21,0,49,325,178,552
3111201,5,0,5,85,32,6,123,539,77,739
3111202,0,3,3,19,9,0,28,230,27,285
3111203,3,3,6,26,6,0,32,271,20,323
3111204,6,0,6,35,25,0,60,273,21,354
3111205,17,6,23,15,13,0,28,230,38,296
3111206,13,0,13,36,18,0,54,282,27,363
3111207,3,0,3,33,21,3,57,151,16,224
3111208,3,0,3,52,19,3,74,194,22,290
3111209,0,0,0,48,21,0,69,252,20,341
3111210,6,3,9,43,33,6,82,222,40,344
3111211,0,5,5,63,27,7,97,263,53,413
3111212,7,0,7,77,20,4,101,329,26,456
3111213,4,0,4,43,16,3,62,185,21,268
3111214,3,0,3,98,64,6,168,793,148,1109
3111215,5,0,5,52,29,3,84,258,38,380
3111216,0,6,6,68,35,0,103,238,25,366
3111217,0,0,0,43,18,0,61,301,23,385
3111218,3,0,3,33,12,0,45,134,18,197
3111301,3,0,3,77,15,4,96,179,12,287
3111302,8,0,8,93,24,12,129,295,23,447
3111303,6,0,6,74,22,0,96,179,0,275
3111304,3,6,9,54,10,0,64,236,26,326
3111305,6,0,6,50,13,9,72,155,16,243
3111306,4,0,4,106,18,12,136,264,12,412
3111307,4,0,4,87,30,4,121,226,23,370
3111308,0,3,3,54,18,3,75,141,17,233
3111309,0,0,0,56,17,0,73,136,3,212
3111310,3,0,3,49,14,3,66,225,12,303
3111401,45,3,48,47,16,0,63,250,21,334
3111402,3,3,6,90,17,6,113,198,20,331
3111403,6,3,9,108,14,0,122,203,24,349
3111404,6,5,11,97,30,4,131,222,8,361
3111405,0,4,4,101,24,0,125,146,22,293
3111406,0,0,0,87,18,0,105,194,27,326
3111407,6,3,9,70,13,9,92,219,21,332
3111408,5,0,5,82,15,3,100,207,27,334
3111409,0,0,0,134,22,3,159,315,16,490
3111410,3,0,3,76,43,0,119,409,61,589
3111411,3,0,3,49,24,3,76,260,28,364
3111412,3,0,3,81,23,0,104,243,13,360
3111413,0,0,0,81,6,3,90,179,21,290
3111501,3,0,3,21,29,0,50,188,32,270
3111502,3,0,3,49,13,0,62,261,63,386
3111503,0,0,0,64,22,4,90,264,23,377
3111504,5,0,5,39,19,6,64,303,51,418
3111505,3,0,3,47,23,0,70,310,40,420
3111506,3,6,9,51,9,0,60,179,23,262
3111507,3,0,3,85,19,0,104,332,48,484
3111508,0,0,0,39,21,3,63,210,93,366
3111509,7,0,7,45,21,0,66,344,65,475
3111510,4,0,4,61,26,5,92,249,28,369
3111511,3,0,3,33,15,0,48,209,25,282
3111512,6,0,6,36,28,3,67,333,34,434
3111513,0,0,0,46,21,0,67,271,28,366
3111601,3,6,9,59,19,0,78,133,12,223
3111602,6,0,6,80,18,8,106,181,16,303
3111603,0,0,0,50,4,6,60,92,7,159
3111604,3,0,7,97,21,9,127,241,30,398
3111605,0,0,0,55,12,0,67,211,13,291
3111606,5,3,8,70,27,3,100,265,66,431
3111607,4,0,4,125,18,7,150,223,14,387
3111608,6,0,6,95,26,0,121,373,121,615
3111609,4,0,4,34,7,6,47,123,19,189
3111610,4,0,4,75,15,3,93,277,36,406
3111611,0,0,0,99,28,9,136,270,25,431
3111701,3,6,9,59,9,0,68,165,18,251
3111702,6,0,6,55,15,3,73,116,22,211
3111703,0,0,0,47,9,0,56,108,12,176
3111704,10,0,10,56,24,0,80,228,18,326
3111705,8,0,8,56,39,0,95,392,22,509
3111706,4,0,4,43,25,0,68,177,12,257
3111707,3,3,6,57,22,0,79,349,33,461
3111708,0,0,0,0,0,0,0,0,0,0
3111709,3,3,6,50,8,6,64,156,9,229
3111710,3,0,3,38,24,3,65,278,28,371
3111711,0,0,0,36,9,3,48,232,31,311
3111712,3,0,3,73,23,0,96,168,21,285
3111713,3,0,3,53,15,0,68,123,16,207
3111714,0,3,3,70,34,9,113,251,28,392
3111715,0,0,0,132,20,7,159,285,23,467
3111716,8,5,13,112,40,9,161,320,31,512
3111717,6,0,6,64,24,9,97,222,9,328
3111718,9,0,9,86,24,5,115,195,12,322
3111719,0,0,0,78,23,4,105,295,19,419
3111720,4,0,4,91,22,8,121,205,21,347
3111721,6,3,9,69,19,0,88,145,15,248
3111722,0,0,0,0,0,0,0,0,0,0
3111723,4,0,4,26,26,0,52,227,9,288
3111724,8,0,8,30,9,0,39,194,12,245
3111725,3,3,12,27,16,0,43,268,20,331
3111726,3,0,3,60,10,0,70,126,6,202
3111727,5,4,9,69,15,3,87,300,20,407
3111728,4,0,4,50,12,0,62,188,16,266
3111729,0,0,0,0,0,0,0,0,0,0
3111730,3,0,3,33,19,4,56,192,3,251
3111731,3,0,3,42,12,3,57,237,17,311
3111732,0,3,3,54,19,0,73,296,30,399
3111733,6,3,9,40,19,0,59,188,26,273
3111801,0,0,0,20,10,0,30,95,4,129
3111802,0,0,0,38,9,3,50,126,0,176
3111803,6,0,6,111,35,5,151,236,22,409
3111804,3,0,3,110,21,4,135,185,6,326
3111805,0,0,0,102,21,4,127,163,4,294
3111806,6,6,12,119,33,6,158,267,21,446
3111807,0,3,3,77,24,3,104,156,15,275
3111808,0,0,0,53,12,0,65,186,21,272
3111809,4,3,7,104,29,9,142,233,43,418
3111810,3,0,3,83,16,3,102,238,18,358
3111811,3,0,3,102,24,0,126,285,15,426
3111812,3,3,6,79,20,3,102,229,22,353
3111813,0,0,0,26,34,0,60,140,12,212
3111814,3,0,3,58,26,8,92,355,34,481
3111815,3,0,3,37,21,0,58,137,31,226
3111901,0,0,0,0,0,0,0,0,0,0
3111902,0,3,3,33,8,0,41,108,15,164
3111903,0,0,0,36,21,0,57,187,17,261
3111904,28,7,38,15,9,0,24,235,18,277
3111905,0,0,3,47,18,0,65,211,30,306
3111906,3,3,6,51,7,6,64,170,6,240
3111907,10,0,10,51,18,3,72,312,43,427
3111908,6,3,9,40,22,4,66,430,46,542
3112001,6,3,9,91,24,6,121,136,6,263
3112002,6,3,9,43,14,3,60,175,9,244
3112003,3,0,3,76,15,0,91,140,0,231
3112004,0,0,0,45,22,3,70,294,8,372
3112005,3,0,3,95,14,6,115,191,13,319
3112006,3,0,3,47,16,0,63,349,28,440
3112007,3,3,6,69,26,3,98,393,28,519
3112008,0,0,0,17,10,0,27,188,21,236
3112009,6,3,12,31,19,0,50,263,25,338
3112010,9,8,17,76,33,6,115,171,17,303
3112011,7,4,11,95,31,4,130,244,30,404
3112012,0,3,3,96,14,7,117,175,3,295
3112013,4,3,7,44,18,3,65,121,12,198
3112014,0,0,0,0,0,0,0,0,0,0
3112015,3,0,3,57,34,0,91,130,5,226
3112016,0,0,0,88,24,9,121,159,12,292
3112101,4,0,4,60,30,0,90,173,11,274
3112102,4,0,4,90,40,0,130,219,15,364
3112103,0,4,4,82,41,3,126,196,16,338
3112104,14,3,17,79,33,7,119,300,27,446
3112105,13,3,16,31,16,0,47,345,43,435
3112106,4,0,4,54,24,0,78,323,32,433
3112107,6,3,9,81,22,0,103,388,34,525
3112108,4,3,7,64,18,3,85,148,21,254
3112109,5,0,5,43,27,0,70,373,26,469
3112110,9,0,9,51,16,3,70,264,37,371
3112111,6,0,6,116,37,10,163,282,18,463
3112112,0,0,0,0,0,0,0,0,0,0
3112201,10,3,13,52,39,0,91,358,31,480
3112202,0,0,0,59,24,0,83,356,42,481
3112203,18,0,18,60,16,3,79,370,21,470
3112204,3,3,6,69,22,0,91,214,22,327
3112205,7,0,7,57,27,5,89,178,8,275
3112206,0,0,0,51,23,3,77,207,31,315
3112207,6,3,13,91,28,0,119,283,27,429
3112208,5,0,5,81,10,0,91,128,18,237
3112209,3,0,3,19,9,0,28,156,19,203
3112210,3,0,3,44,12,6,62,92,11,165
3112211,3,0,3,88,27,9,124,229,3,356
3112212,7,3,10,57,20,6,83,234,19,336
3112213,3,0,3,53,18,3,74,295,15,384
3112214,0,0,0,73,15,0,88,346,16,450
3112215,3,3,6,64,23,3,90,409,25,524
3112216,6,3,9,63,44,9,116,271,21,408
3112217,16,0,16,63,26,0,89,250,21,360
3112218,0,0,0,37,9,0,46,221,28,295
3112219,12,3,18,46,26,0,72,273,47,392
3112220,4,3,7,29,11,0,40,215,21,276
3112221,7,3,10,33,15,0,48,150,12,210
3112222,11,0,11,73,27,0,100,230,12,342
3112223,0,0,0,60,22,0,82,333,37,452
3112224,6,0,6,68,17,3,88,224,23,335
3112301,7,0,7,110,21,9,140,240,22,402
3112302,29,3,32,131,16,7,154,240,13,407
3112303,0,3,3,91,15,3,109,139,19,267
3112304,0,0,0,35,28,4,67,112,3,182
3112305,3,0,3,63,15,16,94,179,0,273
3112306,0,0,0,84,21,8,113,216,18,347
3112307,9,3,12,105,26,6,137,236,12,385
3112308,7,0,7,110,22,10,142,175,5,322
3112309,0,0,0,138,23,6,167,144,21,332
3112310,3,0,3,71,15,4,90,125,0,215
3112401,0,0,0,38,5,0,43,134,9,186
3112402,6,0,6,66,28,3,97,300,48,445
3112403,0,0,0,47,17,0,64,198,14,276
3112404,7,3,10,25,60,3,88,269,44,401
3112405,0,8,8,34,38,0,72,300,51,423
3112406,25,0,25,57,12,3,72,361,17,450
3112407,8,3,11,72,27,3,102,372,42,516
3112408,9,3,12,42,25,0,67,271,35,373
3112409,13,0,13,55,31,0,86,262,24,372
3112410,6,3,9,52,19,0,71,87,6,164
3112411,0,0,0,80,20,6,106,203,9,318
3112412,4,0,4,43,14,3,60,102,10,172
3112501,4,0,4,41,8,3,52,135,16,203
3112502,13,3,16,91,27,3,121,310,41,472
3112503,3,4,7,37,15,0,52,130,28,210
3112504,3,0,3,75,24,0,99,205,24,328
3112505,0,0,0,0,3,0,3,3,3,9
3112506,7,3,10,33,19,0,52,173,27,252
3112507,3,0,3,59,19,0,78,167,23,268
3112508,15,0,15,77,37,0,114,277,9,400
3112509,3,0,3,45,13,3,61,133,19,213
3112510,4,6,10,62,19,0,81,119,24,224
3112511,8,0,8,88,18,5,111,198,4,313
3112512,3,0,3,55,24,0,79,192,12,283
3112513,7,0,7,104,42,3,149,235,30,414
3112601,3,0,3,38,11,9,58,172,12,242
3112602,3,3,6,80,24,6,110,356,37,503
3112603,3,0,3,39,22,0,61,219,19,299
3112604,3,3,9,45,27,6,78,287,16,381
3112605,6,0,6,88,22,3,113,343,18,474
3112606,6,0,6,62,7,6,75,191,16,282
3112607,0,0,0,25,6,0,31,222,6,259
3112608,3,3,6,53,32,3,88,317,25,430
3112609,0,0,0,37,5,0,42,212,42,296
3112610,3,0,3,62,31,0,93,293,24,410
3112611,9,3,12,47,16,3,66,355,12,433
3112612,7,3,10,65,18,3,86,231,15,332
3112613,3,0,3,52,14,6,72,281,24,377
3112614,4,0,4,57,8,7,72,356,34,462
3112615,55,3,58,164,39,4,207,1364,147,1718
3112616,0,0,0,0,0,0,0,0,0,0
3112701,5,4,9,130,22,11,163,301,19,483
3112702,4,0,4,78,25,7,110,215,6,331
3112703,4,0,4,105,39,6,150,237,40,427
3112704,5,0,5,56,18,6,80,419,24,523
3112705,0,4,4,25,21,3,49,222,11,282
3112706,6,3,9,66,34,0,100,348,25,473
3112707,40,9,49,29,9,6,44,163,15,222
3112708,3,0,3,68,14,0,82,214,12,308
3112709,0,0,0,40,21,3,64,230,10,304
3112710,6,3,9,78,24,12,114,232,12,358
3112801,0,0,0,29,24,0,53,374,72,499
3112802,0,0,0,31,29,0,60,419,91,570
3112803,0,0,0,27,30,0,57,455,56,568
3112804,0,0,0,20,11,0,31,247,38,316
3112805,0,0,0,18,24,0,42,333,66,441
3112806,3,0,3,39,18,0,57,298,31,386
3112807,6,0,6,23,39,0,62,266,12,340
3112808,3,0,3,23,37,0,60,369,15,444
3112809,0,0,0,30,20,0,50,283,36,369
3112810,0,0,0,0,0,0,0,12,0,12
3112811,0,0,0,6,8,0,14,122,6,142
3112812,0,0,0,26,13,0,39,359,25,423
3112813,0,0,0,48,10,3,61,223,12,296
3112814,5,0,5,54,24,0,78,157,21,256
3112815,0,0,0,47,15,0,62,285,46,393
3112816,0,0,0,12,13,6,31,84,18,133
3112817,3,0,3,18,9,0,27,142,13,182
3112818,3,0,3,39,29,0,68,487,55,610
3112819,3,4,7,35,34,0,69,378,29,476
3112901,12,0,12,119,31,3,153,269,18,440
3112902,0,0,0,81,20,3,104,180,13,297
3112903,3,0,3,52,9,0,61,180,12,253
3112904,0,0,0,76,19,0,95,188,16,299
3112905,6,0,6,66,16,4,86,145,13,244
3112906,6,0,6,113,25,6,144,273,14,431
3112907,0,0,0,59,16,0,75,198,3,276
3112908,0,3,3,100,22,8,130,193,29,352
3112909,3,0,3,51,9,3,63,185,9,257
3112910,3,0,3,52,16,0,68,80,0,148
3113001,4,0,4,39,20,3,62,201,9,272
3113002,3,0,3,17,4,4,25,249,19,293
3113003,4,0,4,35,23,0,58,212,5,275
3113004,0,0,0,97,24,11,132,363,28,523
3113005,0,0,0,35,21,3,59,199,9,267
3113006,0,0,0,56,18,0,74,185,17,276
3113007,5,0,5,50,13,0,63,280,21,364
3113008,0,0,0,40,16,0,56,260,18,334
3113009,0,0,0,59,19,0,78,209,9,296
3113010,6,0,6,99,18,11,128,220,12,360
3113011,6,3,9,87,21,6,114,153,15,282
3113012,0,0,0,78,14,5,97,101,12,210
3113013,4,0,4,81,28,4,113,308,21,442
3113014,29,4,33,91,20,0,111,233,10,354
3113015,5,3,8,78,16,7,101,279,24,404
3113016,3,0,3,95,27,0,122,288,12,422
3113101,53,0,53,110,21,6,137,294,12,443
3113102,0,0,0,74,14,6,94,169,10,273
3113103,4,0,4,102,23,0,125,241,12,378
3113104,3,0,3,66,21,0,87,185,9,281
3113105,3,0,3,43,22,3,68,256,30,354
3113106,6,0,6,48,12,6,66,242,19,327
3113107,6,0,6,48,8,0,56,255,9,320
3113108,0,3,3,36,6,0,42,128,17,187
3113109,3,0,3,26,14,0,40,184,21,245
3113110,0,0,0,83,16,6,105,264,30,399
3113111,0,0,0,23,15,0,38,178,26,242
3113112,3,0,3,39,13,0,52,241,40,333
3113113,24,6,30,58,22,3,83,320,44,447
3113114,11,0,11,42,19,3,64,338,41,443
3113115,10,0,10,36,4,0,40,252,29,321
3113116,0,0,0,27,7,0,34,152,4,190
3113117,4,0,4,57,22,0,79,194,29,302
3113118,3,3,6,112,20,0,132,263,32,427
3113119,5,0,5,45,6,0,51,165,4,220
3113120,3,0,3,127,39,0,166,238,9,413
3113121,3,0,3,83,25,9,117,182,12,311
3113122,3,3,6,99,16,4,119,239,49,407
3113201,5,0,5,98,29,6,133,206,15,354
3113202,7,0,7,42,22,4,68,166,10,244
3113203,0,0,0,58,16,3,77,106,3,186
3113204,4,0,4,99,31,3,133,256,13,402
3113205,7,0,7,90,15,0,105,156,18,279
3113206,7,0,7,79,17,3,99,147,12,258
3113207,0,3,3,81,33,3,117,270,20,407
3113208,14,0,14,110,45,7,162,404,10,576
3113209,3,0,3,97,19,0,116,187,8,311
3113210,6,0,6,44,18,6,68,174,23,265
3113211,6,0,6,90,29,14,133,204,12,349
3113212,0,3,3,77,24,3,104,153,19,276
3113213,6,0,6,87,8,3,98,146,16,260
3113214,4,0,4,79,15,7,101,175,18,294
3113215,6,0,6,59,18,4,81,228,0,309
3113216,11,0,11,52,20,3,75,162,11,248
3113217,3,0,3,55,15,3,73,160,9,242
3113218,8,0,8,42,28,0,70,306,22,398
3113219,8,0,8,75,28,3,106,197,9,312
3113220,0,0,0,99,16,9,124,181,6,311
3113221,3,0,3,52,15,4,71,191,7,269
3113222,3,4,7,41,24,3,68,156,51,275
3113223,3,0,3,56,20,13,89,154,9,252
3113224,12,5,17,107,31,3,141,192,20,353
3113225,7,8,15,140,30,6,176,228,19,423
3113226,11,0,11,117,25,0,142,272,15,429
3113227,6,3,9,130,30,11,171,254,23,448
3113228,3,3,6,76,21,3,100,229,17,346
3113229,6,0,6,34,26,3,63,316,16,395
3113230,3,0,3,79,27,6,112,205,19,336
3113231,3,0,3,39,27,0,66,233,30,329
3113301,5,0,5,73,20,9,102,252,16,370
3113302,0,0,0,41,12,0,53,139,6,198
3113303,0,0,0,61,32,0,93,212,9,314
3113304,6,0,6,115,22,8,145,318,11,474
3113305,4,0,4,75,24,3,102,196,9,307
3113306,0,0,0,23,21,0,44,206,15,265
3113307,3,0,3,14,19,0,33,287,43,363
3113308,3,0,3,32,12,0,44,313,25,382
3113309,6,0,6,25,28,0,53,332,49,434
3113310,4,0,4,38,13,0,51,367,26,444
3113311,0,3,3,29,22,0,51,373,28,452
3113312,0,0,0,36,15,3,54,256,12,322
3113313,0,0,0,76,12,6,94,253,10,357
3113401,8,3,11,77,17,11,105,183,12,300
3113402,6,3,9,80,6,6,92,176,31,299
3113403,0,0,0,55,9,9,73,126,21,220
3113404,7,0,7,93,19,6,118,205,9,332
3113405,5,0,5,96,24,6,126,161,7,294
3113406,6,6,12,73,12,3,88,193,15,296
3113407,6,0,9,88,29,3,120,176,12,308
3113408,0,0,0,67,32,11,110,288,30,428
3113409,6,6,15,95,27,4,126,319,21,466
3113410,3,3,6,121,44,13,178,297,18,493
3113411,0,0,0,76,20,8,104,237,9,350
3113412,7,0,7,74,11,9,94,167,18,279
3113413,13,3,16,84,28,6,118,201,21,340
3113414,4,0,4,81,9,9,99,151,8,258
3113415,7,0,7,73,24,0,97,230,12,339
3113416,4,3,7,39,13,12,64,129,10,203
3113417,3,5,8,70,6,4,80,193,18,291
3113418,0,0,0,82,17,4,103,213,9,325
3113419,24,6,30,113,18,10,141,255,27,423
3113420,6,0,6,86,36,0,122,299,22,443
3113421,4,0,4,89,37,8,134,256,4,394
3113422,0,0,0,52,9,3,64,110,9,183
3113501,0,4,4,29,10,0,39,183,11,233
3113502,6,0,6,63,17,0,80,186,24,290
3113503,3,3,6,46,19,3,68,258,25,351
3113504,0,5,5,38,15,3,56,228,20,304
3113505,0,0,0,28,16,6,50,212,11,273
3113506,5,3,8,37,15,6,58,203,27,288
3113507,6,0,6,69,29,6,104,251,13,368
3113508,0,0,0,53,12,3,68,257,19,344
3113509,0,0,3,31,26,0,57,218,3,278
3113510,3,0,3,58,28,0,86,302,21,409
3113511,3,0,3,70,13,3,86,291,19,396
3113512,4,0,4,57,13,3,73,209,19,301
3113513,0,0,0,40,13,0,53,185,15,253
3113514,7,0,7,72,18,6,96,258,33,387
3113515,0,0,0,46,27,0,73,456,38,567
3113516,0,0,0,38,9,3,50,193,8,251
3113517,6,0,6,67,28,0,95,286,15,396
3113518,0,0,0,126,35,4,165,286,18,469
3113519,3,0,3,45,12,0,57,181,8,246
3113520,3,3,6,66,34,3,103,274,74,451
3113521,0,0,0,83,28,0,111,265,15,391
3113522,3,3,6,52,11,0,63,254,27,344
3113523,26,0,26,79,27,4,110,361,31,502
3113524,3,0,3,25,10,3,38,131,15,184
3113525,6,0,6,22,20,0,42,276,23,341
3113601,0,0,0,48,8,7,63,125,4,192
3113602,0,0,0,55,15,3,73,138,52,263
3113603,4,0,4,93,21,7,121,243,15,379
3113604,3,3,6,57,9,0,66,157,66,289
3113605,0,0,0,31,13,6,50,176,11,237
3113606,4,0,4,69,21,3,93,314,12,419
3113607,3,0,3,95,28,6,129,297,27,453
3113608,6,0,6,83,33,6,122,359,30,511
3113609,0,0,0,57,18,6,81,293,15,389
3113610,0,0,0,45,9,0,54,174,3,231
3113611,3,0,3,36,28,6,70,248,6,324
3113612,4,0,4,27,11,8,46,243,27,316
3113613,4,0,4,60,33,6,99,294,26,419
3113614,4,0,4,28,9,0,37,214,44,295
3113615,0,0,0,0,0,0,0,0,0,0
3113701,0,3,3,28,17,0,45,207,15,267
3113702,0,0,0,29,18,4,51,443,57,551
3113703,6,3,9,53,19,6,78,145,43,266
3113704,0,0,0,46,18,0,64,117,9,190
3113705,8,6,14,51,30,3,84,183,53,320
3113706,11,4,15,83,28,0,111,182,36,329
3113707,4,0,4,62,15,13,90,322,21,433
3113708,10,0,10,27,0,4,31,211,14,256
3113709,0,0,0,79,18,7,104,356,16,476
3113710,0,0,0,15,6,0,21,203,0,224
3113711,0,0,0,34,21,3,58,304,15,377
3113712,11,5,16,12,24,4,40,325,34,399
3113713,0,0,0,23,30,0,53,361,29,443
3113714,0,0,0,21,27,0,48,385,22,455
3113715,0,0,0,45,14,0,59,272,17,348
3113716,0,0,0,31,6,0,37,238,21,296
3113717,3,0,3,83,24,3,110,222,18,350
3113718,3,0,3,80,15,9,104,288,43,435
3113719,0,0,0,43,24,0,67,425,30,522
3113720,6,0,6,69,19,4,92,284,11,387
3113721,3,0,3,35,24,3,62,353,35,450
3113722,0,0,0,23,17,0,40,292,6,338
3113723,6,0,9,31,29,0,60,344,34,438
3113724,0,0,0,47,20,0,67,376,29,472
3113725,0,0,0,16,7,0,23,265,14,302
3113801,0,0,0,90,18,0,108,186,14,308
3113802,4,0,4,91,23,0,114,165,3,282
3113803,3,0,3,107,19,17,143,216,10,369
3113804,0,0,0,63,13,4,80,140,12,232
3113805,0,0,0,87,16,13,116,170,18,304
3113806,0,0,0,41,14,0,55,89,16,160
3113807,0,0,0,63,23,3,89,122,6,217
3113808,0,0,0,38,3,8,49,106,9,164
3113809,3,0,3,74,6,5,85,115,4,204
3113810,0,0,0,101,37,8,146,195,15,356
3113811,0,0,0,54,3,9,66,76,6,148
3113812,0,4,4,60,22,7,89,230,26,345
3113813,0,0,0,182,34,0,216,377,24,617
3113814,3,0,3,60,19,8,87,109,12,208
3113901,0,0,0,82,27,0,109,246,15,370
3113902,3,3,6,45,35,3,83,363,81,527
3113903,4,0,4,43,30,0,73,302,62,437
3113904,3,0,3,71,10,5,86,191,15,292
3113905,3,0,3,88,20,3,111,183,15,309
3113906,5,3,8,100,30,7,137,220,24,381
3113907,7,0,7,124,22,9,155,244,16,415
3113908,0,0,0,144,47,4,195,407,61,663
3113909,3,3,6,28,18,0,46,137,25,208
3113910,4,0,4,96,36,7,139,370,33,542
3113911,5,0,5,103,28,0,131,189,20,340
3113912,0,0,0,130,30,3,163,310,28,501
3113913,4,0,4,54,23,3,80,243,14,337
3113914,6,0,6,103,35,0,138,250,28,416
3113915,0,0,0,167,33,8,208,311,26,545
3113916,0,0,0,54,7,3,64,139,13,216
3113917,0,0,0,78,25,8,111,224,13,348
3113918,0,0,0,21,3,0,24,60,0,84
3113919,0,0,0,88,20,3,111,205,18,334
3113920,7,0,7,65,13,0,78,214,15,307
3113921,3,0,3,70,16,3,89,193,12,294
3113922,0,0,0,3,0,0,3,9,3,15
3114001,3,0,3,80,31,6,117,256,27,400
3114002,0,0,0,42,22,9,73,150,17,240
3114003,6,0,6,97,26,5,128,211,10,349
3114004,0,0,0,3,0,0,3,6,12,21
3114005,0,0,0,46,10,0,56,130,17,203
3114006,9,0,9,84,33,0,117,322,39,478
3114007,0,0,0,115,24,15,154,261,9,424
3114008,4,0,4,91,28,6,125,305,34,464
3114009,0,0,0,76,30,4,110,170,15,295
3114010,0,0,0,0,0,0,0,0,0,0
3114101,0,0,0,71,22,4,97,175,21,293
3114102,0,0,0,75,22,4,101,136,6,243
3114103,0,0,0,96,17,5,118,116,5,239
3114104,0,0,0,53,5,4,62,105,5,172
3114105,0,0,0,69,7,3,79,100,10,189
3114106,0,0,0,61,12,0,73,107,9,189
3114107,0,0,0,37,18,3,58,110,9,177
3114108,3,0,3,66,24,0,90,169,16,275
3114109,4,0,4,165,18,7,190,179,9,378
3114110,0,0,0,162,32,12,206,203,21,430
3114111,3,0,3,152,33,9,194,332,10,536
3114112,0,0,0,44,7,5,56,98,14,168
3114113,0,0,0,166,25,7,198,257,14,469
3114114,0,0,0,105,23,10,138,205,0,343
3114115,0,0,0,59,23,3,85,115,12,212
3114116,0,0,0,229,33,18,280,260,27,567
3114117,3,3,6,57,9,0,66,181,23,270
3114118,0,0,0,63,24,0,87,210,17,314
3114119,0,0,0,60,10,0,70,125,7,202
3114120,0,0,0,0,0,0,0,0,0,0
3114121,0,0,0,48,10,0,58,67,13,138
3114122,29,66,95,39,16,0,55,195,145,395
3114123,3,0,3,131,23,16,170,230,17,417
3114124,0,0,0,82,19,10,111,140,13,264
3114125,0,0,0,31,12,0,43,87,9,139
3114126,0,0,0,117,15,10,142,151,10,303
3114127,0,0,0,38,12,0,50,123,0,173
3114128,3,0,3,56,17,12,85,158,21,264
3114129,0,0,0,95,27,3,125,244,16,385
3114130,0,0,0,3,0,0,3,0,0,3
3114131,0,0,0,73,33,3,109,209,41,359
3114201,0,0,0,96,24,3,123,280,41,444
3114202,3,0,3,29,10,3,42,100,12,154
3114203,3,0,3,127,26,9,162,290,64,516
3114204,0,0,0,91,43,15,149,354,48,551
3114205,3,0,3,40,21,4,65,142,0,207
3114206,0,3,3,79,21,0,100,239,33,372
3114207,3,0,3,45,22,3,70,168,20,258
3114208,0,0,0,81,33,15,129,203,32,364
3114209,3,0,3,54,18,5,77,260,44,381
3114210,0,0,0,37,15,0,52,174,29,255
3114211,5,0,5,252,49,13,314,529,71,914
3114212,10,7,17,38,8,0,46,153,22,221
3114213,6,0,6,38,15,0,53,123,12,188
3114214,0,0,0,70,22,0,92,306,19,417
3114215,0,0,0,67,14,6,87,258,11,356
3114216,0,0,4,111,32,6,149,342,24,515
3114217,0,0,0,5,0,0,5,14,3,22
3114218,0,0,0,139,21,0,160,216,18,394
3114219,0,0,0,22,0,0,22,12,3,37
3114220,6,0,6,86,26,3,115,366,35,516
3114221,0,3,3,44,17,0,61,190,23,274
3114222,0,0,0,0,0,0,0,0,0,0
3114223,0,3,3,38,12,6,56,178,30,264
3114224,4,0,4,58,16,3,77,186,15,278
3114225,0,0,0,79,34,6,119,225,65,409
3114226,0,0,0,42,17,0,59,148,60,267
3114227,0,0,0,40,9,3,52,65,14,131
3114301,0,0,0,0,0,0,0,0,0,0
3114302,0,0,0,0,0,0,0,0,0,0
3114303,0,0,0,57,33,0,90,248,31,369
3114304,3,0,3,58,16,0,74,228,40,342
3114305,0,0,0,44,14,6,64,156,39,259
3114306,0,0,0,32,6,3,41,128,12,181
3114307,6,0,6,65,21,0,86,221,38,345
3114308,3,0,3,74,27,7,108,150,28,286
3114309,8,3,11,55,19,4,78,250,31,359
3114310,3,0,3,50,21,6,77,132,15,224
3114311,0,4,4,42,17,3,62,179,14,255
3114312,0,0,0,27,3,0,30,174,23,227
3114313,0,0,0,0,0,0,0,0,0,0
3114314,4,0,4,38,11,0,49,205,29,283
3114315,0,0,0,76,32,3,111,240,30,381
3114316,3,0,3,70,16,3,89,202,33,324
3114317,6,0,6,94,31,3,128,293,36,457
3114318,0,0,0,31,12,3,46,238,34,318
3114319,0,0,0,68,29,0,97,239,16,352
3114401,3,0,3,68,38,7,113,207,33,353
3114402,3,0,3,82,33,0,115,195,24,334
3114403,0,0,0,67,30,3,100,157,35,292
3114404,0,0,0,73,25,3,101,153,27,281
3114405,0,0,0,111,26,10,147,216,59,422
3114406,0,0,0,92,14,0,106,138,19,263
3114407,0,0,0,128,37,0,165,204,27,396
3114408,3,0,3,69,4,6,79,162,22,263
3114409,0,0,0,109,16,3,128,134,24,286
3114410,0,0,0,60,15,3,78,162,20,260
3114411,3,0,3,33,18,7,58,96,17,171
3114412,0,0,0,55,13,0,68,130,21,219
3114413,0,0,0,167,43,9,219,211,25,455
3114414,0,0,0,44,10,0,54,65,17,136
3114415,0,0,0,102,20,0,122,153,45,320
3114416,0,0,0,75,10,0,85,117,39,241
3114417,0,0,0,50,19,3,72,68,4,144
3114418,4,0,4,105,18,0,123,137,18,278
3114501,0,0,0,41,15,6,62,267,68,397
3114502,3,0,3,80,24,3,107,379,89,575
3114503,0,3,3,21,3,0,24,152,173,349
3114504,3,0,3,36,12,3,51,343,57,451
3114505,7,4,14,50,32,0,82,501,187,770
3114506,6,0,6,70,20,3,93,574,130,797
3114507,6,0,6,15,4,0,19,142,39,200
3114508,0,0,0,29,10,3,42,228,59,329
3114509,0,5,5,32,16,0,48,253,86,387
3114510,0,0,0,19,15,0,34,192,75,301
3114511,0,0,0,48,16,0,64,268,44,376
3114512,4,0,4,42,9,8,59,217,22,298
3114513,0,0,3,86,25,0,111,451,68,630
3114514,3,0,3,51,26,3,80,412,112,604
3114515,4,0,4,21,12,0,33,155,45,233
3114516,0,3,3,15,15,0,30,221,42,293
3114517,0,0,0,15,9,0,24,117,33,174
3114518,0,0,0,64,22,6,92,323,108,523
3114519,0,3,3,37,18,3,58,386,161,605
3114520,6,0,6,18,6,0,24,202,41,267
3114521,3,4,7,32,15,0,47,166,50,263
3114601,5,3,8,88,48,12,148,260,30,438
3114602,6,0,6,92,30,10,132,236,12,380
3114603,60,9,69,61,35,3,99,475,110,684
3114604,3,0,3,53,25,5,83,194,49,326
3114605,24,4,28,68,20,5,93,242,33,368
3114606,4,0,4,101,36,9,146,249,36,431
3114607,4,0,4,75,21,0,96,229,24,349
3114608,3,0,3,54,27,0,81,201,41,323
3114609,6,0,6,49,12,6,67,164,11,242
3114610,4,0,4,84,39,4,127,236,22,385
3114611,0,0,0,46,18,0,64,161,6,231
3114612,3,3,6,34,31,0,65,130,10,205
3114613,6,3,9,85,29,10,124,191,24,339
3114614,3,3,6,46,33,6,85,236,24,345
3114615,7,0,10,130,49,3,182,320,35,537
3114616,3,0,3,95,40,4,139,293,25,457
3114617,5,3,8,77,38,3,118,256,22,396
3114701,0,0,0,109,31,11,151,325,68,544
3114702,0,0,0,52,26,0,78,197,50,325
3114703,3,0,3,65,28,0,93,162,54,309
3114704,3,0,3,34,18,0,52,104,6,162
3114705,3,0,3,37,15,0,52,112,9,173
3114706,3,0,3,73,21,0,94,114,16,224
3114707,0,0,0,121,26,12,159,166,21,346
3114708,0,0,0,65,25,0,90,143,23,256
3114709,0,0,0,61,9,3,73,144,25,242
3114710,0,0,0,57,9,3,69,117,23,209
3114711,0,0,0,43,11,0,54,112,34,200
3114712,4,0,4,63,18,6,87,166,26,279
3114713,4,0,4,74,31,9,114,194,29,337
3114714,0,0,0,152,39,6,197,270,34,501
3114715,0,0,0,72,24,9,105,135,13,253
3114716,0,3,3,92,25,8,125,162,44,331
3114717,3,0,3,251,62,11,324,302,53,679
3114718,0,0,0,218,45,8,271,315,46,632
3114719,6,0,6,60,26,0,86,178,23,287
3114720,3,0,3,47,13,6,66,111,31,208
3114721,0,0,0,101,29,3,133,201,33,367
3114722,0,0,0,28,10,6,44,72,7,123
3114801,0,0,0,27,4,0,31,92,15,138
3114802,6,3,9,74,38,9,121,238,38,397
3114803,0,0,0,12,9,0,21,64,3,88
3114804,0,0,0,79,23,6,108,172,42,322
3114805,0,0,0,86,28,0,114,192,30,336
3114806,4,0,8,75,23,0,98,166,22,286
3114807,0,0,0,51,11,6,68,149,16,233
3114808,0,0,0,61,20,4,85,80,12,177
3114809,0,0,0,99,9,7,115,171,21,307
3114810,0,3,3,120,20,7,147,157,34,338
3114811,0,3,3,53,3,0,56,73,24,153
3114812,11,3,14,49,25,3,77,154,30,261
3114813,4,0,4,54,23,8,85,175,10,270
3114814,9,3,12,29,11,0,40,141,28,209
3114815,34,10,44,53,33,4,90,292,47,429
3114816,3,0,3,33,15,7,55,106,9,170
3114817,6,3,9,66,26,6,98,169,26,293
3114818,3,0,3,45,21,0,66,114,5,185
3114819,6,0,6,50,14,3,67,238,12,317
3114820,3,0,3,40,21,10,71,129,24,224
3114821,0,0,0,32,14,0,46,81,11,138
3114822,0,0,0,166,16,16,198,268,34,500
3114823,0,0,0,71,25,6,102,184,22,308
3114901,6,0,6,92,45,6,143,270,23,436
3114902,5,0,5,87,19,6,112,245,18,375
3114903,0,0,0,120,23,0,143,141,6,290
3114904,3,0,3,73,20,0,93,130,6,229
3114905,0,0,0,26,7,0,33,77,7,117
3114906,0,0,0,70,13,6,89,239,35,363
3114907,3,0,3,109,49,6,164,280,27,471
3114908,0,3,3,55,19,3,77,191,34,302
3114909,0,0,0,0,0,0,0,0,0,0
3114910,4,0,4,52,14,0,66,141,24,231
3114911,3,0,3,41,20,3,64,152,10,226
3114912,0,0,0,14,6,0,20,58,5,83
3114913,4,0,4,85,24,12,121,181,27,329
3114914,3,0,3,59,27,0,86,123,41,250
3114915,0,0,0,52,19,13,84,218,34,336
3114916,0,0,0,38,19,0,57,101,12,170
3114917,3,0,3,65,16,0,81,161,16,258
3114918,6,0,6,156,18,10,184,251,27,462
3114919,8,0,8,77,36,3,116,292,36,444
3114920,3,0,3,52,22,3,77,208,35,320
3114921,3,0,3,66,17,0,83,185,28,296
3114922,3,0,3,60,17,4,81,156,29,266
3114923,0,0,0,80,19,3,102,187,25,314
3114924,3,3,6,79,36,3,118,224,76,418
3115001,0,0,0,0,0,0,0,0,0,0
3115101,0,0,0,36,19,6,61,136,40,237
3115102,0,0,0,65,31,9,105,272,26,403
3115103,0,0,0,47,21,3,71,195,33,299
3115104,0,0,0,35,15,3,53,180,37,270
3115105,0,0,0,81,27,3,111,256,55,422
3115106,0,0,0,63,29,4,96,192,33,321
3115107,0,0,0,39,4,0,43,112,17,172
3115108,3,0,3,43,18,5,66,153,13,232
3115109,4,0,4,58,52,0,110,221,26,357
3115110,3,0,3,25,39,4,68,107,11,186
3115111,0,0,0,73,15,4,92,268,81,441
3115112,3,0,3,40,26,3,69,178,38,285
3115113,0,0,0,26,15,8,49,112,7,168
3115114,4,0,4,27,6,3,36,161,40,237
3115115,0,0,0,68,23,0,91,210,57,358
3115201,7,0,7,33,9,0,42,164,40,246
3115202,0,0,0,63,22,3,88,213,89,390
3115203,6,0,6,35,13,3,51,178,20,249
3115204,0,0,0,37,12,0,49,157,85,291
3115205,15,3,18,30,18,9,57,176,110,343
3115206,3,0,3,14,5,0,19,170,37,226
3115207,3,0,6,71,28,0,99,249,57,405
3115208,3,0,3,26,14,0,40,117,24,181
3115209,8,0,8,36,11,6,53,137,31,221
3115210,0,0,0,43,15,0,58,131,22,211
3115211,0,0,0,53,34,3,90,264,25,379
3115212,8,0,8,43,22,0,65,154,10,229
3115213,6,3,9,50,36,5,91,233,33,357
3115214,11,0,11,68,44,3,115,229,22,366
3115301,0,0,0,102,24,0,126,220,26,372
3115302,0,0,0,94,14,0,108,283,15,406
3115303,3,0,3,75,31,0,106,213,21,340
3115304,3,0,3,85,27,6,118,166,22,306
3115305,3,0,3,90,27,0,117,271,9,397
3115306,0,0,0,133,41,6,180,297,22,499
3115307,0,0,0,0,0,0,0,0,0,0
3115308,0,0,0,55,16,0,71,156,21,248
3115309,4,0,4,104,17,12,133,171,17,321
3115310,0,0,0,102,38,3,143,217,31,391
3115311,0,0,0,74,14,0,88,114,15,217
3115312,0,0,0,92,25,0,117,255,26,398
3115313,3,0,3,54,12,6,72,146,23,241
3115314,0,0,0,90,24,0,114,164,23,301
3115315,3,0,3,56,24,4,84,162,55,301
3115316,0,0,0,125,22,9,156,276,52,484
3115317,0,0,0,56,29,3,88,87,14,189
3115318,0,0,0,60,15,3,78,147,7,232
3115319,0,0,0,91,24,0,115,189,12,316
3115401,3,0,3,25,3,0,28,151,54,233
3115402,6,3,9,57,23,6,86,391,105,582
3115403,0,0,0,48,15,0,63,285,75,423
3115404,0,0,0,27,13,0,40,189,55,284
3115405,6,0,6,11,0,0,11,192,15,218
3115406,3,0,3,35,21,0,56,99,34,189
3115407,6,0,6,52,21,0,73,159,27,259
3115408,0,0,0,26,0,0,26,191,36,253
3115409,139,12,151,23,6,0,29,352,43,424
3115410,0,5,5,113,30,6,149,580,167,896
3115411,5,0,5,52,20,3,75,202,59,336
3115412,3,0,6,51,33,0,84,233,86,403
3115413,6,0,6,31,18,0,49,171,48,268
3115414,0,0,0,28,13,0,41,150,47,238
3115415,7,0,7,52,23,3,78,248,48,374
3115501,6,0,6,42,26,4,72,279,61,412
3115502,0,0,0,26,12,3,41,85,18,144
3115503,0,0,0,56,29,0,85,197,23,305
3115504,0,0,0,103,27,8,138,208,42,388
3115505,0,0,0,69,20,3,92,147,22,261
3115506,5,0,5,32,15,0,47,139,23,209
3115507,3,0,3,61,23,12,96,184,27,307
3115508,3,0,3,79,20,3,102,139,34,275
3115509,32,0,32,58,14,0,72,210,16,298
3115510,0,0,0,0,0,0,0,0,0,0
3115511,0,6,6,87,29,3,119,290,59,468
3115512,0,0,0,59,28,3,90,202,32,324
3115601,0,0,0,47,11,3,61,125,13,199
3115602,4,0,4,75,23,0,98,233,30,361
3115603,3,0,3,51,16,0,67,129,16,212
3115604,6,6,12,58,27,4,89,293,42,424
3115605,7,0,7,55,11,0,66,128,5,199
3115606,0,0,0,33,9,0,42,106,21,169
3115607,6,0,6,51,18,0,69,190,25,284
3115608,3,0,3,66,30,0,96,220,23,339
3115609,12,0,12,67,26,9,102,183,23,308
3115610,3,0,3,54,23,0,77,154,28,259
3115611,4,0,4,72,22,9,103,225,38,366
3115612,0,0,0,0,0,0,0,0,0,0
3115613,3,0,3,28,12,0,40,145,18,203
3115614,5,4,9,79,42,9,130,246,50,426
3115615,0,0,0,37,9,0,46,99,10,155
3115616,3,0,3,60,13,3,76,119,13,208
3115617,4,0,4,79,37,3,119,204,25,348
3115618,7,0,7,47,21,6,74,166,21,261
3115619,6,0,6,94,27,6,127,257,9,393
3115620,0,0,0,46,9,6,61,153,18,232
3115621,6,3,9,96,34,3,133,257,41,431
3115622,7,0,7,94,27,9,130,289,30,449
3115623,36,47,83,17,0,0,17,107,92,216
3115701,0,0,0,102,33,6,141,331,110,582
3115702,8,27,35,49,30,0,79,232,101,412
3115703,0,0,0,40,23,3,66,141,13,220
3115704,6,0,6,65,24,9,98,187,27,312
3115705,5,5,10,59,14,0,73,249,69,391
3115706,3,0,3,62,13,3,78,142,43,263
3115707,8,0,8,37,11,5,53,156,38,247
3115708,0,0,0,68,20,3,91,172,39,302
3115709,4,0,4,49,24,3,76,121,6,203
3115710,0,0,0,0,0,0,0,0,0,0
3115711,3,3,6,57,41,9,107,230,56,393
3115712,4,0,4,77,17,3,97,241,103,441
3115801,0,0,0,24,4,0,28,74,12,114
3115802,4,0,4,42,14,0,56,137,11,204
3115803,0,0,0,35,21,3,59,78,6,143
3115804,7,0,7,48,14,0,62,165,22,249
3115805,5,0,5,77,33,4,114,218,39,371
3115806,3,3,6,29,15,0,44,98,20,162
3115807,19,0,19,61,31,4,96,235,35,366
3115808,3,0,3,48,12,0,60,191,39,290
3115809,0,0,0,29,14,0,43,107,0,150
3115810,3,0,3,46,18,9,73,168,22,263
3115811,0,0,0,8,9,0,17,109,14,140
3115812,0,3,3,31,6,9,46,95,15,156
3115813,0,0,0,33,20,0,53,138,31,222
3115814,4,0,4,28,12,0,40,116,21,177
3115815,7,0,7,22,12,0,34,124,21,179
3115816,3,0,3,22,12,0,34,114,12,160
3115901,9,0,9,57,18,0,75,225,20,320
3115902,3,0,3,60,18,4,82,134,11,227
3115903,0,0,0,21,9,3,33,60,6,99
3115904,3,4,7,32,10,3,45,124,18,187
3115905,0,0,0,56,4,0,60,69,7,136
3115906,12,0,12,49,21,0,70,160,21,251
3115907,0,0,0,65,27,6,98,141,18,257
3115908,0,0,0,35,13,0,48,99,15,162
3115909,65,3,68,14,3,0,17,198,27,242
3115910,0,0,0,29,18,0,47,79,21,147
3115911,0,0,0,31,14,0,45,123,21,189
3115912,4,3,7,37,15,3,55,183,49,287
3115913,6,0,6,46,15,3,64,228,39,331
3115914,30,7,37,28,21,0,49,214,37,300
3115915,5,0,5,78,14,0,92,301,38,431
3115916,6,6,12,61,18,0,79,219,36,334
3115917,7,0,7,88,22,3,113,188,32,333
3115918,3,0,3,49,4,0,53,158,33,244
3115919,3,4,7,34,22,0,56,150,18,224
3115920,4,0,4,29,16,0,45,151,8,204
3115921,6,3,9,20,12,3,35,161,28,224
3115922,7,0,7,56,30,8,94,177,22,293
3115923,3,0,3,9,12,0,21,79,9,109
3115924,3,0,3,37,7,4,48,132,9,189
3115925,4,0,4,78,27,0,105,193,19,317
3115926,6,3,9,40,22,0,62,154,18,234
3115927,0,4,4,28,18,0,46,105,19,170
3115928,10,0,10,60,23,6,89,195,26,310
3115929,6,0,6,29,25,0,54,108,20,182
3115930,6,0,6,70,26,3,99,275,38,412
3116001,7,0,7,48,17,0,65,239,26,330
3116002,0,0,0,30,9,0,39,205,22,266
3116003,3,3,6,35,14,3,52,179,25,256
3116004,6,3,9,51,18,9,78,192,19,289
3116005,8,3,11,65,19,6,90,186,34,310
3116006,4,0,4,71,32,3,106,256,30,392
3116007,3,0,3,61,26,0,87,221,15,323
3116008,0,0,0,40,13,4,57,164,14,235
3116009,0,0,0,63,24,7,94,196,25,315
3116010,3,0,3,38,7,0,45,130,17,192
3116011,6,3,9,81,34,0,115,274,32,421
3116012,0,0,0,0,0,0,0,9,0,9
3116013,0,0,0,0,0,0,0,0,0,0
3116014,4,0,4,40,10,3,53,128,21,202
3116015,0,0,0,16,11,0,27,101,21,149
3116016,0,0,0,0,0,0,0,0,0,0
3116017,6,3,9,57,21,0,78,156,23,257
3116018,3,0,3,74,28,0,102,205,27,334
3116019,3,0,3,72,22,8,102,200,16,318
3116020,0,0,0,95,26,3,124,277,24,425
3116021,3,0,3,41,19,0,60,189,12,261
3116022,0,3,3,92,19,0,111,267,48,426
3116023,0,6,6,29,15,0,44,115,28,187
3116024,6,0,6,39,7,0,46,120,19,185
3116101,0,0,0,55,19,3,77,128,27,232
3116102,0,0,0,24,12,3,39,97,7,143
3116103,0,3,3,51,3,4,58,197,56,311
3116104,0,0,0,0,3,0,3,15,3,21
3116105,3,0,6,22,9,0,31,99,19,149
3116106,0,0,0,0,0,0,0,0,0,0
3116107,3,0,3,21,12,3,36,107,11,154
3116108,0,0,0,0,0,0,0,0,0,0
3116109,3,0,3,52,23,3,78,169,18,265
3116110,4,0,4,20,9,0,29,166,27,222
3116111,6,0,9,86,20,0,106,256,38,400
3116112,0,0,0,68,15,9,92,229,22,343
3116113,6,0,6,31,24,0,55,184,21,260
3116114,3,0,3,68,13,0,81,169,24,274
3116115,0,0,0,0,0,0,0,0,3,3
3116116,27,6,33,43,17,4,64,290,43,397
3116117,6,0,6,17,9,0,26,123,24,173
3116118,3,0,3,29,15,3,47,157,20,224
3116119,3,0,3,27,7,0,34,160,24,218
3116120,0,0,0,60,25,0,85,212,19,316
3116121,0,0,0,39,4,0,43,180,44,267
3116122,3,0,3,67,17,0,84,221,27,332
3116123,0,0,0,30,16,0,46,183,28,257
3116124,0,0,0,69,13,3,85,186,17,288
3116125,0,0,0,31,9,0,40,97,27,164
3116126,6,0,6,48,15,7,70,281,24,375
3116127,4,0,4,28,17,0,45,120,23,188
3116128,0,0,0,60,16,0,76,120,11,207
3116129,31,5,36,26,12,0,38,169,8,215
3116130,7,3,10,55,30,0,85,175,29,289
3116131,6,0,6,18,3,0,21,65,12,98
3116132,0,0,0,44,18,0,62,92,0,154
3116133,3,0,3,63,19,6,88,173,15,276
3116134,0,0,0,56,16,5,77,171,22,270
3116135,6,0,6,60,15,7,82,173,20,275
3116136,0,0,0,17,17,0,34,63,0,97
3116137,0,0,0,0,0,0,0,0,0,0
3116138,0,0,0,0,0,0,0,0,0,0
3116139,0,0,0,0,0,0,0,0,0,0
3116140,6,0,6,36,15,0,51,119,19,189
3116141,8,4,12,28,13,0,41,117,29,187
3116201,0,0,0,0,0,0,0,3,3,6
3116301,4,0,4,225,214,0,439,454,3,896
3116302,4,0,4,178,180,12,370,297,11,678
3116401,0,8,8,10,3,5,18,95,45,158
3116402,0,0,0,37,15,0,52,110,34,196
3116403,11,0,11,47,20,3,70,146,34,250
3116404,7,3,10,61,19,9,89,151,35,275
3116405,4,5,9,41,27,7,75,164,36,275
3116406,4,0,4,93,28,7,128,255,32,415
3116407,0,0,0,61,15,15,91,142,15,248
3116408,0,0,0,13,15,0,28,54,0,82
3116409,0,0,0,33,9,0,42,203,33,278
3116410,0,0,0,57,28,9,94,181,28,303
3116411,0,0,0,63,19,0,82,163,23,268
3116412,0,0,0,37,3,6,46,120,26,192
3116413,3,0,3,73,31,0,104,190,25,319
3116414,3,0,3,67,38,3,108,213,17,338
3116415,0,0,0,69,18,0,87,150,13,250
3116416,0,0,0,66,22,0,88,172,18,278
3116417,0,0,0,53,15,9,77,169,31,277
3116418,0,0,0,0,0,0,0,3,0,3
3116419,0,0,0,24,18,3,45,110,20,175
3116420,3,0,3,21,0,0,21,85,16,122
3116501,0,0,0,42,9,3,54,134,0,188
3116502,3,0,3,22,13,3,38,137,43,218
3116503,0,3,3,17,18,6,41,180,46,267
3116504,32,0,32,122,36,9,167,368,65,600
3116505,0,0,0,88,24,3,115,188,35,338
3116506,0,0,0,42,24,0,66,218,23,307
3116507,4,0,4,72,12,6,90,397,101,588
3116508,3,0,3,52,21,6,79,346,84,509
3116509,0,0,0,32,5,3,40,98,33,171
3116510,0,0,0,65,15,0,80,124,30,234
3116511,0,0,0,35,21,0,56,157,72,285
3116512,3,4,7,31,14,0,45,264,59,368
3116601,6,0,6,55,22,0,77,203,15,295
3116602,6,0,6,70,30,4,104,178,15,297
3116603,0,0,0,89,31,3,123,247,34,404
3116604,14,67,81,50,24,3,77,207,137,421
3116605,13,3,16,42,14,0,56,213,45,314
3116606,12,0,12,104,23,3,130,253,29,412
3116607,6,3,9,31,6,6,43,169,37,249
3116608,9,3,12,42,14,0,56,243,45,344
3116609,18,8,26,68,18,6,92,267,27,386
3116610,9,4,13,72,25,3,100,237,36,373
3116611,0,0,0,75,28,0,103,223,22,348
3116612,6,6,12,29,27,3,59,166,21,246
3116613,10,0,10,63,27,4,94,241,21,356
3116614,3,0,3,79,25,10,114,193,28,335
3116615,10,6,16,61,21,6,88,206,43,337
3116616,8,0,8,54,22,3,79,211,36,326
3116617,3,0,3,63,22,3,88,211,12,311
3116618,3,0,3,39,16,0,55,159,3,217
3116619,3,0,3,27,6,7,40,106,9,155
3116620,4,0,4,42,16,8,66,99,21,186
3116621,6,0,6,102,62,4,168,285,30,483
3116622,0,0,0,56,17,0,73,155,25,253
3116623,6,0,6,68,27,3,98,202,15,315
3116624,5,0,5,78,12,0,90,234,10,334
3116625,4,4,8,63,22,3,88,266,35,389
3116701,7,0,7,22,13,0,35,158,19,212
3116702,6,0,6,30,13,3,46,105,8,159
3116703,10,3,13,44,18,3,65,217,34,316
3116704,0,0,0,67,12,4,83,254,35,372
3116705,0,0,0,67,23,6,96,313,59,468
3116706,0,0,0,51,9,0,60,150,25,235
3116707,3,0,3,28,8,3,39,186,35,260
3116708,7,0,7,38,12,5,55,206,25,286
3116709,0,0,0,36,22,4,62,158,21,241
3116710,17,0,17,25,11,0,36,149,10,195
3116711,0,0,0,42,10,0,52,215,43,310
3116712,0,0,0,38,13,0,51,156,24,231
3116713,3,0,3,43,6,0,49,197,25,271
3116714,0,3,3,23,3,6,32,78,36,146
3116715,0,0,0,32,9,0,41,118,29,188
3116716,3,0,3,74,36,7,117,282,33,432
3116801,0,0,0,0,0,0,0,0,0,0
3116802,0,0,0,0,0,0,0,0,0,0
3116803,3,0,3,41,17,0,58,131,15,204
3116804,0,0,0,0,3,0,3,3,0,6
3116805,6,0,6,66,31,9,106,146,53,305
3116806,0,4,4,47,18,3,68,199,25,292
3116807,0,0,0,67,26,8,101,224,26,351
3116808,3,0,3,46,26,0,72,223,8,303
3116809,3,0,3,73,23,0,96,180,16,292
3116810,3,0,3,38,12,0,50,154,9,213
3116811,0,3,3,87,24,7,118,300,26,444
3116812,6,0,6,87,30,3,120,254,76,450
3116813,0,0,0,63,21,0,84,167,39,290
3116814,4,0,4,21,9,6,36,88,16,140
3116815,0,0,0,46,49,4,99,59,6,164
3116901,14,3,17,28,7,3,38,148,24,210
3116902,4,0,4,36,15,0,51,123,12,186
3116903,0,0,0,22,11,6,39,147,21,207
3116904,3,0,3,57,19,0,76,160,20,256
3116905,0,0,0,56,14,3,73,210,30,313
3116906,6,0,6,84,15,3,102,214,37,353
3116907,3,0,3,30,16,3,49,127,15,191
3116908,0,3,3,18,9,3,30,53,6,89
3116909,4,40,44,18,12,0,30,77,92,199
3116910,0,0,0,64,26,0,90,276,23,389
3116911,4,0,4,57,15,5,77,233,40,350
3116912,0,0,0,0,0,0,0,0,0,0
3116913,0,0,0,39,21,0,60,187,4,251
3116914,0,0,0,26,23,0,49,181,21,251
3116915,3,0,3,24,9,3,36,76,10,122
3116916,0,0,0,45,19,5,69,136,24,229
3116917,0,0,0,22,12,0,34,92,9,135
3116918,0,0,0,33,18,0,51,100,17,168
3116919,3,0,3,68,25,5,98,180,10,288
3116920,3,0,3,33,3,3,39,150,20,209
3116921,3,0,3,23,14,0,37,80,17,134
3116922,0,0,0,32,18,3,53,103,15,171
3116923,10,3,13,81,36,13,130,314,34,478
3116924,3,3,6,42,9,0,51,133,24,208
3116925,6,3,9,30,9,3,42,149,15,206
3116926,0,0,0,28,12,0,40,74,12,126
3116927,3,0,3,36,13,0,49,78,15,142
3116928,0,0,0,53,16,6,75,86,13,174
3116929,0,0,0,20,4,3,27,92,6,125
3116930,6,3,9,58,36,3,97,235,24,356
3117001,5,0,5,154,46,10,210,282,39,531
3117002,11,3,14,53,38,3,94,225,24,343
3117003,3,3,6,105,19,3,127,227,29,383
3117004,7,0,7,50,21,3,74,141,33,248
3117005,4,0,4,65,35,3,103,196,18,317
3117006,3,0,3,54,31,3,88,166,3,257
3117007,0,0,0,36,11,0,47,96,14,157
3117008,0,0,0,35,15,6,56,116,15,187
3117009,6,0,6,32,18,6,56,101,15,172
3117010,0,0,0,69,16,0,85,238,32,355
3117011,8,6,14,56,27,6,89,273,68,430
3117012,7,7,14,29,23,3,55,163,30,248
3117013,3,3,6,19,9,0,28,119,21,168
3117014,5,3,8,62,24,3,89,246,30,365
3117015,6,3,9,57,30,0,87,278,38,403
3117016,3,3,6,75,41,3,119,281,69,469
3117017,3,0,3,110,31,3,144,240,17,401
3117018,3,0,3,37,22,0,59,132,16,207
3117019,6,0,6,65,30,4,99,228,39,366
3117020,11,0,11,53,27,3,83,259,49,391
3117021,30,7,37,44,27,3,74,314,67,455
3117022,10,3,16,66,23,7,96,251,40,387
3117023,7,3,10,84,37,17,138,270,42,450
3117024,3,0,3,97,29,6,132,199,20,351
3117101,3,0,3,87,27,4,118,202,26,346
3117102,13,0,13,70,18,4,92,164,34,290
3117103,3,0,3,41,20,3,64,156,18,238
3117104,6,0,6,74,16,9,99,191,32,322
3117105,0,6,6,59,33,3,95,171,25,291
3117106,3,0,3,34,32,0,66,126,12,204
3117107,4,0,4,64,13,3,80,136,23,239
3117108,4,0,4,53,18,0,71,229,43,343
3117109,3,3,6,52,6,3,61,179,32,272
3117110,4,0,4,60,19,7,86,190,15,291
3117111,0,0,0,56,10,0,66,120,16,202
3117112,0,0,3,77,27,0,104,169,30,303
3117113,0,0,0,51,14,3,68,100,12,180
3117114,0,0,0,0,0,0,0,0,0,0
3117201,7,0,7,59,39,3,101,192,9,302
3117202,7,3,10,69,29,4,102,189,33,324
3117203,5,0,5,39,21,0,60,159,20,239
3117204,3,0,3,84,18,6,108,130,52,290
3117205,5,0,5,95,31,8,134,216,32,382
3117206,13,0,13,134,37,6,177,349,31,557
3117207,4,3,7,46,33,3,82,196,33,311
3117208,6,0,6,31,13,3,47,87,9,143
3117209,18,4,22,58,33,4,95,266,34,395
3117210,4,0,4,37,16,3,56,138,21,215
3117211,0,0,0,93,23,8,124,161,34,319
3117212,0,3,3,52,13,0,65,116,18,199
3117213,3,0,3,70,11,0,81,230,39,350
3117214,3,0,3,47,15,0,62,128,10,200
3117215,3,0,3,81,23,0,104,184,16,304
3117216,3,0,3,68,17,3,88,127,18,233
3117217,4,0,4,33,13,3,49,92,21,162
3117218,24,3,27,152,21,9,182,309,28,519
3117301,3,3,6,61,11,0,72,104,20,196
3117302,0,0,0,73,20,3,96,109,24,229
3117303,3,0,3,70,26,3,99,175,34,308
3117304,0,0,0,33,11,0,44,98,17,159
3117305,3,0,3,28,14,5,47,81,20,148
3117306,5,3,8,46,24,0,70,170,33,273
3117307,8,3,11,45,10,4,59,133,30,222
3117308,3,3,6,72,23,6,101,206,49,356
3117309,0,3,3,34,18,0,52,115,23,190
3117310,5,0,5,39,24,0,63,166,41,270
3117311,0,0,0,106,20,9,135,148,31,314
3117312,3,0,3,61,12,0,73,109,31,213
3117313,4,0,4,23,15,6,44,97,18,159
3117314,0,3,3,59,24,3,86,189,35,310
3117315,0,0,0,127,24,0,151,272,39,462
3117316,0,0,0,98,9,0,107,112,4,223
3117317,26,6,32,60,21,9,90,204,24,318
3117318,3,4,7,57,15,0,72,161,34,267
3117319,5,5,10,27,15,3,45,141,25,211
3117401,3,9,12,25,12,3,40,144,27,211
3117402,6,3,9,38,4,0,42,101,22,165
3117403,3,0,3,57,9,0,66,207,27,300
3117404,12,0,12,60,21,6,87,217,42,346
3117405,0,0,0,38,24,3,65,131,6,202
3117406,3,0,3,66,10,6,82,170,17,269
3117407,0,0,0,53,12,0,65,86,3,154
3117408,0,0,0,42,5,3,50,78,9,137
3117409,0,0,0,100,15,6,121,167,28,316
3117410,0,0,0,62,18,0,80,90,19,189
3117411,0,0,0,42,22,0,64,150,15,229
3117412,5,3,8,86,17,4,107,275,25,407
3117413,8,0,8,41,14,0,55,235,26,316
3117501,3,0,3,58,12,6,76,168,15,259
3117502,3,0,3,36,7,0,43,106,12,161
3117503,11,3,14,60,23,13,96,189,33,318
3117504,32,4,36,96,36,3,135,276,40,451
3117505,4,0,4,17,15,3,35,97,19,151
3117506,3,0,3,42,21,0,63,192,21,276
3117507,0,0,0,65,21,3,89,159,21,269
3117508,10,3,13,49,11,6,66,165,30,261
3117509,4,0,4,44,6,6,56,168,23,247
3117510,0,0,0,17,6,0,23,48,6,77
3117511,3,0,3,45,9,9,63,124,6,193
3117512,3,0,3,84,29,7,120,175,26,321
3117601,3,0,3,44,22,0,66,76,19,161
3117602,0,0,0,69,19,3,91,150,27,268
3117603,10,3,13,99,30,6,135,263,49,447
3117604,0,0,0,64,12,6,82,188,36,306
3117605,0,0,0,59,31,0,90,160,29,279
3117606,3,0,6,46,15,0,61,133,33,227
3117607,5,0,5,30,19,0,49,188,26,263
3117608,6,0,6,63,25,0,88,174,22,284
3117609,3,0,3,73,22,0,95,167,20,282
3117610,0,0,0,57,18,6,81,157,20,258
3117611,0,0,0,64,24,0,88,185,23,296
3117612,0,0,0,62,15,4,81,209,59,349
3117613,0,3,3,47,11,3,61,135,26,222
3117614,0,0,0,65,17,0,82,158,63,303
3117615,0,6,6,58,22,3,83,138,46,267
3117616,12,0,12,73,24,0,97,185,63,345
3117617,28,3,31,70,5,3,78,263,25,366
3117618,0,0,0,83,18,0,101,210,49,360
3117701,0,0,0,45,9,0,54,141,16,211
3117702,3,0,3,34,12,0,46,99,15,160
3117703,0,0,0,39,19,6,64,126,18,208
3117704,6,3,9,36,16,0,52,169,17,238
3117705,4,0,4,43,14,0,57,126,25,208
3117706,3,0,3,62,13,7,82,204,28,314
3117707,3,0,3,41,9,0,50,101,12,163
3117708,10,3,13,48,11,0,59,226,66,351
3117709,0,0,0,81,11,0,92,119,12,223
3117710,3,0,3,64,13,0,77,138,25,240
3117711,0,0,0,40,12,3,55,118,11,184
3117712,0,0,0,90,33,3,126,216,55,397
3117713,0,0,0,85,15,3,103,144,18,265
3117714,6,0,6,17,3,3,23,81,9,113
3117715,3,0,3,69,28,0,97,187,28,312
3117716,9,0,9,57,27,0,84,196,34,314
3117717,0,0,0,24,16,0,40,104,16,160
3117718,3,3,6,102,33,6,141,286,54,481
3117719,6,0,6,49,24,3,76,187,15,278
3117801,20,5,25,48,21,4,73,226,21,320
3117802,6,0,6,69,22,15,106,193,30,329
3117803,0,0,0,55,13,0,68,189,27,284
3117804,0,0,0,22,15,0,37,117,21,175
3117805,3,0,3,34,0,3,37,149,41,227
3117806,4,0,4,64,21,6,91,273,43,407
3117807,0,0,0,60,9,0,69,158,36,263
3117808,0,0,0,44,16,3,63,183,18,264
3117809,0,0,0,40,19,6,65,110,23,198
3117810,0,0,0,60,18,3,81,149,11,241
3117811,0,0,0,60,10,7,77,131,15,223
3117812,9,0,9,60,11,0,71,193,16,280
3117901,8,3,11,41,12,3,56,218,27,301
3117902,6,0,6,31,12,0,43,181,18,242
3117903,3,3,6,25,7,0,32,137,21,190
3117904,3,3,6,63,23,3,89,243,20,352
3117905,66,6,72,74,18,6,98,379,57,534
3117906,6,0,6,31,17,9,57,147,17,221
3117907,9,0,9,31,15,3,49,138,19,206
3117908,7,3,10,68,31,6,105,224,24,353
3117909,3,0,3,57,44,0,101,189,30,320
3117910,6,3,9,38,10,4,52,159,27,238
3117911,3,3,6,38,9,0,47,134,6,187
3117912,3,0,3,37,16,0,53,115,19,187
3117913,4,0,4,25,18,3,46,158,20,224
3117914,6,0,6,48,22,0,70,172,14,256
3117915,4,0,4,36,11,3,50,139,22,211
3117916,0,0,0,60,19,4,83,192,25,300
3117917,3,0,3,68,22,6,96,166,21,283
3117918,3,0,6,74,17,3,94,213,43,350
3117919,3,3,6,44,15,0,59,212,24,295
3117920,4,0,4,69,19,0,88,158,24,270
3117921,4,0,4,51,10,0,61,75,6,142
3117922,6,0,6,71,23,0,94,189,36,319
3117923,0,0,0,47,13,3,63,134,32,229
3117924,0,0,0,60,21,3,84,168,12,264
3118001,0,0,0,19,13,7,39,108,3,150
3118002,0,0,0,37,19,0,56,103,6,165
3118003,6,3,9,88,22,5,115,258,31,404
3118004,6,3,9,33,12,0,45,137,12,194
3118005,4,0,4,87,20,0,107,190,42,339
3118006,0,0,0,55,21,6,82,133,18,233
3118007,3,7,10,68,14,0,82,156,50,288
3118008,6,0,6,43,15,5,63,130,42,235
3118009,6,0,6,42,32,9,83,213,30,326
3118010,27,0,27,17,0,3,20,118,19,157
3118011,0,0,0,38,15,0,53,94,6,153
3118012,0,3,3,59,21,0,80,170,35,285
3118013,0,3,3,19,29,0,48,104,18,170
3118014,24,0,24,30,14,3,47,181,11,239
3118015,0,0,0,33,19,0,52,121,21,194
3118016,5,0,5,33,18,3,54,113,12,179
3118017,0,0,0,44,16,6,66,117,5,188
3118018,3,3,6,48,18,6,72,185,18,275
3118019,0,0,0,74,20,3,97,195,12,304
3118020,3,0,3,66,17,6,89,194,13,296
3118021,0,3,3,52,19,6,77,179,43,299
3118022,4,0,4,63,20,3,86,140,26,252
3118023,0,0,0,44,4,0,48,69,7,124
3118024,0,0,0,60,19,0,79,145,40,264
3118101,8,0,8,36,15,3,54,129,17,200
3118102,6,6,12,67,18,4,89,226,27,342
3118103,3,0,3,28,12,6,46,122,9,177
3118104,5,0,5,79,15,3,97,218,32,347
3118105,22,0,22,34,21,0,55,127,6,188
3118106,0,0,0,27,9,0,36,68,10,114
3118107,0,0,0,55,11,0,66,143,10,219
3118108,0,0,0,36,15,3,54,79,9,142
3118109,0,0,0,39,14,0,53,244,55,352
3118110,0,0,0,21,7,0,28,121,12,161
3118111,0,0,0,51,5,6,62,131,32,225
3118201,0,0,0,40,20,0,60,106,4,170
3118202,3,0,3,32,25,0,57,138,12,207
3118203,3,0,3,32,18,6,56,127,18,201
3118204,6,0,6,50,21,0,71,127,19,217
3118205,0,0,0,46,22,0,68,130,29,227
3118206,0,4,4,47,25,3,75,91,29,195
3118207,3,0,3,41,18,6,65,151,12,228
3118208,0,0,0,91,21,0,112,164,13,289
3118209,0,0,0,47,15,3,65,99,7,171
3118210,0,0,0,43,10,4,57,113,6,176
3118211,0,0,0,64,21,0,85,124,16,225
3118212,11,3,14,63,44,9,116,251,25,392
3118213,7,6,13,71,35,3,109,215,12,336
3118214,12,0,12,85,39,6,130,259,22,411
3118215,48,3,51,48,21,0,69,172,29,270
3118216,3,0,3,43,23,0,66,109,15,190
3118217,0,0,0,51,16,3,70,102,14,186
3118301,6,0,6,35,18,4,57,83,42,182
3118302,3,0,3,48,12,0,60,113,25,198
3118303,3,0,3,76,36,6,118,146,38,302
3118304,0,0,4,54,14,0,68,135,29,232
3118305,0,0,0,54,15,5,74,118,10,202
3118306,3,0,3,54,21,0,75,164,27,266
3118307,0,0,0,47,21,0,68,145,17,230
3118308,6,3,9,60,17,0,77,173,17,267
3118309,18,24,42,60,24,0,84,238,64,386
3118310,3,3,6,39,23,6,68,114,9,191
3118311,48,9,57,63,43,6,112,290,42,444
3118312,3,0,3,40,8,0,48,135,21,204
3118313,0,0,0,33,12,0,45,102,6,153
3118314,6,0,6,54,17,0,71,163,21,255
3118315,6,0,6,95,27,3,125,196,25,346
3118316,0,0,0,81,21,3,105,268,59,432
3118317,0,0,0,47,13,0,60,117,7,184
3118318,4,0,4,98,24,3,125,259,38,422
3118319,3,0,3,52,12,0,64,116,35,215
3118320,0,0,0,63,25,6,94,131,24,249
3118321,3,0,3,107,20,11,138,195,25,358
3118322,5,0,5,129,30,6,165,201,36,402
3118323,5,6,11,51,15,4,70,231,46,347
3118324,0,0,0,73,21,4,98,165,21,284
3118325,0,0,0,51,14,0,65,111,67,243
3118326,0,0,0,113,32,11,156,158,40,354
3118327,0,0,0,49,19,0,68,163,38,269
3118328,5,0,5,40,3,0,43,105,40,188
3118329,0,0,0,44,18,6,68,101,33,202
3118330,18,5,23,23,10,3,36,169,16,221
3118331,3,3,6,42,15,4,61,118,21,200
3118332,13,5,18,45,12,3,60,193,42,295
3118333,10,0,10,59,14,4,77,164,77,318
3118334,0,0,0,36,21,0,57,144,13,214
3118335,3,0,3,36,12,0,48,134,13,195
3118336,6,0,6,92,52,6,150,259,47,456
3118337,6,0,6,60,28,0,88,203,41,332
3118338,0,0,0,55,12,7,74,122,18,214
3118339,0,0,0,45,13,3,61,106,21,188
3118340,5,3,8,79,20,3,102,237,44,383
3118341,0,0,0,57,12,0,69,140,6,215
3118342,4,4,8,32,27,0,59,186,54,299
3118343,5,0,5,34,15,0,49,161,13,223
3118344,3,0,3,90,11,0,101,165,28,294
3118345,0,0,0,165,29,3,197,268,27,492
3118401,0,0,0,80,9,0,89,205,9,303
3118402,7,0,7,42,16,0,58,166,21,245
3118403,27,4,31,41,18,3,62,193,23,278
3118404,0,0,0,23,6,0,29,86,9,124
3118405,6,0,6,46,23,0,69,202,18,289
3118406,0,0,0,24,18,0,42,109,13,164
3118407,3,0,3,79,22,0,101,248,26,375
3118408,3,0,3,63,30,0,93,281,37,411
3118409,0,4,4,62,15,0,77,148,4,229
3118410,4,0,4,36,11,0,47,141,7,195
3118411,6,3,9,54,20,0,74,195,23,292
3118412,6,0,6,104,24,0,128,241,23,392
3118413,3,0,3,65,21,0,86,180,16,282
3118501,0,0,0,97,23,3,123,233,11,367
3118502,0,0,0,49,21,0,70,129,19,218
3118503,0,0,0,40,29,6,75,175,27,277
3118504,6,0,6,57,21,4,82,112,3,197
3118505,4,0,4,53,18,3,74,180,6,260
3118506,0,0,0,32,12,3,47,116,12,175
3118507,3,0,3,21,8,0,29,116,15,160
3118508,30,0,30,51,24,0,75,238,18,331
3118509,9,0,9,54,23,3,80,194,8,282
3118510,3,0,3,39,6,0,45,117,22,184
3118511,3,5,8,33,12,0,45,102,11,158
3118512,3,0,3,63,29,10,102,166,22,290
3118513,4,0,4,37,6,3,46,112,12,170
3118514,4,0,4,29,16,3,48,87,0,135
3118601,27,3,30,58,20,4,82,247,42,371
3118602,28,0,28,51,21,0,72,224,38,334
3118603,3,0,3,57,19,6,82,190,27,299
3118604,3,0,3,54,21,0,75,164,18,257
3118605,6,0,6,76,15,0,91,239,21,351
3118606,0,0,0,23,15,9,47,129,13,189
3118607,0,0,0,75,22,0,97,225,30,352
3118608,3,0,3,45,12,4,61,144,21,226
3118609,6,0,6,49,18,0,67,215,16,298
3118610,0,0,3,48,11,0,59,125,31,215
3118611,4,0,4,45,9,3,57,229,15,301
3118612,0,0,0,46,20,0,66,255,28,349
3118701,7,0,7,48,20,3,71,176,33,280
3118702,6,0,6,56,6,0,62,155,10,227
3118703,6,5,11,52,10,5,67,134,9,210
3118704,4,0,4,38,12,3,53,151,24,228
3118705,6,0,6,21,14,0,35,137,12,184
3118706,7,3,10,26,12,3,41,153,27,221
3118707,13,0,13,86,30,4,120,295,28,443
3118708,6,0,6,34,7,0,41,131,17,189
3118709,9,6,15,18,9,0,27,171,27,225
3118710,11,3,14,58,36,8,102,264,23,389
3118711,56,0,56,26,3,0,29,163,7,199
3118712,14,0,14,39,19,0,58,161,15,234
3118713,4,0,4,48,15,0,63,150,3,216
3118714,0,0,0,39,14,3,56,114,12,182
3118715,3,0,3,48,16,0,64,158,12,234
3118716,3,0,3,50,3,0,53,101,18,172
3118717,0,3,3,36,11,0,47,111,6,164
3118718,23,3,26,68,18,0,86,247,25,358
3118801,0,0,0,52,20,6,78,169,9,256
3118802,0,4,4,77,26,0,103,225,14,342
3118803,3,0,3,55,16,0,71,202,9,282
3118804,4,0,4,28,0,0,28,83,15,126
3118805,4,0,4,40,12,0,52,189,17,258
3118806,8,0,8,69,26,0,95,228,28,351
3118807,0,0,0,72,22,0,94,238,27,359
3118808,5,0,5,81,28,6,115,232,16,363
3118809,10,0,10,72,20,0,92,279,27,398
3118810,4,3,7,42,18,0,60,185,25,270
3118811,9,0,9,68,18,0,86,269,45,400
3118812,0,0,0,69,23,0,92,278,13,383
3118813,0,0,0,40,15,0,55,140,9,204
3118814,11,4,15,63,26,0,89,292,41,422
3118901,3,0,3,57,18,3,78,117,10,205
3118902,4,0,4,56,12,0,68,202,9,279
3118903,12,7,19,40,24,9,73,249,52,374
3118904,10,0,10,39,20,0,59,175,18,252
3118905,7,3,10,50,15,0,65,196,25,286
3118906,3,0,3,54,20,0,74,180,23,277
3118907,0,0,0,105,25,10,140,282,21,443
3118908,3,0,3,97,29,3,129,196,6,331
3118909,17,4,21,71,23,0,94,229,29,352
3118910,0,3,3,135,42,0,177,313,24,514
3118911,3,0,3,43,4,4,51,174,6,231
3118912,6,0,6,76,18,6,100,165,3,268
3118913,4,3,7,109,23,8,140,311,13,464
3118914,6,0,6,123,38,8,169,388,36,593
3118915,3,0,3,46,25,0,71,140,9,220
3118916,0,0,0,0,0,0,0,6,0,6
3118917,3,0,3,61,20,9,90,216,38,344
3118918,12,3,15,114,35,8,157,392,32,581
3118919,0,0,0,53,12,3,68,105,12,185
3118920,34,42,76,44,20,0,64,148,70,282
3118921,10,3,13,48,29,0,77,292,29,398
3118922,9,0,9,28,27,3,58,143,22,223
3118923,9,0,9,75,29,3,107,215,10,332
3118924,0,0,0,32,15,0,47,117,15,179
3118925,3,0,3,35,12,3,50,107,10,167
3118926,6,0,6,42,11,0,53,85,15,153
3118927,0,0,0,84,22,9,115,106,13,234
3118928,10,0,10,35,11,0,46,130,15,191
3118929,14,3,17,62,40,4,106,241,24,371
3118930,38,3,41,34,19,0,53,186,12,251
3118931,3,7,10,61,31,4,96,248,34,378
3118932,6,4,10,52,30,4,86,226,40,352
3118933,0,0,0,44,14,3,61,117,7,185
3118934,3,3,6,60,17,8,85,137,20,242
3118935,0,0,0,75,26,3,104,159,27,290
3118936,4,0,4,41,9,0,50,108,13,171
3118937,3,3,6,54,23,3,80,177,22,279
3118938,3,0,3,56,19,3,78,190,41,309
3118939,12,9,21,32,0,0,32,157,40,229
3119001,0,0,0,37,9,0,46,99,18,163
3119002,0,0,0,31,7,3,41,133,28,202
3119003,0,3,6,33,15,0,48,129,8,185
3119004,0,0,0,73,9,3,85,137,6,228
3119005,0,0,0,82,17,12,111,136,33,280
3119006,3,0,3,65,14,4,83,146,34,263
3119007,0,0,0,83,15,6,104,116,21,241
3119008,0,0,0,153,59,0,212,372,17,601
3119009,0,0,0,76,10,0,86,146,11,243
3119010,0,0,0,42,12,4,58,122,48,228
3119011,0,0,0,74,12,0,86,132,15,233
3119012,0,0,0,115,21,6,142,130,18,290
3119013,0,0,0,51,16,6,73,130,9,212
3119014,0,0,0,65,15,3,83,129,29,241
3119015,0,0,0,41,8,0,49,107,23,179
3119016,3,0,3,52,10,0,62,143,34,239
3119017,0,0,0,83,13,0,96,130,23,249
3119018,0,0,0,48,0,4,52,87,50,189
3119019,0,0,0,51,6,0,57,145,15,217
3119020,0,0,0,60,0,0,60,98,35,193
3119021,0,0,0,56,11,0,67,121,19,207
3119022,0,0,0,78,26,0,104,152,32,288
3119023,4,0,4,46,9,3,58,135,22,215
3119101,4,0,4,30,9,0,39,49,11,99
3119102,0,0,0,76,23,4,103,159,9,271
3119103,7,0,7,41,17,4,62,335,76,473
3119104,7,3,10,51,14,0,65,376,99,540
3119105,0,0,0,117,11,5,133,173,112,418
3119106,0,0,0,46,5,0,51,101,3,155
3119107,8,3,11,59,21,6,86,153,21,260
3119108,4,0,4,27,10,3,40,128,10,178
3119109,3,3,6,54,13,3,70,110,38,218
3119110,0,0,0,44,10,0,54,102,9,165
3119111,3,0,3,76,20,0,96,171,32,299
3119112,0,0,0,27,12,0,39,105,21,165
3119113,3,3,6,98,20,0,118,194,38,350
3119114,3,0,3,33,3,0,36,123,21,180
3119115,0,0,0,103,20,14,137,217,23,377
3119116,4,0,4,69,25,6,100,241,42,383
3119117,3,0,3,76,33,6,115,180,29,324
3119118,3,0,3,110,25,3,138,219,66,423
3119119,3,0,3,60,6,0,66,125,11,202
3119120,0,0,0,41,6,0,47,80,9,136
3119121,0,0,0,27,12,3,42,99,20,161
3119122,0,0,0,71,0,9,80,65,0,145
3119123,0,0,0,141,13,5,159,128,21,308
3119124,0,0,0,60,9,3,72,62,7,141
3119125,0,0,0,42,20,3,65,250,61,376
3119126,0,3,3,4,0,0,4,80,16,100
3119201,0,0,0,200,32,15,247,256,31,534
3119202,0,0,0,155,43,12,210,270,12,492
3119203,0,6,6,110,46,0,156,232,66,454
3119204,3,0,3,29,12,0,41,168,18,227
3119205,0,0,0,90,14,0,104,162,34,300
3119206,0,0,0,91,0,3,94,113,28,235
3119207,7,0,7,139,30,0,169,222,24,415
3119208,0,0,0,93,24,3,120,180,18,318
3119209,0,0,0,111,17,6,134,206,22,362
3119210,0,0,0,99,23,0,122,151,27,300
3119211,0,0,0,69,27,3,99,144,35,278
3119212,0,0,0,44,11,0,55,103,39,197
3119213,0,0,0,59,24,0,83,118,45,246
3119214,0,0,0,133,33,0,166,181,47,394
3119215,0,0,0,49,15,0,64,69,9,142
3119216,0,0,0,46,15,7,68,136,13,217
3119217,0,0,0,72,18,7,97,153,73,323
3119218,0,13,13,79,12,6,97,184,66,347
3119219,0,0,0,50,14,3,67,153,32,252
3119220,3,3,6,52,7,6,65,146,72,283
3119221,0,0,0,25,19,0,44,118,23,185
3119222,0,3,3,50,8,3,61,166,22,249
3119223,0,0,0,37,19,3,59,189,33,281
3119224,0,0,0,97,16,0,113,149,24,286
3119225,0,0,0,75,12,3,90,137,24,251
3119226,0,0,0,113,22,5,140,186,22,348
3119227,3,0,3,98,20,10,128,283,62,473
3119228,0,0,0,53,12,0,65,127,14,206
3119229,3,0,3,134,48,11,193,225,28,446
3119230,0,0,0,65,13,9,87,86,3,176
3119231,0,0,0,118,39,8,165,212,40,417
3119232,3,0,3,53,0,0,53,101,24,178
3119301,0,0,0,49,24,3,76,276,44,396
3119302,0,0,0,0,0,0,0,8,4,12
3119303,6,3,9,45,3,0,48,136,22,206
3119304,0,0,0,37,4,3,44,151,19,214
3119305,0,0,0,45,8,0,53,124,10,187
3119306,0,0,0,72,20,3,95,200,36,331
3119307,0,0,0,58,19,3,80,221,21,322
3119308,7,0,7,60,16,6,82,160,9,251
3119309,6,4,10,71,18,9,98,205,32,335
3119310,0,0,0,0,0,0,0,3,0,3
3119311,0,0,0,21,0,3,24,163,5,192
3119312,6,0,6,67,33,3,103,231,33,367
3119313,3,0,3,44,6,3,53,210,30,293
3119314,0,0,0,82,9,3,94,205,38,337
3119315,0,0,0,32,3,0,35,59,8,102
3119316,0,0,0,49,7,0,56,153,17,226
3119317,4,0,4,7,0,3,10,52,9,71
3119318,0,0,0,76,17,6,99,342,48,489
3119319,0,0,0,30,6,0,36,76,15,127
3119401,0,0,0,60,12,8,80,118,4,202
3119402,0,0,0,44,21,0,65,99,6,170
3119403,0,3,3,54,13,3,70,106,25,201
3119404,0,0,0,85,15,3,103,257,43,403
3119405,0,0,0,77,23,9,109,202,13,324
3119406,6,3,9,31,13,0,44,147,27,218
3119407,10,0,10,41,13,0,54,159,15,228
3119408,17,0,17,45,24,0,69,168,24,261
3119409,0,0,0,38,9,0,47,121,0,168
3119410,0,0,0,55,13,6,74,131,7,212
3119411,3,0,3,50,6,3,59,119,4,182
3119412,6,3,9,85,21,0,106,125,14,245
3119413,4,0,4,34,7,3,44,106,4,154
3119414,4,0,4,28,12,0,40,131,18,189
3119415,3,0,3,73,10,0,83,199,6,288
3119416,3,0,3,49,19,3,71,107,7,185
3119417,0,0,0,50,7,0,57,99,12,168
3119418,0,0,0,31,9,3,43,56,11,110
3119419,3,0,3,59,25,0,84,166,14,264
3119420,0,0,0,46,6,0,52,104,20,176
3119421,3,0,3,55,7,0,62,134,27,223
3119422,3,3,6,46,12,3,61,105,6,172
3119423,0,3,3,26,6,0,32,72,18,122
3119424,0,6,6,51,21,0,72,121,30,223
3119425,0,0,0,51,26,3,80,138,17,235
3119426,0,0,0,31,6,0,37,117,3,157
3119427,4,0,4,44,11,0,55,103,11,169
3119428,5,0,5,29,9,6,44,133,18,195
3119429,0,0,0,48,18,3,69,107,4,180
3119430,0,0,0,0,0,0,0,0,0,0
3119431,0,0,0,63,13,3,79,125,10,214
3119432,6,6,12,53,28,3,84,246,44,374
3119501,3,0,3,148,25,6,179,210,19,408
3119502,0,0,0,95,21,11,127,288,25,440
3119503,0,0,0,45,6,0,51,105,19,175
3119504,3,0,3,94,13,5,112,195,13,320
3119505,0,3,3,78,21,3,102,176,21,299
3119506,0,0,0,63,25,0,88,141,18,247
3119507,0,0,0,27,0,0,27,111,12,150
3119508,4,0,4,58,11,5,74,131,21,226
3119509,38,0,38,28,6,3,37,138,27,202
3119510,0,0,0,59,10,0,69,116,12,197
3119511,0,0,0,70,23,3,96,131,31,258
3119512,4,0,4,93,23,3,119,162,23,304
3119513,3,3,6,50,15,3,68,116,27,211
3119514,0,4,4,73,24,4,101,187,23,311
3119515,6,0,6,41,24,6,71,196,29,296
3119516,0,0,0,3,0,0,3,4,0,7
3119517,0,0,0,0,0,0,0,0,0,0
3119518,5,0,5,66,15,0,81,97,29,207
3119519,4,0,4,39,6,4,49,81,3,133
3119520,0,0,0,16,0,3,19,32,3,54
3119601,3,0,3,98,40,3,141,279,11,431
3119602,0,0,0,57,21,3,81,127,12,220
3119603,6,0,6,86,17,12,115,318,23,456
3119604,0,0,0,62,18,0,80,192,57,329
3119605,0,0,0,106,32,3,141,230,36,407
3119606,3,0,3,113,19,10,142,221,37,400
3119607,4,0,4,105,24,3,132,179,30,341
3119608,0,0,0,154,33,8,195,212,34,441
3119609,0,0,0,105,16,0,121,136,27,284
3119610,0,3,3,67,21,0,88,180,58,326
3119611,25,3,28,90,18,4,112,291,33,436
3119612,0,0,0,70,12,14,96,104,23,223
3119613,4,0,4,60,14,0,74,152,12,238
3119614,0,0,0,133,37,11,181,276,24,481
3119615,0,4,4,83,21,3,107,190,38,335
3119616,3,0,3,81,33,6,120,169,15,304
3119617,0,0,0,95,39,10,144,174,24,342
3119618,0,0,0,96,23,0,119,160,19,298
3119619,0,4,4,39,15,0,54,181,38,273
3119620,0,0,0,0,0,0,0,0,0,0
3119621,0,0,0,151,35,5,191,371,37,599
3119622,0,0,0,48,10,0,58,102,15,175
3119701,0,0,0,0,0,0,0,51,0,51
3119801,0,0,0,0,0,0,0,0,0,0
3119802,0,0,0,153,47,9,209,299,36,544
3119803,3,3,6,112,21,3,136,172,30,338
3119804,9,0,9,78,15,12,105,187,7,299
3119805,0,0,0,99,25,6,130,169,41,340
3119806,0,0,0,101,22,0,123,96,10,229
3119807,0,0,0,0,0,0,0,9,0,9
3119808,0,0,0,75,13,0,88,135,16,239
3119809,0,0,0,61,26,9,96,177,18,291
3119810,3,0,3,51,14,3,68,136,21,225
3119811,0,0,0,66,21,0,87,164,6,257
3119812,4,0,4,35,14,0,49,117,6,172
3119813,0,0,0,83,32,4,119,220,27,366
3119814,0,0,0,82,31,0,113,154,10,277
3119815,4,0,4,115,30,0,145,250,17,412
3119816,0,3,3,114,14,4,132,153,12,297
3119817,0,0,0,111,25,6,142,160,28,330
3119818,0,0,0,74,18,0,92,116,31,239
3119819,0,0,0,99,22,0,121,163,28,312
3119820,6,0,6,102,20,7,129,177,35,341
3119821,0,0,0,139,32,7,178,208,29,415
3119822,3,0,3,105,46,6,157,263,15,435
3119823,0,0,0,108,17,3,128,172,23,323
3119824,19,4,23,35,18,0,53,172,25,250
3119825,0,0,0,83,25,6,114,202,16,332
3119826,0,0,0,104,24,6,134,211,33,378
3119827,0,0,0,53,18,4,75,201,28,304
3119828,0,0,0,60,18,4,82,183,24,289
3119901,0,0,0,0,0,0,0,3,0,3
3119902,0,0,0,74,24,6,104,223,31,358
3119903,5,0,5,67,26,0,93,249,34,376
3119904,3,0,3,60,19,3,82,219,38,339
3119905,0,0,0,25,16,6,47,131,39,217
3119906,0,0,0,0,0,0,0,0,0,0
3119907,0,0,0,67,31,7,105,183,29,317
3119908,0,4,4,37,24,0,61,187,100,348
3119909,9,0,9,55,25,0,80,261,110,451
3119910,0,3,3,3,0,0,3,9,6,18
3119911,0,0,0,82,28,0,110,242,149,501
3119912,8,6,14,80,32,0,112,280,58,450
3119913,9,0,9,60,24,3,87,247,42,376
3119914,6,3,9,43,17,4,64,203,54,321
3119915,3,3,6,83,24,3,110,328,78,516
3119916,0,0,0,107,13,3,123,172,8,303
3119917,24,0,24,48,15,0,63,234,27,324
3120001,0,0,0,104,19,6,129,170,20,319
3120002,0,0,0,79,28,6,113,166,15,294
3120003,0,0,0,68,23,0,91,217,32,340
3120004,0,0,0,54,28,3,85,157,33,275
3120005,0,0,0,48,13,0,61,96,19,176
3120006,7,0,7,30,10,0,40,154,28,222
3120007,0,0,0,51,6,10,67,152,13,232
3120008,0,0,0,0,9,0,9,114,8,131
3120009,3,0,3,52,19,12,83,190,33,306
3120010,6,0,6,186,45,8,239,232,21,492
3120011,0,3,3,138,15,6,159,201,26,386
3120012,0,0,0,62,23,6,91,209,38,338
3120013,0,0,0,117,27,6,150,231,46,427
3120014,0,0,0,115,23,16,154,183,18,355
3120015,0,0,0,61,15,3,79,119,12,210
3120016,0,0,0,43,11,0,54,105,16,175
3120017,3,3,6,87,23,6,116,291,27,434
3120018,3,0,3,88,23,0,111,189,48,348
3120019,24,0,24,43,9,6,58,164,16,238
3120020,0,0,0,49,15,0,64,165,17,246
3120021,0,0,0,48,25,0,73,159,9,241
3120022,0,0,0,93,19,3,115,265,38,418
3120023,0,0,0,129,32,6,167,268,34,469
3120024,0,0,0,63,33,3,99,125,16,240
3120025,3,3,6,52,15,9,76,182,40,298
3120026,3,0,3,70,10,6,86,200,8,294
3120101,3,0,3,64,21,3,88,177,15,280
3120102,3,0,3,118,24,10,152,260,40,452
3120103,3,0,3,73,34,12,119,235,48,402
3120104,0,0,0,92,31,7,130,224,19,373
3120105,0,0,0,85,30,0,115,221,30,366
3120106,4,0,4,84,28,3,115,202,47,364
3120107,3,0,3,37,15,0,52,154,0,206
3120108,0,0,0,51,13,3,67,118,14,199
3120109,0,0,0,69,22,3,94,137,29,260
3120110,0,0,0,68,24,6,98,131,34,263
3120201,0,0,0,0,0,0,0,0,0,0
3120301,0,0,0,86,23,3,112,121,30,263
3120302,0,0,0,77,18,3,98,109,19,226
3120303,0,0,0,111,29,4,144,196,12,352
3120304,0,0,0,71,22,7,100,191,20,311
3120305,3,0,3,85,20,7,112,248,12,372
3120306,4,0,4,103,23,9,135,243,23,401
3120307,0,0,0,75,26,3,104,164,46,314
3120308,0,0,0,43,25,6,74,89,28,191
3120309,0,0,0,81,23,3,107,179,42,328
3120310,20,0,20,212,40,11,263,360,46,669
3120311,0,0,0,62,24,9,95,158,19,272
3120312,0,0,0,37,9,3,49,114,21,184
3120313,3,0,3,78,6,12,96,97,13,206
3120401,0,3,3,74,32,0,106,262,29,397
3120402,3,0,3,26,18,3,47,136,25,208
3120403,0,0,0,132,44,13,189,317,57,563
3120404,0,0,0,0,0,0,0,0,0,0
3120405,8,4,12,37,20,0,57,204,73,334
3120406,9,0,9,56,34,0,90,330,81,501
3120407,0,0,0,59,21,6,86,202,36,324
3120408,3,0,3,60,19,3,82,105,35,222
3120409,3,0,3,73,29,9,111,275,47,433
3120410,0,0,0,69,28,7,104,194,32,330
3120411,0,0,0,44,8,10,62,133,39,234
3120412,6,0,6,62,34,6,102,223,24,349
3120413,3,3,6,51,27,8,86,163,36,285
3120501,4,6,10,60,14,9,83,219,33,335
3120502,0,3,3,74,30,6,110,213,27,350
3120503,11,11,22,81,30,3,114,249,52,415
3120504,14,6,20,77,35,0,112,300,43,455
3120505,4,3,7,32,24,3,59,153,36,248
3120506,7,0,7,61,15,0,76,200,34,310
3120507,3,0,3,56,8,6,70,126,21,217
3120508,8,3,11,58,19,6,83,185,69,337
3120509,3,0,3,72,34,9,115,209,43,367
3120510,10,0,10,57,16,3,76,189,34,299
3120511,4,0,4,43,6,0,49,127,40,216
3120512,0,0,0,49,7,7,63,141,28,232
3120513,0,0,0,62,23,7,92,150,43,285
3120514,4,3,7,64,24,7,95,237,75,407
3120515,0,0,0,40,19,3,62,179,36,277
3120516,0,0,0,0,0,0,0,6,0,6
3120517,12,3,15,69,30,7,106,233,52,391
3120518,6,7,13,53,22,9,84,179,44,307
3120519,3,0,3,44,19,6,69,153,18,240
3120601,3,0,3,46,24,0,70,182,32,284
3120602,0,0,0,49,18,0,67,176,30,273
3120603,3,0,3,70,26,6,102,187,44,333
3120604,5,0,5,84,35,0,119,243,42,404
3120605,0,0,0,38,16,3,57,98,12,167
3120701,3,0,3,49,34,0,83,158,14,255
3120702,6,3,9,25,24,0,49,197,17,263
3120703,0,0,0,31,12,6,49,84,10,143
3120704,8,0,8,60,24,3,87,263,33,383
3120705,6,3,9,49,21,0,70,162,31,263
3120706,3,3,6,65,33,0,98,408,60,566
3120707,52,11,63,124,29,15,168,414,103,685
3120708,7,3,10,72,20,0,92,241,19,352
3120709,0,0,0,66,28,0,94,277,30,401
3120710,7,0,7,69,24,6,99,291,34,424
3120801,3,0,3,58,35,6,99,167,36,302
3120802,0,0,0,29,18,4,51,110,26,187
3120803,0,0,0,35,18,3,56,102,18,176
3120804,0,3,3,87,44,8,139,280,36,455
3120805,3,0,3,69,24,0,93,161,28,282
3120806,0,0,0,72,25,3,100,156,37,293
3120807,0,0,0,70,42,6,118,277,40,435
3120808,0,0,0,67,15,3,85,206,15,306
3120809,0,0,0,122,36,7,165,238,8,411
3120810,0,0,0,38,21,6,65,156,20,241
3120811,4,0,4,68,28,0,96,185,22,303
3120812,6,0,10,63,23,0,86,190,23,299
3120813,0,0,0,38,27,3,68,100,3,171
3120814,6,0,6,53,24,6,83,198,28,309
3120815,4,0,4,7,7,3,17,59,0,76
3120816,25,8,33,45,19,0,64,271,54,389
3120817,0,0,0,40,24,4,68,140,24,232
3120818,8,4,12,81,34,0,115,275,32,422
3120819,6,0,6,44,15,0,59,111,18,188
3120820,0,0,0,102,44,12,158,233,15,406
3120821,3,0,3,36,12,0,48,161,3,212
3120822,0,6,6,95,30,0,125,243,37,405
3120823,0,0,0,69,14,0,83,134,9,226
3120824,6,0,6,51,25,8,84,163,12,259
3120825,0,0,0,94,43,4,141,212,20,373
3120901,0,0,0,101,21,6,128,246,16,390
3120902,4,0,4,155,39,6,200,286,22,508
3120903,0,0,0,92,34,7,133,279,23,435
3120904,3,0,3,82,19,9,110,187,9,306
3120905,4,0,4,59,10,0,69,155,26,250
3120906,0,0,0,46,17,0,63,110,18,191
3120907,0,0,0,32,11,0,43,38,7,88
3120908,3,0,3,49,18,3,70,130,3,203
3120909,0,0,0,73,23,8,104,124,14,242
3120910,0,0,0,71,25,7,103,158,17,278
3120911,0,3,3,38,18,3,59,140,30,229
3120912,0,3,3,0,0,0,0,3,381,384
3120913,0,0,0,0,0,0,0,0,49,49
3121001,0,0,0,97,23,3,123,196,27,346
3121002,3,0,3,59,28,6,93,149,24,266
3121003,0,6,6,68,19,0,87,171,33,291
3121004,3,0,3,103,25,4,132,189,24,345
3121005,0,0,0,79,21,3,103,126,12,241
3121006,0,0,0,93,24,3,120,156,36,312
3121007,4,0,4,78,20,6,104,165,41,310
3121008,8,0,8,104,32,10,146,259,40,445
3121009,0,0,0,228,45,5,278,429,47,754
3121010,0,0,0,44,20,6,70,96,12,178
3121011,0,0,0,0,0,0,0,0,0,0
3121012,0,0,0,74,17,0,91,140,19,250
3121013,3,21,24,38,6,3,47,74,71,192
3121014,0,0,0,81,33,0,114,208,43,365
3121015,6,0,6,28,6,0,34,84,15,133
3121016,0,5,5,84,22,4,110,200,11,321
3121017,3,0,3,98,37,9,144,258,35,437
3121018,3,0,3,97,40,3,140,277,40,457
3121019,0,4,4,276,60,17,353,506,107,966
3121101,7,0,7,49,19,4,72,137,8,217
3121102,0,0,0,45,19,0,64,135,4,203
3121103,3,0,3,72,21,3,96,160,32,288
3121104,0,0,0,50,16,6,72,158,28,258
3121105,4,3,7,86,28,6,120,245,47,412
3121106,0,3,3,100,46,0,146,223,33,402
3121107,0,0,0,83,34,0,117,244,24,385
3121108,0,0,0,41,13,0,54,118,10,182
3121109,7,3,10,91,31,3,125,276,55,456
3121110,6,4,10,104,26,3,133,320,71,524
3121111,3,0,3,83,20,4,107,166,28,301
3121112,0,0,0,45,16,0,61,137,30,228
3121113,0,0,0,6,6,0,12,25,0,37
3121201,0,0,0,0,0,0,0,0,0,0
3121202,0,3,3,41,21,3,65,265,36,366
3121203,22,0,22,42,15,0,57,224,58,339
3121204,9,0,9,30,19,3,52,183,24,259
3121205,0,0,0,39,17,0,56,130,25,211
3121206,0,0,0,21,10,0,31,124,6,161
3121207,3,3,6,15,15,6,36,106,28,170
3121208,4,5,9,42,15,3,60,188,48,296
3121209,11,0,11,60,30,5,95,259,63,417
3121210,0,0,0,43,7,3,53,120,29,202
3121301,0,0,0,72,24,6,102,208,41,351
3121302,8,0,8,65,27,3,95,180,36,311
3121303,0,0,0,60,19,0,79,170,12,261
3121304,4,0,4,91,37,5,133,213,34,380
3121305,3,0,3,59,16,0,75,158,12,245
3121306,3,0,3,144,43,8,195,279,27,501
3121307,6,0,6,177,47,6,230,325,42,597
3121308,0,0,0,77,31,3,111,155,27,293
3121309,5,0,8,84,35,3,122,333,42,497
3121310,3,0,3,80,32,3,115,267,25,407
3121311,7,0,7,76,45,9,130,250,18,398
3121312,6,6,12,97,37,0,134,236,39,409
3121313,4,0,4,79,38,5,122,300,47,469
3121314,3,0,6,95,19,13,127,250,12,389
3121315,6,0,6,74,16,0,90,183,36,309
3121316,5,0,5,66,39,5,110,243,37,390
3121317,32,0,32,123,36,9,168,472,71,711
3121401,11,35,46,41,28,3,72,161,91,324
3121402,6,0,6,64,30,4,98,226,57,381
3121403,6,0,6,68,21,3,92,226,37,355
3121404,6,0,6,38,16,3,57,110,25,192
3121405,15,3,18,80,41,3,124,303,22,449
3121406,6,0,6,75,36,4,115,250,26,391
3121407,0,3,3,67,14,0,81,158,32,271
3121408,5,7,12,65,27,0,92,216,20,328
3121409,6,0,6,61,23,3,87,217,37,341
3121410,3,0,3,41,29,0,70,177,30,277
3121411,4,4,8,70,48,6,124,282,21,427
3121412,3,3,6,60,32,0,92,209,42,343
3121413,0,0,0,43,29,7,79,136,18,233
3121501,0,0,0,37,6,9,52,81,16,149
3121502,42,8,50,59,38,3,100,224,37,361
3121503,0,0,0,18,6,0,24,75,14,113
3121504,0,0,0,132,37,3,172,265,33,470
3121505,0,0,0,105,23,3,131,194,55,380
3121506,4,0,4,53,10,0,63,147,75,285
3121507,6,52,58,10,3,0,13,80,104,197
3121508,0,0,0,74,38,9,121,218,21,360
3121509,7,0,7,67,40,7,114,225,16,355
3121510,0,3,3,44,23,0,67,153,34,254
3121511,0,0,0,61,22,3,86,186,38,310
3121512,0,3,3,68,31,7,106,265,27,398
3121513,3,0,3,64,27,6,97,176,6,279
3121514,0,0,0,59,21,10,90,169,12,271
3121515,0,0,0,104,15,9,128,219,24,371
3121516,3,0,3,33,11,6,50,119,12,181
3121517,0,0,0,59,38,7,104,167,22,293
3121601,3,3,6,78,26,4,108,226,45,379
3121602,29,6,35,54,19,3,76,263,47,386
3121603,9,3,12,79,33,9,121,266,47,434
3121604,0,0,0,0,3,0,3,3,0,6
3121605,8,0,8,27,13,0,40,112,26,178
3121606,0,0,0,0,0,0,0,0,0,0
3121607,4,0,4,51,18,4,73,136,38,247
3121608,0,0,0,0,0,0,0,0,0,0
3121609,0,0,0,12,12,3,27,60,6,93
3121610,7,0,7,31,22,4,57,132,33,222
3121611,11,0,11,29,21,0,50,122,34,206
3121612,0,0,0,24,6,4,34,65,5,104
3121613,0,0,0,62,19,6,87,173,27,287
3121614,3,0,3,26,19,0,45,137,18,200
3121615,11,0,11,67,25,6,98,250,28,376
3121616,13,3,16,61,34,3,98,246,43,387
3121617,15,3,18,73,45,0,118,318,48,484
3121618,0,0,0,69,18,10,97,179,19,295
3121619,8,0,8,46,27,6,79,168,24,271
3121620,3,0,3,44,13,0,57,108,12,177
3121621,0,0,0,53,25,3,81,140,24,245
3121701,6,0,6,48,24,6,78,170,16,264
3121702,0,0,0,21,8,0,29,68,4,101
3121703,0,0,0,34,12,0,46,97,14,157
3121704,6,3,9,30,15,0,45,215,40,300
3121705,7,7,14,42,29,3,74,288,80,442
3121706,7,3,10,45,21,3,69,208,51,328
3121707,0,3,3,62,31,3,96,260,66,422
3121708,0,0,0,60,24,3,87,257,43,387
3121709,4,0,4,68,16,0,84,179,49,312
3121710,0,0,0,54,26,0,80,180,32,292
3121801,3,0,3,86,16,10,112,200,28,340
3121802,4,3,7,50,15,0,65,119,40,224
3121803,0,0,0,30,12,4,46,124,19,189
3121804,5,0,5,36,16,0,52,210,16,278
3121805,0,0,0,45,29,0,74,118,15,207
3121806,0,0,0,42,20,0,62,143,10,215
3121807,0,3,3,86,18,6,110,167,23,300
3121808,4,0,4,30,28,0,58,130,24,212
3121809,0,0,0,27,18,3,48,96,13,157
3121810,0,0,0,36,17,0,53,95,9,157
3121811,0,0,0,30,9,0,39,165,28,232
3121901,0,0,0,27,14,0,41,70,22,133
3121902,0,0,0,0,0,0,0,0,0,0
3121903,0,0,0,55,20,0,75,239,88,402
3121904,0,3,6,44,19,0,63,142,41,246
3121905,0,0,0,30,6,0,36,121,15,172
3121906,0,0,0,43,17,0,60,125,22,207
3121907,0,0,0,0,0,0,0,32,6,38
3121908,0,0,0,53,24,3,80,172,31,283
3121909,0,0,0,19,18,0,37,97,12,146
3121910,5,0,5,56,19,6,81,218,18,317
3121911,4,0,4,37,19,3,59,109,13,181
3121912,3,0,3,29,24,9,62,109,33,204
3121913,6,0,6,34,10,4,48,115,17,180
3121914,3,0,3,37,25,0,62,116,18,196
3121915,0,0,0,0,0,0,0,0,0,0
3121916,3,0,3,71,26,0,97,216,22,335
3121917,0,0,0,28,27,0,55,133,13,201
3122001,0,0,0,43,16,3,62,127,16,205
3122002,0,0,0,47,21,0,68,162,21,251
3122003,0,0,0,26,15,0,41,112,22,175
3122004,0,0,0,49,12,3,64,146,24,234
3122005,0,0,0,50,7,0,57,161,16,234
3122006,0,3,3,76,28,3,107,193,37,337
3122007,0,0,0,96,27,7,130,221,36,387
3122008,0,0,0,46,25,3,74,196,43,313
3122101,0,0,0,0,0,0,0,6,3,9
3122201,6,3,9,62,21,6,89,224,14,327
3122202,4,0,4,22,10,0,32,157,11,200
3122203,0,0,0,16,14,0,30,195,15,240
3122204,3,0,3,37,4,0,41,117,54,212
3122205,3,3,6,62,17,9,88,246,23,357
3122206,0,0,0,61,15,6,82,153,28,263
3122207,10,0,10,46,17,3,66,150,8,224
3122208,0,0,0,53,30,0,83,166,20,269
3122209,11,3,14,64,29,7,100,229,24,353
3122210,3,0,3,60,15,6,81,204,21,306
3122211,3,3,6,43,18,3,64,165,20,249
3122212,14,6,20,64,15,5,84,218,18,320
3122213,9,0,9,100,14,3,117,284,64,465
3122214,4,6,10,63,22,3,88,184,21,293
3122215,16,58,74,41,6,0,47,126,123,296
3122216,10,89,99,60,24,3,87,194,164,445
3122217,6,3,9,50,21,0,71,150,35,256
3122218,5,6,11,52,20,0,72,254,72,398
3122219,4,0,4,29,9,6,44,137,24,205
3122220,10,0,13,95,26,4,125,260,47,432
3122221,3,3,6,50,7,3,60,126,27,213
3122222,7,0,7,56,19,4,79,168,22,269
3122301,6,0,6,65,12,3,80,157,17,254
3122302,0,0,0,50,20,3,73,121,15,209
3122303,6,0,6,114,27,3,144,302,32,478
3122304,3,0,3,46,26,3,75,191,31,297
3122305,0,0,0,91,25,6,122,198,23,343
3122306,0,0,3,114,36,9,159,250,70,479
3122307,3,0,3,117,50,10,177,276,20,473
3122308,7,6,13,46,17,3,66,288,52,406
3122309,0,0,0,26,15,3,44,118,18,180
3122310,3,0,3,58,21,6,85,195,12,292
3122311,0,0,0,90,29,3,122,212,27,361
3122312,0,0,0,31,22,3,56,148,26,230
3122313,0,0,0,49,21,0,70,145,12,227
3122314,0,0,0,65,13,7,85,158,21,264
3122315,22,26,48,106,37,6,149,384,81,614
3122316,0,0,0,76,15,3,94,133,20,247
3122317,0,0,0,97,28,3,128,202,10,340
3122318,0,0,0,40,7,3,50,124,22,196
3122319,0,0,0,87,24,0,111,179,24,314
3122320,57,52,109,23,10,0,33,309,113,455
3122321,7,3,10,38,18,0,56,187,24,267
3122322,8,0,8,57,23,3,83,187,27,297
3122323,0,0,0,41,13,0,54,163,27,244
3122324,7,0,7,78,32,3,113,251,34,398
3122325,3,0,3,24,15,10,49,144,8,201
3122326,9,0,9,53,25,0,78,162,16,256
3122327,4,0,4,34,5,0,39,128,24,191
3122328,3,0,3,21,6,0,27,143,22,192
3122329,6,0,6,58,18,6,82,236,32,350
3122330,0,0,0,35,16,0,51,174,33,258
3122331,8,3,11,44,16,0,60,185,34,279
3122332,5,0,5,41,12,0,53,113,30,196
3122333,0,4,4,49,23,4,76,123,22,221
3122334,6,0,6,58,21,4,83,158,25,266
3122335,0,0,0,11,8,0,19,163,12,194
3122336,0,0,0,72,22,0,94,176,36,306
3122337,6,3,9,159,38,15,212,290,38,540
3122338,0,0,0,84,32,0,116,198,46,360
3122339,7,0,7,26,21,6,53,146,28,227
3122340,3,3,6,65,24,3,92,231,43,366
3122341,3,3,6,68,21,0,89,270,27,386
3122342,3,0,3,83,22,0,105,226,28,359
3122401,3,6,9,59,28,3,90,254,36,380
3122402,3,0,3,65,13,0,78,116,6,200
3122403,4,0,4,85,26,6,117,203,20,340
3122404,4,0,4,41,15,3,59,216,22,297
3122405,0,5,5,65,19,0,84,177,49,310
3122406,3,6,9,58,27,0,85,161,31,277
3122407,9,3,12,59,33,6,98,258,20,376
3122408,4,0,4,51,17,0,68,165,14,247
3122409,3,3,6,46,18,4,68,81,19,168
3122410,9,0,9,83,26,0,109,277,113,499
3122411,3,6,9,44,21,6,71,184,86,341
3122412,14,3,17,93,14,5,112,241,47,400
3122413,6,0,6,60,24,3,87,242,47,376
3122414,10,6,16,48,15,0,63,185,38,286
3122415,8,0,8,33,7,0,40,183,19,242
3122416,6,3,9,29,24,3,56,180,18,254
3122417,17,6,23,32,22,3,57,324,102,483
3122418,3,0,6,46,12,0,58,142,49,249
3122419,7,4,11,21,3,0,24,138,25,187
3122420,8,0,8,64,42,0,106,271,37,414
3122501,5,3,8,24,23,3,50,149,25,224
3122502,3,3,6,28,6,4,38,117,18,173
3122503,6,0,6,47,14,3,64,146,16,226
3122504,0,0,0,47,19,3,69,151,15,235
3122505,10,3,13,66,33,7,106,112,18,236
3122506,7,85,92,23,19,0,42,131,166,339
3122507,0,0,0,0,0,0,0,0,6,6
3122508,0,0,0,68,27,12,107,194,12,313
3122509,3,0,3,79,31,3,113,220,15,348
3122510,0,0,0,33,4,0,37,97,13,147
3122511,6,4,10,17,18,0,35,249,46,330
3122512,3,3,6,39,20,3,62,151,43,256
3122513,7,0,7,60,38,3,101,315,43,459
3122514,8,0,8,22,25,0,47,242,67,356
3122515,14,7,21,43,17,3,63,268,61,392
3122516,0,6,6,53,33,0,86,308,81,475
3122517,14,3,17,24,18,0,42,211,21,274
3122518,17,7,24,90,65,0,155,565,98,818
3122519,8,0,8,46,25,6,77,218,35,330
3122520,11,3,14,64,35,6,105,232,42,379
3122521,10,0,10,17,15,0,32,179,37,248
3122522,17,6,23,42,36,0,78,319,31,428
3122523,0,0,0,7,0,0,7,32,3,42
3122601,3,3,6,108,30,0,138,277,22,437
3122602,16,6,22,57,10,6,73,275,32,380
3122603,0,0,0,78,24,0,102,200,12,314
3122604,6,0,6,75,28,3,106,217,25,348
3122605,8,0,8,77,32,4,113,202,10,325
3122606,3,6,9,94,27,5,126,276,24,426
3122607,7,3,10,69,23,0,92,200,9,301
3122608,17,6,23,86,41,0,127,308,32,467
3122609,0,0,0,88,28,4,120,246,42,408
3122610,0,0,0,44,10,0,54,93,12,159
3122611,0,6,6,57,13,0,70,175,30,275
3122612,6,0,6,52,27,3,82,183,26,291
3122613,23,0,23,110,37,9,156,315,26,497
3122614,19,0,19,14,21,0,35,191,15,241
3122615,3,0,3,96,24,3,123,282,20,425
3122616,0,0,0,44,28,6,78,197,9,284
3122617,0,0,0,0,0,0,0,0,0,0
3122618,10,0,10,90,15,0,105,247,25,377
3122619,3,0,7,72,35,6,113,224,13,350
3122620,7,0,7,94,12,0,106,135,24,265
3122621,3,0,3,37,16,0,53,151,21,225
3122622,12,0,12,59,20,0,79,297,30,406
3122623,8,0,8,58,23,3,84,174,18,276
3122624,6,3,9,72,24,3,99,206,23,328
3122625,3,5,8,113,22,10,145,171,15,331
3122626,22,11,33,129,43,7,179,505,66,750
3122627,79,9,91,52,26,3,81,509,100,690
3122628,7,3,10,25,18,3,46,179,27,252
3122629,4,3,7,73,20,0,93,158,9,260
3122630,10,0,10,65,0,3,68,169,25,262
3122631,12,0,12,49,30,6,85,157,7,249
3122632,4,0,7,68,28,6,102,206,9,317
3122633,10,3,13,78,18,0,96,279,18,393
3122701,11,0,11,37,17,0,54,292,62,408
3122702,3,3,6,59,21,0,80,297,58,435
3122703,15,0,15,34,35,0,69,343,44,456
3122704,3,3,6,33,32,3,68,223,35,326
3122705,6,0,6,22,10,4,36,226,84,346
3122706,0,0,0,29,13,0,42,173,15,230
3122707,6,0,6,32,14,0,46,271,51,368
3122708,10,3,13,43,36,0,79,451,95,625
3122709,9,0,9,50,29,0,79,462,60,601
3122710,7,8,15,15,17,0,32,193,35,260
3122711,7,3,10,79,30,0,109,441,130,680
3122712,5,0,5,44,25,0,69,390,96,555
3122713,6,6,12,43,42,8,93,398,73,564
3122714,3,0,3,51,40,3,94,358,64,516
3122715,3,3,6,37,28,3,68,344,59,471
3122716,6,0,6,56,27,3,86,265,45,396
3122717,9,25,34,69,25,3,97,336,97,530
3122718,3,0,3,25,19,0,44,237,26,307
3122719,6,0,6,80,31,0,111,322,45,478
3122720,7,0,7,48,34,0,82,296,31,409
3122721,3,0,3,57,14,3,74,294,93,461
3122801,7,0,7,26,15,0,41,134,25,200
3122802,6,3,9,43,23,3,69,130,12,211
3122803,3,0,3,56,13,0,69,124,35,228
3122804,0,0,0,48,18,0,66,225,39,330
3122805,0,0,0,44,17,3,64,135,24,223
3122806,7,3,10,74,30,6,110,212,32,354
3122807,9,6,15,64,22,0,86,198,39,323
3122808,3,0,3,26,10,0,36,261,63,360
3122809,6,4,10,69,12,0,81,199,27,307
3122810,10,3,13,95,22,0,117,243,20,380
3122811,10,3,13,52,23,6,81,236,33,350
3122812,7,3,10,77,36,0,113,284,35,432
3122813,16,0,16,55,19,3,77,288,40,405
3122814,11,0,11,51,38,0,89,197,30,316
3122815,7,3,10,58,31,3,92,252,27,371
3122816,0,0,0,0,0,0,0,0,0,0
3122817,16,6,22,30,39,0,69,293,50,412
3122818,7,0,7,47,23,0,70,139,27,236
3122819,27,4,31,45,22,0,67,321,42,430
3122820,7,6,13,85,28,5,118,272,56,446
3122821,3,0,3,31,20,4,55,108,11,174
3122822,5,4,9,76,31,0,107,207,20,334
3122823,3,0,3,67,45,3,115,299,31,445
3122824,8,0,8,48,23,3,74,188,23,285
3122825,13,3,16,88,18,6,112,272,57,441
3122826,4,6,10,70,19,9,98,223,44,365
3122827,8,5,13,54,16,0,70,340,59,469
3122828,12,4,16,41,16,0,57,278,41,376
3122829,18,0,18,66,31,3,100,247,28,375
3122830,8,7,15,80,24,4,108,266,18,392
3122901,6,3,9,48,22,0,70,256,25,351
3122902,6,0,6,28,4,0,32,105,12,149
3122903,13,6,19,87,15,3,105,235,27,367
3122904,4,3,7,77,18,10,105,179,29,313
3122905,6,0,6,78,15,3,96,206,41,343
3122906,3,0,3,37,21,0,58,220,45,323
3122907,4,0,4,34,22,0,56,247,100,403
3122908,7,0,10,41,24,0,65,298,122,485
3122909,3,0,3,40,21,3,64,261,45,370
3122910,14,0,14,48,25,0,73,245,48,366
3122911,3,0,3,54,14,0,68,195,52,315
3122912,3,3,6,57,41,0,98,355,112,565
3122913,6,3,9,80,12,0,92,184,53,329
3122914,16,4,20,94,23,6,123,285,55,463
3122915,0,0,0,0,0,0,0,0,0,0
3122916,7,3,10,27,23,0,50,278,23,351
3123001,19,8,27,32,34,0,66,265,81,412
3123002,8,0,8,38,15,0,53,176,17,246
3123003,10,0,10,60,29,0,89,233,25,347
3123004,4,0,4,48,25,0,73,246,48,367
3123005,8,3,11,37,21,0,58,311,71,440
3123006,11,0,11,21,31,0,52,264,77,393
3123007,10,5,15,40,34,0,74,332,48,454
3123008,7,4,11,41,20,0,61,254,81,396
3123009,6,0,6,24,33,0,57,353,29,439
3123010,6,5,14,24,26,0,50,261,99,410
3123011,11,3,14,44,23,0,67,383,45,495
3123012,91,5,96,28,13,3,44,265,25,334
3123101,4,0,4,28,24,0,52,144,25,221
3123102,0,0,0,42,23,7,72,176,18,266
3123103,3,0,3,46,37,0,83,205,28,316
3123104,3,3,6,102,38,11,151,294,38,483
3123105,8,0,8,43,23,3,69,249,48,366
3123106,12,0,12,28,30,3,61,271,40,372
3123107,5,6,11,26,10,0,36,133,33,202
3123108,6,3,9,32,12,0,44,197,21,262
3123109,4,0,4,40,24,3,67,208,50,325
3123110,7,3,10,67,29,3,99,352,44,495
3123111,10,0,10,44,13,0,57,143,6,206
3123112,0,0,0,58,20,3,81,206,31,318
3123113,0,0,0,0,0,0,0,5,0,5
3123114,9,4,13,63,20,3,86,212,23,321
3123115,13,0,13,175,63,7,245,544,70,859
3123116,6,3,9,76,30,0,106,268,31,405
3123117,3,3,6,24,17,0,41,119,13,173
3123118,3,6,9,29,20,0,49,199,26,274
3123119,16,6,22,74,36,3,113,249,42,404
3123120,9,8,17,88,43,0,131,351,41,523
3123121,12,0,12,73,22,7,102,229,27,358
3123122,0,0,0,81,20,6,107,189,15,311
3123123,8,0,8,87,35,3,125,279,25,429
3123124,8,3,11,55,31,0,86,290,32,408
3123125,6,0,6,48,11,0,59,168,35,262
3123126,4,0,4,40,27,3,70,182,25,277
3123201,15,0,15,27,27,0,54,191,21,266
3123202,6,0,6,67,24,9,100,200,24,324
3123203,12,3,15,61,24,3,88,173,36,297
3123204,5,0,5,59,19,0,78,155,14,247
3123205,7,0,7,62,19,4,85,147,16,248
3123206,11,0,11,72,31,6,109,311,20,440
3123207,0,0,0,92,23,7,122,187,25,334
3123208,0,0,0,69,22,6,97,126,6,229
3123209,0,0,0,86,21,4,111,173,7,291
3123210,0,0,0,96,23,11,130,257,34,421
3123211,37,87,124,20,17,0,37,208,152,397
3123212,6,0,6,39,15,0,54,116,7,177
3123213,5,3,8,45,32,0,77,223,26,326
3123214,3,0,3,84,29,6,119,248,18,385
3123215,3,3,6,43,26,0,69,136,11,216
3123216,0,0,0,82,26,9,117,155,18,290
3123217,6,0,6,64,11,5,80,185,14,279
3123218,0,0,0,38,14,0,52,79,21,152
3123219,4,0,4,48,14,0,62,158,21,241
3123220,3,0,3,95,18,6,119,260,35,414
3123221,0,0,0,3,0,0,3,15,0,18
3123222,15,0,15,61,12,10,83,199,27,309
3123223,0,0,0,0,0,0,0,11,0,11
3123224,0,0,0,50,8,0,58,166,15,239
3123225,4,6,13,58,41,0,99,192,37,328
3123226,6,3,9,46,17,0,63,161,28,252
3123301,0,0,0,82,24,7,113,156,12,281
3123302,0,3,3,38,15,0,53,169,12,234
3123303,4,0,4,70,32,6,108,216,7,331
3123304,6,3,9,40,26,0,66,215,9,290
3123305,0,0,0,80,20,9,109,131,9,249
3123306,3,0,3,54,16,3,73,151,15,239
3123307,4,0,4,111,23,6,140,179,9,328
3123308,4,0,4,109,36,3,148,262,18,428
3123309,14,0,14,101,37,6,144,315,39,498
3123310,14,0,14,100,34,6,140,327,24,491
3123311,7,3,10,41,20,0,61,171,28,260
3123312,3,3,6,28,25,0,53,144,15,212
3123313,3,0,3,58,12,3,73,144,16,233
3123314,0,0,0,31,12,0,43,129,6,178
3123315,3,0,3,69,18,9,96,190,7,293
3123316,46,15,61,32,15,0,47,259,37,343
3123317,4,0,4,62,24,0,86,161,33,280
3123318,32,7,39,39,13,3,55,207,16,278
3123319,12,7,19,99,25,11,135,256,41,432
3123320,0,0,0,60,6,0,66,143,12,221
3123321,0,4,4,62,14,0,76,181,22,279
3123322,3,0,3,108,32,6,146,208,4,358
3123323,10,3,13,33,17,3,53,199,30,282
3123324,8,5,13,62,30,0,92,245,24,361
3123325,7,3,10,48,16,8,72,197,29,298
3123326,0,0,0,0,0,0,0,0,0,0
3123327,0,0,0,0,0,0,0,0,0,0
3123328,0,0,0,66,20,4,90,132,24,246
3123329,0,0,0,78,37,3,118,263,14,395
3123330,8,0,8,98,32,7,137,222,34,393
3123331,3,0,3,34,10,0,44,112,15,171
3123332,3,3,6,97,32,6,135,291,29,455
3123333,0,0,0,0,0,0,0,0,0,0
3123401,7,0,7,35,19,0,54,162,21,237
3123402,6,0,6,56,10,3,69,115,9,193
3123403,11,0,11,34,6,3,43,128,23,194
3123404,6,3,9,69,27,0,96,291,54,441
3123405,6,3,9,28,26,3,57,250,31,338
3123406,11,0,11,69,12,3,84,354,50,488
3123407,3,4,7,44,19,3,66,168,39,273
3123408,7,4,11,74,37,4,115,367,38,520
3123409,10,3,13,106,35,6,147,243,29,419
3123410,0,0,0,0,0,0,0,0,0,0
3123411,6,0,6,44,15,6,65,149,18,232
3123412,3,3,6,56,6,6,68,156,22,246
3123413,8,3,11,73,29,3,105,302,82,489
3123414,9,0,9,77,21,0,98,386,35,519
3123415,8,8,16,80,40,3,123,471,97,691
3123416,5,4,9,62,24,6,92,295,54,441
3123417,13,0,13,75,26,3,104,304,43,451
3123418,6,3,9,47,29,3,79,298,27,404
3123419,0,0,0,63,19,0,82,259,25,366
3123420,9,6,15,82,21,3,106,218,21,345
3123421,3,3,6,52,21,6,79,137,14,230
3123422,20,0,20,80,29,9,118,205,23,346
3123423,14,4,18,99,36,7,142,299,20,461
3123424,7,5,12,76,27,3,106,194,16,316
3123425,17,6,23,68,36,6,110,260,16,386
3123426,9,0,9,85,40,3,128,306,33,467
3123427,22,8,30,95,25,4,124,301,40,465
3123428,7,0,7,110,46,0,156,274,20,450
3123429,8,6,14,73,16,9,98,204,21,323
3123430,10,0,10,40,28,0,68,199,23,290
3123431,6,0,6,26,15,0,41,144,38,223
3123432,14,0,14,78,19,0,97,252,29,378
3123501,0,0,0,40,29,0,69,264,32,365
3123502,0,0,0,65,11,5,81,134,16,231
3123503,0,0,0,0,0,0,0,0,0,0
3123504,0,0,0,74,15,0,89,184,43,316
3123505,3,0,3,42,6,3,51,115,3,169
3123506,3,0,3,76,12,3,91,149,15,255
3123507,3,0,3,115,30,0,145,279,24,448
3123508,6,0,6,112,22,9,143,223,16,382
3123509,0,0,0,63,18,0,81,203,27,311
3123510,0,0,0,0,0,0,0,3,0,3
3123511,0,0,0,0,0,0,0,0,0,0
3123512,3,0,3,110,21,4,135,197,28,360
3123513,3,0,3,59,15,6,80,174,12,266
3123514,0,0,0,36,11,0,47,172,16,235
3123515,0,0,0,118,39,6,163,326,28,517
3123516,3,0,3,66,19,0,85,187,16,288
3123517,4,0,4,45,19,3,67,251,28,346
3123518,0,0,0,100,18,3,121,199,14,334
3123519,0,0,0,79,15,0,94,152,33,279
3123520,6,0,6,53,18,0,71,297,30,398
3123521,6,0,6,43,23,6,72,140,55,267
3123522,76,30,106,35,12,0,47,279,64,390
3123523,3,0,3,111,48,10,169,264,62,495
3123524,9,0,9,62,22,6,90,159,22,271
3123525,0,0,0,41,16,3,60,146,6,212
3123526,3,3,6,103,43,0,146,328,36,510
3123601,0,0,0,0,0,0,0,0,0,0
3123602,0,23,23,129,20,7,156,298,84,538
3123603,0,0,0,0,0,0,0,9,0,9
3123604,4,3,7,55,23,0,78,348,49,475
3123605,0,0,0,37,3,0,40,158,34,232
3123606,41,3,44,17,24,0,41,203,15,259
3123607,6,3,9,40,30,0,70,283,33,386
3123608,3,0,3,49,22,0,71,242,38,351
3123609,6,0,6,44,22,3,69,212,7,288
3123610,0,0,0,18,15,4,37,247,53,337
3123611,14,0,14,54,28,0,82,321,58,461
3123612,10,5,15,77,34,9,120,249,52,421
3123613,11,0,11,80,45,9,134,262,36,432
3123614,13,3,16,95,42,13,150,355,24,529
3123615,14,3,17,3,9,0,12,160,15,187
3123616,0,0,0,139,29,12,180,306,23,509
3123701,10,0,10,40,20,3,63,232,26,321
3123702,58,11,69,112,52,0,164,576,86,826
3123703,6,0,6,17,18,9,44,131,9,184
3123704,0,0,0,0,0,0,0,0,0,0
3123705,0,0,0,0,0,0,0,0,0,0
3123706,3,0,3,45,21,0,66,148,3,217
3123707,18,7,25,31,21,0,52,206,40,298
3123708,18,13,31,0,15,0,15,389,71,475
3123709,3,3,6,43,14,0,57,179,23,259
3123710,3,0,3,107,16,7,130,148,39,317
3123711,0,0,0,127,23,3,153,243,25,421
3123712,0,0,0,85,17,0,102,229,33,364
3123713,20,3,23,72,38,0,110,302,46,458
3123714,45,8,53,6,15,0,21,279,49,349
3123715,6,7,13,73,27,0,100,209,56,365
3123716,9,3,12,64,20,0,84,203,16,303
3123717,0,0,0,80,25,0,105,239,34,378
3123718,6,3,9,84,33,0,117,187,15,319
3123719,4,3,7,110,25,5,140,224,37,401
3123720,0,5,5,58,15,0,73,218,25,316
3123721,6,0,6,69,31,0,100,214,13,327
3123722,0,7,7,83,34,3,120,223,29,372
3123723,4,0,4,53,14,4,71,173,6,250
3123724,4,0,4,51,24,9,84,199,18,301
3123725,41,10,51,0,9,0,9,275,43,327
3123801,0,0,0,38,12,3,53,158,6,217
3123802,0,0,0,85,18,7,110,288,26,424
3123803,7,0,7,63,16,0,79,262,64,405
3123804,9,0,9,57,21,5,83,247,23,353
3123805,3,3,6,43,6,4,53,203,28,284
3123806,8,0,8,60,17,0,77,229,14,320
3123807,5,0,5,44,9,3,56,120,9,185
3123808,6,0,6,44,20,6,70,190,25,285
3123809,13,0,13,45,18,0,63,205,43,311
3123810,6,3,9,94,24,0,118,256,42,416
3123811,3,3,6,30,18,0,48,150,22,220
3123812,3,3,6,58,19,4,81,201,18,300
3123813,3,0,3,41,31,3,75,282,32,389
3123814,60,4,64,37,15,0,52,357,46,455
3123815,3,3,6,41,3,0,44,173,19,236
3123816,0,0,0,66,21,6,93,157,38,288
3123817,3,0,3,30,6,3,39,259,28,326
3123818,3,3,6,48,15,0,63,218,33,314
3123819,8,4,12,41,40,0,81,383,64,528
3123820,0,6,6,40,5,0,45,326,36,407
3123821,7,90,97,18,6,0,24,66,148,238
3123822,7,0,7,31,9,0,40,191,6,237
3123823,12,0,12,65,12,3,80,231,30,341
3123824,10,3,13,74,24,0,98,549,118,765
3123825,10,7,17,29,26,0,55,254,95,404
3123826,4,0,4,81,26,3,110,267,20,397
3123827,6,0,6,44,12,6,62,168,16,246
3123828,0,0,0,62,23,3,88,265,21,374
3123829,0,0,0,47,27,3,77,267,25,369
3123830,0,3,3,33,20,4,57,221,45,323
3123831,11,3,14,21,41,0,62,338,59,459
3123832,3,0,3,39,12,0,51,240,56,347
3123833,5,0,5,33,17,6,56,349,64,469
3123834,6,0,6,52,15,0,67,301,93,461
3123835,3,68,71,61,23,6,90,277,171,538
3123836,0,0,0,54,23,0,77,205,24,306
3123837,7,0,7,42,18,0,60,129,24,213
3123838,4,0,4,63,28,0,91,220,27,338
3123839,7,0,7,53,21,3,77,214,31,322
3123840,0,0,0,38,15,3,56,201,38,295
3123841,0,0,0,0,0,0,0,14,3,17
3123901,11,3,14,80,19,4,103,237,24,364
3123902,9,7,16,55,20,3,78,220,35,333
3123903,8,3,11,51,26,0,77,199,22,298
3123904,9,6,15,53,41,0,94,333,47,474
3123905,12,0,12,58,12,7,77,162,17,256
3123906,3,7,10,45,27,0,72,253,14,339
3123907,14,0,14,61,28,0,89,315,41,445
3123908,11,0,11,58,19,3,80,244,23,347
3123909,9,3,12,83,30,0,113,281,33,427
3123910,0,0,0,50,18,3,71,187,25,283
3123911,3,0,3,128,27,4,159,325,24,508
3123912,4,0,4,58,37,5,100,294,54,448
3123913,14,6,20,70,34,9,113,340,81,534
3123914,8,0,8,65,41,3,109,471,42,622
3123915,10,0,10,71,23,4,98,234,9,341
3123916,6,0,6,60,13,0,73,188,29,290
3123917,7,0,7,49,16,6,71,221,27,319
3123918,11,3,14,50,29,3,82,191,31,304
3123919,19,4,23,57,24,0,81,319,45,445
3124001,6,3,9,31,15,3,49,195,23,267
3124002,3,3,6,37,27,0,64,144,12,220
3124003,0,0,0,0,0,0,0,0,0,0
3124004,0,0,0,82,26,0,108,154,23,285
3124005,5,3,8,59,29,3,91,218,38,347
3124006,0,0,0,53,28,0,81,182,37,300
3124007,0,0,0,30,17,0,47,165,17,229
3124008,3,0,6,58,27,0,85,202,25,312
3124009,0,0,0,31,23,0,54,152,32,238
3124010,7,4,11,51,33,0,84,274,17,375
3124011,6,3,9,85,26,0,111,210,34,355
3124012,7,0,7,63,29,3,95,291,23,409
3124013,30,7,37,15,43,0,58,522,84,664
3124014,91,75,166,37,30,4,71,394,154,619
3124015,4,0,4,31,15,0,46,254,29,329
3124016,4,0,4,37,18,0,55,157,8,220
3124017,12,0,12,68,31,3,102,225,30,357
3124018,4,4,8,49,27,0,76,162,30,268
3124019,3,7,14,60,53,0,113,588,117,818
3124020,4,0,4,35,22,0,57,166,14,237
3124021,9,6,15,80,35,3,118,269,21,408
3124022,9,6,15,78,29,0,107,195,23,325
3124023,3,0,3,15,18,0,33,131,15,179
3124101,6,0,6,49,17,0,66,122,26,214
3124102,0,0,0,0,0,0,0,0,0,0
3124103,0,0,0,54,27,0,81,196,16,293
3124104,0,0,0,17,14,0,31,131,105,267
3124105,0,0,0,71,19,0,90,215,14,319
3124106,6,0,6,68,31,6,105,200,20,325
3124107,0,0,0,49,25,0,74,129,22,225
3124108,3,0,3,55,14,0,69,137,27,233
3124109,4,0,4,72,23,3,98,215,16,329
3124110,3,0,3,75,23,0,98,157,29,284
3124111,5,0,5,49,20,0,69,222,24,315
3124112,3,0,3,63,19,0,82,198,13,293
3124113,0,3,3,38,10,3,51,114,15,180
3124201,0,0,0,55,21,10,86,164,34,284
3124202,4,0,4,52,20,3,75,180,16,271
3124203,4,0,4,43,14,3,60,178,27,265
3124204,3,0,3,48,15,6,69,129,21,219
3124205,0,0,0,72,22,0,94,180,12,286
3124206,0,0,0,81,30,6,117,236,9,362
3124207,4,0,4,79,28,3,110,227,21,358
3124208,3,0,3,57,18,3,78,139,9,226
3124209,4,0,4,58,10,0,68,121,12,201
3124210,0,0,0,40,10,10,60,120,7,187
3124211,4,0,4,114,24,10,148,229,14,391
3124212,0,0,0,33,12,4,49,73,10,132
3124213,0,0,0,65,23,6,94,153,19,266
3124214,6,3,9,83,25,4,112,260,24,396
3124215,10,0,10,63,22,6,91,221,9,321
3124216,0,0,3,77,21,6,104,216,12,332
3124217,13,3,16,39,22,3,64,261,18,343
3124218,4,0,4,49,17,4,70,183,15,268
3124219,0,0,0,29,3,0,32,56,4,92
3124220,0,0,0,108,16,7,131,156,18,305
3124221,3,0,3,51,16,3,70,153,20,243
3124222,0,0,0,59,21,7,87,234,18,339
3124223,0,0,0,28,13,0,41,119,3,163
3124224,4,0,4,38,20,0,58,151,6,215
3124225,3,0,3,57,20,3,80,156,21,257
3124226,0,3,3,40,19,5,64,95,9,168
3124227,0,0,0,62,22,9,93,197,3,293
3124228,21,6,27,38,22,0,60,169,9,238
3124229,11,3,14,77,31,3,111,313,18,442
3124230,3,0,3,98,23,6,127,206,6,339
3124231,0,0,0,33,9,0,42,126,13,181
3124232,3,0,3,30,15,0,45,125,12,182
3124233,14,5,19,74,46,7,127,316,33,476
3124234,6,0,6,53,38,10,101,207,3,311
3124235,7,0,7,47,22,0,69,219,15,303
3124236,0,0,0,77,28,0,105,228,18,351
3124237,4,0,4,58,21,3,82,119,15,216
3124238,5,0,5,48,25,7,80,161,10,251
3124301,3,0,3,74,14,3,91,195,10,296
3124302,6,6,12,38,25,6,69,183,21,273
3124303,6,0,6,119,31,11,161,272,18,451
3124304,0,3,3,10,3,0,13,15,9,37
3124305,50,3,53,38,14,0,52,204,30,286
3124306,0,0,0,128,24,8,160,258,33,451
3124307,3,3,6,108,27,10,145,280,28,453
3124308,0,5,5,42,18,0,60,173,19,252
3124309,0,0,0,101,26,6,133,196,15,344
3124310,0,0,0,70,26,0,96,195,18,309
3124311,35,0,35,58,37,0,95,244,4,343
3124312,0,0,3,82,27,3,112,174,27,313
3124313,0,0,0,58,29,6,93,171,32,296
3124314,0,0,0,30,15,6,51,143,20,214
3124315,3,3,6,77,27,7,111,205,30,346
3124316,6,0,6,62,18,4,84,172,22,278
3124317,0,0,0,56,20,9,85,79,16,180
3124318,3,3,6,56,17,0,73,191,18,282
3124401,0,3,3,33,9,3,45,61,7,113
3124402,0,0,0,42,12,6,60,95,14,169
3124403,4,0,4,68,20,0,88,144,8,240
3124404,0,0,0,19,3,9,31,87,13,131
3124405,3,0,3,81,24,3,108,236,29,373
3124406,3,0,3,103,19,7,129,181,30,340
3124407,5,0,5,90,15,3,108,177,15,300
3124408,0,0,0,110,17,5,132,207,17,356
3124409,0,0,0,54,27,3,84,148,10,242
3124410,0,0,0,0,0,0,0,0,0,0
3124411,0,0,0,0,0,0,0,0,0,0
3124412,3,3,6,66,20,6,92,146,9,247
3124413,7,0,7,83,26,0,109,241,9,359
3124414,0,0,0,116,24,7,147,233,25,405
3124415,0,0,0,46,10,0,56,98,4,158
3124416,0,0,0,133,26,9,168,193,7,368
3124417,0,0,0,55,21,0,76,152,24,252
3124418,0,0,0,61,15,0,76,127,9,212
3124419,0,0,0,70,33,3,106,150,15,271
3124420,0,0,0,128,29,0,157,238,53,448
3124421,0,0,0,103,19,7,129,191,27,347
3124422,0,0,0,27,18,3,48,141,14,203
3124423,0,3,3,90,27,0,117,311,53,481
3124424,0,0,0,98,25,8,131,211,5,347
3124425,3,3,6,97,27,3,127,259,12,398
3124426,0,0,0,72,27,0,99,118,9,226
3124427,0,0,0,78,23,10,111,137,27,275
3124428,0,0,0,53,18,0,71,189,21,281
3124429,4,0,4,178,24,10,212,311,25,548
3124430,3,0,3,213,33,9,255,351,16,622
3124431,15,0,15,69,24,3,96,251,30,377
3124432,0,0,0,83,33,6,122,214,20,356
3124433,3,0,3,75,30,0,105,235,15,355
3124434,0,0,0,45,30,7,82,175,6,263
3124435,5,0,5,101,39,5,145,268,32,445
3124436,3,0,3,73,11,7,91,152,15,258
3124437,0,0,0,70,0,5,75,85,13,173
3124438,6,0,6,95,31,9,135,215,6,356
3124439,0,0,0,67,24,0,91,146,40,277
3124440,0,0,0,70,14,3,87,137,5,229
3124441,0,0,0,67,23,8,98,113,18,229
3124442,0,0,0,60,21,3,84,127,29,240
3124443,0,0,0,128,20,6,154,249,13,416
3124444,0,3,3,79,17,7,103,117,12,232
3124445,0,4,4,88,15,3,106,212,13,331
3124501,0,0,0,301,61,15,377,438,23,838
3124502,0,0,0,52,10,0,62,59,18,139
3124503,6,0,6,132,37,3,172,247,34,453
3124504,0,0,0,76,20,4,100,197,34,331
3124505,0,0,0,114,40,14,168,202,16,386
3124506,0,0,0,75,31,6,112,203,25,340
3124507,7,0,7,48,11,0,59,156,12,227
3124508,0,0,0,272,45,6,323,295,35,653
3124509,10,0,10,127,32,6,165,286,35,486
3124510,3,0,3,119,43,6,168,332,28,528
3124511,0,0,0,69,10,6,85,166,21,272
3124512,0,0,0,105,35,9,149,246,29,424
3124601,0,0,0,6,3,0,9,13,0,22
3124602,0,0,0,77,24,6,107,170,31,308
3124603,3,0,3,151,44,12,207,344,15,566
3124604,0,0,0,77,12,3,92,147,16,255
3124605,0,0,0,41,17,3,61,182,22,265
3124606,0,0,0,0,0,0,0,15,0,15
3124607,7,0,7,109,52,6,167,436,32,635
3124608,0,0,0,75,18,0,93,112,13,218
3124609,0,0,0,73,32,6,111,207,29,347
3124610,0,0,0,88,19,3,110,232,25,367
3124611,6,0,6,97,41,3,141,294,26,461
3124612,6,0,6,24,21,0,45,134,6,185
3124613,3,0,3,86,22,0,108,182,32,322
3124614,9,8,17,26,14,0,40,176,31,247
3124615,0,0,0,21,3,0,24,74,20,118
3124616,3,0,3,63,33,6,102,155,24,281
3124617,0,0,0,135,45,9,189,327,43,559
3124618,8,0,8,15,15,0,30,198,19,247
3124619,3,0,3,46,25,0,71,162,26,259
3124620,3,3,6,41,18,0,59,183,19,261
3124621,3,0,3,39,14,0,53,274,24,351
3124622,3,0,3,29,4,0,33,163,5,201
3124623,3,0,3,81,29,0,110,420,44,574
3124624,0,0,0,116,41,10,167,370,31,568
3124625,4,0,4,62,19,3,84,163,36,283
3124626,0,0,0,103,29,0,132,194,18,344
3124627,0,0,0,77,19,8,104,240,35,379
3124628,5,0,5,113,31,7,151,273,22,446
3124629,4,0,4,50,25,0,75,245,39,359
3124630,0,0,0,0,0,0,0,0,0,0
3124631,0,0,0,3,0,0,3,0,0,3
3124701,0,3,3,67,25,3,95,233,37,365
3124702,6,0,6,34,26,3,63,181,5,249
3124703,6,0,6,85,16,0,101,160,19,280
3124704,0,4,4,96,33,3,132,266,28,426
3124705,4,0,4,88,31,8,127,298,22,447
3124706,0,0,0,68,21,6,95,169,9,273
3124707,0,3,3,117,28,6,151,236,28,415
3124708,3,0,3,79,25,3,107,248,32,387
3124709,6,0,6,53,18,3,74,104,21,199
3124710,6,0,6,73,18,0,91,159,13,263
3124711,0,3,3,64,29,3,96,242,27,365
3124712,3,0,3,38,10,3,51,131,4,186
3124713,3,0,3,62,12,0,74,138,6,218
3124714,0,0,0,35,14,6,55,120,18,193
3124715,0,0,0,76,27,5,108,151,14,273
3124716,0,0,0,65,18,6,89,105,6,200
3124717,6,0,6,37,21,12,70,135,41,246
3124718,12,3,15,3,31,0,34,424,33,491
3124719,0,0,0,0,0,0,0,0,0,0
3124720,0,0,0,50,7,3,60,113,27,200
3124721,3,0,3,101,15,0,116,218,31,365
3124722,3,0,3,48,23,0,71,163,14,248
3124723,0,0,0,70,17,6,93,153,32,278
3124724,0,0,0,58,18,3,79,78,15,172
3124801,3,0,3,28,28,0,56,114,9,179
3124802,6,3,9,22,14,0,36,112,18,166
3124803,3,0,3,79,19,10,108,159,12,279
3124804,244,49,293,0,4,0,4,524,115,643
3124805,0,0,0,0,0,0,0,5,3,8
3124806,0,0,0,81,37,6,124,234,21,379
3124807,43,0,43,77,13,5,95,289,28,412
3124808,4,0,4,140,32,9,181,251,28,460
3124809,0,0,0,72,19,9,100,166,27,293
3124810,0,3,3,59,23,6,88,125,31,244
3124811,6,0,6,77,19,3,99,251,14,364
3124812,0,0,0,39,7,3,49,100,24,173
3124813,0,0,0,59,18,7,84,155,3,242
3124814,0,0,0,90,23,11,124,180,19,323
3124815,25,0,25,37,13,6,56,167,34,257
3124816,3,0,6,179,50,8,237,323,27,587
3124817,0,0,0,140,28,16,184,281,31,496
3124818,4,0,4,106,37,4,147,230,34,411
3124819,0,0,0,85,28,8,121,240,23,384
3124820,3,0,3,56,12,7,75,144,25,244
3124821,8,0,8,91,24,6,121,292,50,463
3124822,3,0,3,70,36,6,112,200,15,327
3124823,6,0,6,67,26,7,100,173,18,291
3124824,5,3,8,98,36,6,140,261,24,425
3124825,4,0,4,79,35,6,120,221,25,366
3124826,3,0,3,53,0,4,57,155,6,218
3124827,0,0,0,0,0,0,0,0,0,0
3124828,0,6,6,67,21,0,88,273,30,391
3124829,0,5,5,91,30,3,124,300,38,462
3124830,3,0,3,42,19,0,61,147,15,223
3124831,6,3,9,100,31,0,131,234,23,388
3124832,0,0,0,157,29,9,195,285,64,544
3124833,3,0,3,97,22,9,128,227,19,374
3124834,0,0,0,68,23,0,91,162,14,267
3124835,3,0,6,41,24,3,68,195,25,288
3124836,6,3,9,29,9,0,38,176,48,262
3124837,0,0,0,72,21,6,99,204,60,363
3124838,24,3,27,38,29,4,71,170,24,265
3124839,13,3,16,75,20,4,99,274,64,437
3124840,3,0,3,63,18,0,81,285,57,423
3124841,3,0,3,36,16,0,52,141,9,202
3124842,0,0,0,74,31,3,108,158,19,285
3124843,3,0,3,111,17,3,131,199,14,344
3124844,0,0,0,47,23,4,74,168,12,254
3124845,0,0,0,0,0,0,0,0,0,0
3124846,3,0,3,83,9,0,92,167,20,279
3124847,3,3,6,42,4,0,46,143,33,222
3124901,3,0,3,52,5,3,60,146,25,231
3124902,3,0,3,55,23,6,84,140,18,242
3124903,4,3,7,58,14,8,80,182,21,283
3124904,0,0,0,63,15,9,87,115,30,232
3124905,6,0,6,66,24,0,90,159,25,274
3124906,3,0,3,66,4,0,70,151,17,238
3124907,0,0,0,110,23,7,140,158,36,334
3124908,0,0,0,80,11,9,100,149,12,261
3124909,0,0,0,115,34,12,161,216,36,413
3124910,0,0,0,184,37,6,227,312,34,573
3124911,0,0,0,232,30,16,278,332,69,679
3124912,3,0,3,188,35,13,236,295,22,553
3124913,0,0,0,86,19,0,105,200,15,320
3124914,0,0,0,126,41,8,175,246,29,450
3124915,3,3,6,110,18,7,135,148,19,302
3124916,3,0,3,82,34,0,116,318,32,466
3124917,0,0,0,46,24,6,76,203,25,304
3124918,0,0,0,50,28,0,78,160,13,251
3124919,0,0,0,62,10,3,75,100,9,184
3124920,0,0,0,119,13,4,136,237,12,385
3124921,3,0,3,88,15,6,109,214,21,344
3124922,0,0,0,118,30,6,154,188,15,357
3124923,0,0,0,135,32,4,171,296,18,485
3124924,0,0,0,110,17,6,133,188,13,334
3124925,0,0,0,120,28,0,148,233,17,398
3124926,0,0,0,261,41,13,315,423,21,759
3124927,0,0,0,163,36,9,208,267,18,493
3124928,0,0,0,316,41,15,372,435,48,855
3124929,0,0,0,78,19,6,103,101,13,217
3124930,0,0,0,136,31,15,182,203,16,401
3124931,0,0,0,125,34,3,162,282,19,463
3125001,8,0,8,85,19,3,107,182,55,344
3125002,0,0,0,97,15,7,119,171,29,319
3125003,0,0,0,88,17,6,111,159,59,329
3125004,0,0,0,80,26,8,114,279,43,436
3125005,0,0,0,56,22,0,78,168,28,274
3125006,6,0,6,86,32,3,121,316,33,470
3125007,4,0,4,63,38,3,104,248,27,379
3125008,5,0,5,64,24,0,88,201,25,314
3125009,38,80,118,30,19,0,49,209,141,399
3125010,0,0,0,80,34,3,117,176,3,296
3125011,0,0,0,92,26,4,122,229,22,373
3125012,0,0,0,76,35,6,117,261,24,402
3125013,0,0,0,42,9,0,51,87,7,145
3125014,0,0,0,103,32,0,135,268,12,415
3125015,3,0,3,65,29,6,100,240,41,381
3125016,0,0,0,59,22,3,84,149,11,244
3125017,3,0,3,105,34,5,144,291,22,457
3125101,0,0,0,544,86,38,668,889,147,1704
3125102,0,0,0,139,20,9,168,273,37,478
3125103,0,0,0,330,44,19,393,418,16,827
3125104,0,0,0,80,9,4,93,200,43,336
3125105,3,0,3,253,37,12,302,269,29,600
3125106,0,0,0,68,15,3,86,122,17,225
3125107,0,0,0,142,25,6,173,213,18,404
3125108,0,4,4,91,12,6,109,174,37,320
3125109,0,0,0,60,25,0,85,235,18,338
3125110,0,0,0,117,9,7,133,199,51,383
3125111,3,0,3,124,30,13,167,174,45,386
3125112,0,0,0,102,21,4,127,118,21,266
3125201,3,0,3,85,21,0,106,193,15,314
3125202,65,18,83,9,18,0,27,286,45,358
3125203,6,0,6,82,33,9,124,212,20,356
3125204,3,0,3,59,20,0,79,206,24,309
3125205,0,0,0,44,7,0,51,144,11,206
3125206,0,0,0,64,15,0,79,150,6,235
3125207,0,0,0,95,42,6,143,304,25,472
3125208,0,0,0,171,32,0,203,334,15,552
3125209,0,0,0,151,57,12,220,360,63,643
3125210,3,0,3,98,22,7,127,246,24,397
3125211,0,0,0,69,35,0,104,236,9,349
3125212,0,0,0,9,3,0,12,9,3,24
3125213,3,0,3,69,36,6,111,276,9,396
3125214,6,0,6,91,41,6,138,295,13,446
3125215,3,0,3,66,27,3,96,189,3,288
3125216,0,0,0,72,31,3,106,247,9,362
3125217,0,0,0,50,15,0,65,111,3,179
3125218,5,0,5,62,13,0,75,205,23,303
3125219,5,0,5,53,17,3,73,114,12,199
3125220,0,0,0,82,28,6,116,233,24,373
3125221,0,0,0,0,0,0,0,0,0,0
3125222,9,0,9,55,20,0,75,212,15,302
3125223,0,0,0,38,14,3,55,126,8,189
3125224,3,0,3,78,32,3,113,207,3,323
3125225,10,0,10,65,23,6,94,191,17,302
3125226,0,3,3,62,34,3,99,143,21,263
3125227,6,0,6,71,23,0,94,191,3,288
3125228,3,0,3,82,39,6,127,207,9,343
3125229,4,0,4,41,19,0,60,140,4,204
3125230,0,4,4,78,31,0,109,321,72,502
3125231,16,40,56,17,4,0,21,133,72,226
3125232,6,0,6,99,29,7,135,300,30,465
3125233,11,0,11,65,20,0,85,190,14,289
3125234,0,0,0,57,32,9,98,214,38,350
3125235,0,0,0,108,40,0,148,273,27,448
3125236,4,0,4,132,38,3,173,348,7,528
3125237,37,8,45,32,12,4,48,227,28,303
3125238,0,3,3,124,30,0,154,229,19,402
3125239,3,0,3,103,27,6,136,219,13,368
3125301,3,0,3,22,12,3,37,94,9,140
3125302,0,0,0,33,16,0,49,153,32,234
3125303,0,0,0,73,16,0,89,248,55,392
3125304,27,0,27,47,24,6,77,245,26,348
3125305,3,0,3,67,11,0,78,129,20,227
3125306,0,0,0,81,24,4,109,222,15,346
3125307,4,0,4,90,23,0,113,207,15,335
3125308,0,0,0,70,18,0,88,200,54,342
3125309,0,0,0,0,0,0,0,0,0,0
3125310,10,5,15,37,26,0,63,276,45,384
3125311,28,0,28,91,24,0,115,236,35,386
3125312,0,0,0,93,26,3,122,231,36,389
3125313,9,0,9,86,45,0,131,512,69,712
3125314,3,0,3,44,22,0,66,111,19,196
3125315,0,0,0,6,0,0,6,4,0,10
3125316,0,0,0,55,16,0,71,207,40,318
3125317,3,0,3,128,49,3,180,405,75,660
3125318,6,3,9,74,12,0,86,261,47,394
3125319,0,0,0,58,17,6,81,177,21,279
3125320,0,0,0,57,36,3,96,235,25,356
3125321,0,0,0,20,23,0,43,168,27,238
3125322,6,0,6,41,39,0,80,357,16,453
3125323,0,0,0,4,9,0,13,53,23,89
3125401,0,0,0,0,0,0,0,0,0,0
3125402,9,0,9,63,25,6,94,253,22,369
3125403,7,0,7,88,30,3,121,293,23,437
3125404,0,0,0,53,5,7,65,124,18,207
3125405,0,0,0,88,31,3,122,292,17,431
3125406,3,0,3,27,6,6,39,123,0,162
3125407,3,0,3,57,21,6,84,156,29,269
3125408,0,0,0,33,13,3,49,121,21,191
3125409,0,0,0,86,36,0,122,215,42,379
3125410,0,4,4,45,16,3,64,152,10,226
3125501,3,0,3,46,13,0,59,93,3,155
3125502,0,0,0,53,15,0,68,87,15,170
3125503,0,0,0,71,23,0,94,104,12,210
3125504,0,0,0,131,33,4,168,212,18,398
3125505,3,0,3,25,4,3,32,100,15,147
3125506,0,0,0,165,29,9,203,196,24,423
3125507,0,0,0,108,14,7,129,155,12,296
3125508,0,0,0,67,42,0,109,183,6,298
3125509,0,0,0,68,29,3,100,139,8,247
3125510,0,0,0,30,21,3,54,118,3,175
3125511,0,0,0,88,26,0,114,199,19,332
3125512,3,0,3,63,23,3,89,204,10,303
3125513,0,0,0,73,24,7,104,204,25,333
3125514,0,0,0,92,17,9,118,148,6,272
3125515,0,0,0,152,30,10,192,169,7,368
3125516,0,0,0,87,53,9,149,220,21,390
3125517,0,0,0,93,23,4,120,225,18,363
3125518,4,0,4,181,35,7,223,290,22,535
3125519,0,0,0,99,30,6,135,186,5,326
3125520,0,0,0,62,27,3,92,181,17,290
3125521,0,0,0,3,0,0,3,13,12,28
3125522,3,0,3,230,40,9,279,203,40,522
3125523,0,0,0,62,14,6,82,128,7,217
3125524,0,0,0,120,26,3,149,191,20,360
3125525,3,0,3,238,46,15,299,350,12,661
3125526,0,0,0,3,6,0,9,20,3,32
3125527,4,0,4,35,12,0,47,112,11,170
3125528,0,0,0,28,15,0,43,148,20,211
3125529,0,0,0,81,20,0,101,112,22,235
3125530,0,0,0,140,28,9,177,218,27,422
3125531,0,0,0,50,7,0,57,99,9,165
3125532,3,0,3,261,49,21,331,360,84,775
3125533,3,0,3,229,41,6,276,292,40,608
3125534,12,7,19,0,35,0,35,466,34,535
3125535,0,0,0,109,24,9,142,190,11,343
3125536,0,0,0,63,18,0,81,127,12,220
3125601,0,0,0,89,33,0,122,130,13,265
3125602,0,0,0,78,21,0,99,142,12,253
3125603,0,0,0,0,0,0,0,0,0,0
3125604,0,0,3,90,22,0,112,183,22,317
3125605,0,0,0,72,6,3,81,150,5,236
3125606,0,0,0,0,0,0,0,0,0,0
3125607,0,0,0,0,0,0,0,0,0,0
3125608,3,0,3,59,6,3,68,104,12,184
3125609,0,0,0,109,28,4,141,171,21,333
3125610,0,0,0,135,20,8,163,176,9,348
3125611,3,0,3,186,43,9,238,286,16,540
3125612,0,0,0,143,14,9,166,247,25,438
3125613,0,0,0,103,23,9,135,261,18,414
3125614,0,0,0,208,62,13,283,326,46,655
3125615,0,0,0,132,24,6,162,190,9,361
3125616,0,0,0,163,34,7,204,194,18,416
3125617,3,0,3,84,30,0,114,111,24,249
3125618,0,0,0,63,24,9,96,147,13,256
3125619,4,0,4,53,19,6,78,196,27,301
3125620,3,0,3,79,27,3,109,211,15,335
3125621,0,0,0,80,18,6,104,235,20,359
3125622,3,0,3,89,35,0,124,205,6,335
3125623,3,0,3,106,29,0,135,218,12,365
3125624,3,0,3,65,33,0,98,239,6,343
3125625,0,0,4,80,22,6,108,185,9,302
3125626,0,0,0,58,28,3,89,183,17,289
3125627,3,0,3,193,45,4,242,436,44,722
3125628,6,0,6,71,30,6,107,244,23,374
3125629,3,0,3,78,23,0,101,221,21,343
3125630,3,0,3,77,30,6,113,201,24,338
3125631,4,0,4,58,31,5,94,173,21,288
3125632,0,0,0,48,19,0,67,142,9,218
3125633,3,6,9,79,12,0,91,187,19,297
3125634,8,0,8,66,42,3,111,262,26,399
3125701,30,0,30,35,21,3,59,193,0,252
3125702,6,0,6,84,16,0,100,173,35,308
3125703,3,0,3,45,27,0,72,148,20,240
3125704,0,0,0,145,29,7,181,389,58,628
3125705,0,0,0,329,53,24,406,553,70,1029
3125801,0,0,0,124,26,10,160,169,24,353
3125802,3,0,3,122,30,6,158,131,23,312
3125803,0,0,0,71,17,3,91,141,21,253
3125804,0,0,0,106,38,3,147,208,26,381
3125805,0,0,0,99,6,3,108,114,17,239
3125806,0,0,0,47,5,0,52,82,10,144
3125807,0,0,0,42,13,0,55,126,52,233
3125808,3,0,3,77,9,3,89,124,14,227
3125809,3,0,3,114,32,6,152,166,20,338
3125810,3,0,3,80,43,9,132,256,21,409
3125811,0,0,0,62,12,7,81,129,23,233
3125812,0,0,0,259,34,14,307,330,36,673
3125813,0,0,0,204,47,18,269,345,18,632
3125814,0,0,0,129,21,9,159,129,26,314
3125815,0,0,0,51,3,3,57,107,11,175
3125816,0,0,0,57,18,0,75,219,18,312
3125817,0,0,0,54,14,7,75,134,12,221
3125818,0,0,0,63,8,3,74,116,0,190
3125819,0,0,0,102,10,0,112,125,15,252
3125820,0,0,0,352,83,17,452,614,65,1131
3125821,6,0,6,281,46,11,338,374,31,743
3125822,3,0,3,93,30,3,126,181,23,330
3125823,0,0,0,54,15,0,69,134,15,218
3125824,0,0,0,163,24,12,199,203,47,449
3125825,0,0,0,65,21,0,86,105,15,206
3125826,0,0,0,66,25,3,94,152,22,268
3125827,0,0,0,74,28,3,105,91,9,205
3125828,0,0,0,150,31,16,197,217,24,438
3125829,0,0,0,97,9,3,109,133,10,252
3125830,0,0,0,72,32,3,107,86,14,207
3125831,0,4,4,67,13,6,86,211,51,348
3125832,0,0,0,110,22,3,135,164,7,306
3125833,0,0,0,120,17,10,147,173,22,342
3125834,11,3,14,96,28,4,128,240,33,401
3125835,0,0,0,137,42,13,192,290,34,516
3125836,6,0,6,161,36,12,209,241,15,465
3125837,76,7,83,124,35,22,181,364,32,577
3125838,3,0,3,116,20,0,136,119,22,277
3125839,0,0,0,103,16,5,124,162,18,304
3125840,3,0,3,198,21,3,222,272,16,510
3125841,0,0,0,343,65,32,440,415,34,889
3125842,0,0,0,115,31,3,149,171,16,336
3125843,0,0,0,107,28,7,142,179,35,356
3125844,0,0,0,67,13,0,80,102,28,210
3125845,9,0,9,0,20,0,20,144,12,176
3125846,0,0,0,164,43,6,213,205,41,459
3125847,3,3,6,71,18,0,89,119,24,232
3125901,7,0,7,18,42,0,60,314,30,404
3125902,101,16,117,0,3,0,3,189,24,216
3125903,4,0,4,84,20,0,104,253,39,396
3125904,10,3,13,39,12,0,51,208,18,277
3125905,10,0,10,77,21,6,104,272,25,401
3125906,7,3,10,74,15,0,89,275,26,390
3125907,3,0,3,61,24,3,88,168,10,266
3125908,7,0,7,45,35,0,80,238,25,343
3125909,4,0,4,81,23,4,108,259,33,400
3125910,6,0,6,49,21,3,73,245,21,339
3126001,4,0,4,78,6,0,84,220,20,324
3126002,3,74,77,123,35,3,161,336,144,641
3126003,0,0,0,78,16,9,103,241,68,412
3126004,0,0,0,64,18,3,85,138,39,262
3126005,0,0,0,61,13,0,74,154,16,244
3126006,0,50,50,89,34,0,123,183,136,442
3126007,3,0,3,93,21,9,123,200,18,341
3126008,0,0,0,121,23,10,154,218,30,402
3126009,0,0,0,43,9,0,52,176,24,252
3126010,6,15,21,76,14,6,96,222,93,411
3126011,0,0,0,95,17,0,112,193,46,351
3126012,3,3,6,80,20,3,103,144,15,262
3126013,3,0,3,79,26,0,105,213,9,327
3126014,4,0,4,59,21,3,83,187,7,277
3126101,3,0,3,42,16,0,58,180,12,250
3126102,4,0,4,134,24,10,168,197,26,391
3126103,3,0,3,129,19,9,157,233,12,402
3126104,3,0,3,79,21,6,106,189,16,311
3126105,0,0,0,97,27,9,133,272,63,468
3126106,41,15,56,44,28,0,72,284,53,409
3126107,7,3,10,55,21,3,79,178,37,294
3126108,3,3,6,50,22,7,79,150,17,246
3126109,0,0,0,48,8,4,60,144,9,213
3126110,3,0,3,99,24,8,131,212,24,367
3126111,19,3,22,105,24,0,129,290,24,443
3126112,13,0,13,63,39,0,102,417,84,603
3126113,4,0,4,65,24,3,92,270,48,410
3126114,7,0,7,98,16,3,117,311,30,458
3126115,0,4,4,70,46,3,119,335,31,485
3126116,6,0,6,56,27,6,89,221,7,317
3126117,0,0,0,57,31,0,88,185,54,327
3126118,0,0,0,73,22,3,98,203,30,331
3126119,3,0,3,68,24,0,92,169,17,278
3126120,6,60,66,64,37,6,107,246,142,495
3126121,0,0,0,31,21,0,52,273,25,350
3126122,0,0,0,64,13,0,77,183,6,266
3126123,3,0,3,48,16,0,64,198,9,271
3126124,3,0,3,102,37,0,139,269,23,431
3126125,0,0,0,56,20,3,79,168,26,273
3126126,3,0,3,67,21,0,88,203,15,306
3126127,6,0,6,104,39,5,148,280,24,452
3126128,3,0,3,27,21,0,48,150,15,213
3126129,0,0,0,49,9,0,58,161,29,248
3126130,0,0,0,54,30,0,84,177,3,264
3126131,0,0,0,59,9,0,68,134,32,234
3126132,0,0,0,10,10,3,23,109,9,141
3126133,0,8,8,90,26,0,116,177,21,314
3126134,3,0,3,46,20,3,69,181,9,259
3126135,10,6,16,57,33,6,96,238,26,360
3126136,6,3,9,53,17,7,77,329,47,453
3126137,6,0,6,51,19,0,70,170,15,255
3126138,6,3,9,63,18,0,81,221,18,320
3126139,0,0,0,0,8,0,8,338,52,398
3126140,8,0,8,49,23,7,79,208,13,300
3126141,0,4,7,20,21,0,41,205,28,274
3126142,3,3,6,52,24,0,76,196,24,296
3126143,3,0,3,44,17,3,64,173,15,252
3126144,7,0,7,53,12,3,68,145,11,224
3126145,4,0,4,43,25,0,68,200,23,291
3126146,8,0,8,83,29,6,118,232,25,375
3126147,6,3,9,59,32,3,94,228,20,342
3126148,6,0,6,77,15,0,92,260,18,370
3126149,5,0,5,67,28,0,95,262,38,395
3126150,6,0,6,36,15,0,51,151,24,226
3126151,4,4,8,57,26,6,89,241,51,381
3126201,4,0,4,134,13,3,150,219,19,388
3126202,0,0,0,93,15,0,108,234,19,361
3126203,0,0,0,103,13,0,116,175,25,316
3126204,3,0,3,152,30,5,187,421,16,624
3126205,0,0,0,57,16,3,76,109,6,191
3126206,3,0,3,73,9,9,91,177,7,275
3126207,0,0,0,110,34,12,156,269,13,438
3126208,120,0,120,42,25,4,71,809,43,923
3126209,0,0,0,41,15,0,56,352,126,534
3126210,10,0,10,82,34,0,116,274,27,417
3126211,0,0,0,56,17,3,76,169,45,290
3126212,3,0,3,37,15,0,52,167,24,243
3126213,3,0,3,65,23,0,88,252,51,391
3126214,0,0,0,121,44,3,168,370,49,587
3126215,6,4,10,72,22,3,97,336,54,487
3126216,3,0,3,138,18,3,159,269,32,460
3126217,3,6,9,103,30,3,136,287,36,459
3126218,3,0,3,61,21,0,82,121,27,230
3126219,7,3,10,101,29,0,130,269,32,431
3126220,3,0,3,34,6,0,40,149,18,207
3126221,6,3,9,88,25,3,116,224,28,368
3126222,0,0,0,160,37,10,207,374,30,611
3126223,0,0,0,103,18,7,128,267,33,428
3126224,0,0,0,41,4,0,45,60,3,108
3126225,3,0,3,79,23,6,108,214,44,366
3126226,0,0,0,54,22,0,76,192,62,330
3126227,0,0,0,126,29,3,158,411,83,652
3126228,0,0,0,114,23,3,140,261,19,420
3126301,6,3,9,59,14,0,73,182,19,274
3126302,3,0,3,46,11,0,57,136,14,207
3126303,8,0,8,22,22,0,44,145,11,200
3126304,3,0,3,70,33,0,103,261,15,379
3126305,0,4,4,62,21,3,86,150,19,255
3126306,5,0,5,68,23,3,94,196,22,312
3126307,0,3,3,77,25,3,105,187,15,307
3126308,3,0,3,81,26,3,110,246,22,378
3126309,3,0,3,81,14,0,95,166,24,285
3126310,3,0,3,51,7,0,58,100,5,163
3126311,4,0,4,63,14,4,81,241,20,342
3126312,6,0,6,54,24,3,81,219,13,313
3126313,0,0,0,86,26,6,118,271,26,415
3126314,4,0,4,66,20,3,89,174,15,278
3126315,0,0,0,59,23,9,91,200,20,311
3126316,4,0,4,100,15,0,115,226,50,391
3126317,0,6,6,54,6,3,63,157,33,253
3126318,7,50,57,48,24,3,75,208,135,418
3126319,7,3,10,56,22,3,81,171,34,286
3126320,6,0,6,87,27,0,114,225,32,371
3126321,0,7,7,49,17,0,66,152,10,228
3126322,140,99,239,0,6,0,6,335,167,508
3126323,27,0,27,77,34,0,111,502,64,677
3126324,0,0,0,4,0,0,4,0,0,4
3126325,3,0,3,47,20,8,75,164,9,248
3126326,3,0,3,25,19,3,47,139,13,199
3126327,3,0,3,134,20,4,158,262,39,459
3126328,4,0,4,75,39,9,123,216,20,359
3126329,27,4,31,84,15,6,105,279,28,412
3126330,6,0,6,47,11,0,58,191,14,263
3126401,0,0,0,72,21,0,93,216,3,312
3126402,0,0,0,83,56,3,142,292,26,460
3126403,0,0,0,0,0,0,0,3,0,3
3126404,6,0,6,88,26,0,114,309,35,458
3126405,3,0,3,104,41,6,151,259,39,449
3126406,4,3,7,64,27,3,94,226,21,341
3126407,3,0,3,103,31,3,137,188,34,359
3126408,3,3,6,103,27,0,130,215,28,373
3126409,0,0,0,171,46,12,229,373,44,646
3126410,6,0,6,68,30,6,104,181,30,315
3126411,0,0,0,63,21,0,84,196,30,310
3126412,7,0,7,92,35,3,130,327,42,499
3126413,3,3,6,75,24,0,99,230,61,390
3126414,0,0,0,0,0,0,0,3,0,3
3126501,3,0,3,61,29,9,99,206,27,332
3126502,0,0,0,105,44,0,149,272,3,424
3126503,5,0,5,124,56,6,186,349,16,551
3126504,0,0,0,81,20,0,101,219,27,347
3126505,0,0,0,68,42,9,119,223,8,350
3126506,0,0,0,57,21,0,78,210,10,298
3126507,3,0,3,65,43,6,114,214,5,333
3126508,3,0,3,35,16,3,54,189,16,259
3126509,0,0,0,100,23,6,129,204,45,378
3126510,0,0,0,84,31,0,115,195,27,337
3126511,6,0,6,139,42,6,187,339,35,561
3126512,3,0,3,86,32,0,118,433,32,583
3126513,0,0,0,62,22,0,84,176,24,284
3126514,0,0,0,119,23,10,152,263,25,440
3126515,0,0,0,86,15,3,104,199,28,331
3126516,0,0,0,52,12,3,67,139,21,227
3126517,0,0,0,50,23,3,76,147,25,248
3126518,3,0,3,118,29,8,155,286,19,460
3126601,6,3,9,52,14,0,66,142,35,243
3126602,4,0,4,58,21,3,82,152,64,298
3126603,0,0,0,23,15,0,38,182,40,260
3126604,0,0,0,0,0,0,0,0,0,0
3126605,3,0,3,33,20,0,53,265,20,338
3126606,3,3,6,73,32,9,114,249,40,403
3126607,0,4,4,31,12,0,43,115,13,171
3126608,6,0,6,55,15,0,70,287,15,372
3126609,6,3,9,116,21,6,143,275,53,471
3126610,3,3,6,34,26,0,60,126,24,210
3126611,3,0,3,45,16,0,61,150,13,224
3126612,9,3,12,71,29,0,100,258,36,394
3126613,0,3,3,48,13,0,61,337,62,460
3126614,65,17,82,17,8,3,28,285,58,371
3126615,13,3,16,69,32,0,101,314,52,467
3126616,10,4,14,29,15,0,44,283,52,379
3126617,9,4,13,95,32,3,130,606,77,813
3126618,8,30,38,99,31,5,135,573,136,844
3126619,3,6,9,56,21,3,80,279,58,417
3126620,3,3,6,60,32,0,92,323,37,452
3126621,3,3,6,38,7,4,49,164,28,241
3126622,0,0,0,50,24,3,77,357,55,489
3126623,43,3,46,41,18,0,59,311,41,411
3126624,0,6,6,59,22,0,81,161,67,309
3126625,5,0,5,60,32,0,92,323,72,487
3126626,0,0,0,34,9,0,43,128,22,193
3126627,14,30,44,51,18,0,69,318,156,543
3126628,3,5,8,31,17,0,48,223,24,295
3126629,3,0,3,61,10,3,74,386,93,553
3126630,3,3,6,47,12,0,59,248,48,355
3126631,11,3,14,31,30,0,61,283,106,450
3126632,8,3,11,41,20,0,61,181,46,288
3126633,3,0,3,66,17,3,86,182,22,290
3126634,8,0,8,63,22,0,85,479,120,684
3126635,9,0,9,94,21,0,115,326,42,483
3126636,15,4,19,21,21,0,42,284,57,383
3126637,12,6,18,138,39,9,186,1127,200,1513
3126638,0,0,0,80,32,6,118,567,82,767
3126639,0,0,0,50,21,3,74,401,51,526
3126640,3,3,6,38,26,0,64,216,50,330
3126641,8,60,68,24,6,0,30,149,117,296
3126642,5,0,5,61,21,0,82,248,34,364
3126643,3,0,3,64,24,4,92,263,28,383
3126644,6,0,6,48,29,3,80,158,14,252
3126645,5,0,5,51,28,6,85,180,8,273
3126646,0,0,0,4,11,0,15,112,16,143
3126647,0,0,0,31,18,4,53,166,25,244
3126648,0,0,0,0,0,0,0,3,0,3
3126649,7,0,7,71,30,9,110,305,52,467
3126650,4,0,4,59,22,0,81,256,62,399
3126651,16,0,16,46,35,12,93,249,53,395
3126652,127,10,137,28,12,0,40,324,32,396
3126653,16,9,28,75,16,0,91,228,55,374
3126654,3,3,6,19,9,0,28,238,54,320
3126655,3,0,3,27,15,0,42,210,65,317
3126656,5,0,5,53,16,0,69,293,64,426
3126657,4,3,10,44,26,0,70,182,18,270
3126658,12,4,16,22,23,0,45,272,48,365
3126659,5,0,5,81,27,9,117,324,85,526
3126660,24,0,24,63,28,3,94,311,30,435
3126661,3,0,3,60,14,6,80,179,37,296
3126662,6,3,9,58,22,0,80,250,27,357
3126663,6,0,6,45,22,0,67,123,19,209
3126701,3,0,3,164,31,6,201,307,52,560
3126702,3,0,3,49,35,0,84,232,29,345
3126703,11,0,11,46,27,3,76,174,7,257
3126704,0,0,0,65,22,3,90,234,8,332
3126705,0,0,0,95,11,5,111,149,12,272
3126706,4,0,4,82,13,6,101,253,23,377
3126707,0,0,0,51,17,0,68,175,22,265
3126708,4,3,7,83,44,9,136,252,17,405
3126709,6,0,6,51,33,0,84,264,24,372
3126710,7,4,11,87,29,3,119,207,23,349
3126711,3,4,7,31,22,0,53,114,4,171
3126712,4,0,4,57,14,5,76,142,12,230
3126713,0,4,4,102,16,9,127,213,28,368
3126714,0,4,4,52,12,3,67,94,14,175
3126715,106,17,123,11,9,0,20,290,31,341
3126716,6,7,13,91,18,6,115,212,28,355
3126717,6,4,10,70,28,6,104,225,27,356
3126718,6,0,6,83,34,3,120,258,17,395
3126719,6,0,6,48,15,0,63,152,3,218
3126720,3,0,3,52,23,3,78,145,13,236
3126801,6,6,12,50,21,3,74,144,26,244
3126802,4,0,4,41,13,0,54,111,9,174
3126803,4,0,4,54,26,0,80,178,16,274
3126804,4,0,4,109,36,0,145,258,42,445
3126805,0,0,0,86,21,0,107,207,19,333
3126806,4,0,4,44,6,0,50,163,15,228
3126807,0,0,0,26,9,0,35,120,21,176
3126808,7,4,11,72,27,4,103,339,40,482
3126809,8,0,8,51,25,0,76,288,32,396
3126810,0,0,0,3,0,0,3,3,0,6
3126811,5,3,8,51,17,0,68,181,24,273
3126812,7,0,7,117,24,4,145,242,24,411
3126901,0,3,3,25,12,0,37,202,77,316
3126902,4,0,4,22,16,0,38,190,65,293
3126903,0,3,3,22,22,3,47,163,58,268
3126904,13,7,20,32,25,0,57,360,84,501
3126905,6,4,10,33,18,0,51,252,95,398
3126906,7,0,7,37,9,0,46,180,71,297
3126907,8,0,8,12,12,9,33,229,37,299
3126908,9,6,15,31,32,0,63,368,62,493
3126909,16,0,16,24,22,3,49,235,110,394
3127001,6,4,10,37,15,5,57,135,13,205
3127002,6,3,9,48,28,0,76,342,24,442
3127003,13,5,18,30,19,3,52,211,97,360
3127004,0,0,0,33,20,0,53,359,21,433
3127005,10,0,10,36,17,0,53,390,92,535
3127006,6,0,6,41,24,3,68,341,95,504
3127007,4,3,7,16,19,0,35,296,71,402
3127008,3,0,3,58,20,0,78,197,29,304
3127009,5,0,5,20,13,0,33,117,13,163
3127010,6,3,9,50,23,3,76,159,19,254
3127011,10,0,10,82,26,0,108,219,15,342
3127012,7,6,13,27,13,0,40,265,83,388
3127013,8,0,8,27,8,3,38,312,68,418
3127014,8,3,11,13,6,0,19,183,42,244
3127015,0,4,4,29,15,0,44,260,78,382
3127016,6,0,6,58,18,3,79,398,160,637
3127017,8,7,15,22,10,0,32,341,93,466
3127018,4,0,4,22,10,0,32,270,180,482
3127019,0,7,7,32,13,4,49,223,102,374
3127020,3,3,6,25,11,6,42,177,21,240
3127021,4,0,4,31,15,0,46,332,52,430
3127022,22,4,26,48,26,6,80,498,106,684
3127023,6,0,6,39,21,0,60,422,68,550
3127024,0,0,0,23,11,0,34,182,65,281
3127025,4,3,7,26,11,0,37,306,48,391
3127026,3,6,9,62,30,0,92,200,39,331
3127027,9,3,12,44,12,0,56,268,59,383
3127028,3,3,6,40,9,0,49,396,83,528
3127029,0,3,3,48,17,0,65,324,63,452
3127030,7,0,7,32,26,0,58,317,54,429
3127031,9,0,9,27,16,0,43,438,79,560
3127032,0,0,0,27,21,0,48,257,28,333
3127033,5,0,5,36,18,0,54,181,8,243
3127034,3,0,3,29,14,0,43,218,7,268
3127035,39,6,45,16,35,0,51,336,53,440
3127036,27,3,30,31,42,0,73,391,32,496
3127037,4,0,4,18,11,0,29,244,50,323
3127038,3,3,6,17,9,3,29,206,41,276
3127039,3,6,9,19,9,3,31,156,100,287
3127040,0,4,4,26,15,6,47,344,146,537
3127041,0,0,0,21,15,6,42,184,55,281
3127042,3,0,3,29,21,0,50,320,58,428
3127043,3,0,3,39,10,0,49,307,101,457
3127044,5,0,5,42,33,0,75,362,101,538
3127045,3,3,6,14,14,6,34,221,54,309
3127046,8,0,8,17,7,0,24,253,34,311
3127101,11,0,11,51,20,0,71,211,36,318
3127102,3,0,3,3,3,0,6,12,3,21
3127103,3,0,3,64,16,3,83,258,15,356
3127104,0,0,0,116,20,4,140,268,13,421
3127105,3,0,3,96,22,0,118,281,19,418
3127106,0,0,0,0,0,0,0,3,0,3
3127107,7,3,10,47,26,3,76,205,25,306
3127108,0,0,0,0,0,0,0,4,4,8
3127109,0,0,0,0,0,0,0,0,0,0
3127110,0,0,0,60,10,3,73,139,37,249
3127111,15,0,15,63,28,3,94,281,24,399
3127112,4,3,7,73,6,0,79,237,8,324
3127113,13,0,13,78,24,0,102,274,55,431
3127114,0,0,0,0,0,0,0,0,0,0
3127115,3,0,3,39,29,0,68,144,30,242
3127201,0,0,0,0,0,0,0,0,0,0
3127202,3,0,3,76,9,3,88,165,21,274
3127203,137,81,218,0,15,0,15,368,140,523
3127204,8,0,8,58,26,0,84,237,23,344
3127205,3,0,3,78,32,0,110,275,15,400
3127206,6,0,6,94,36,3,133,262,23,418
3127207,3,0,3,46,19,0,65,167,26,258
3127208,0,0,0,42,18,0,60,172,16,248
3127209,8,4,12,77,46,0,123,260,36,419
3127210,0,0,0,42,15,3,60,139,19,218
3127211,7,0,7,44,24,0,68,167,23,258
3127212,0,0,0,60,19,6,85,215,17,317
3127213,3,0,3,69,28,5,102,205,13,320
3127214,3,4,7,66,16,0,82,243,19,344
3127215,13,4,17,60,22,4,86,340,48,474
3127216,3,3,6,107,24,3,134,267,44,445
3127217,0,0,0,3,0,0,3,0,0,3
3127301,0,3,3,39,18,7,64,150,21,235
3127302,0,3,3,49,15,3,67,130,24,221
3127303,6,0,6,129,41,8,178,331,28,537
3127304,3,0,3,66,8,3,77,111,6,194
3127305,0,0,0,86,18,9,113,190,7,310
3127306,3,0,3,110,29,7,146,260,13,419
3127307,0,0,0,125,36,3,164,217,10,391
3127308,0,0,0,93,45,0,138,232,4,374
3127309,0,0,0,51,18,3,72,166,18,256
3127310,3,0,3,91,13,4,108,189,5,302
3127311,0,0,0,75,24,3,102,199,6,307
3127312,6,0,6,62,15,0,77,134,29,240
3127313,0,0,0,92,31,10,133,230,22,385
3127314,4,0,4,133,31,9,173,291,29,493
3127315,3,0,3,100,22,3,125,200,25,350
3127316,3,0,3,81,24,7,112,203,9,324
3127317,0,0,3,77,33,3,113,169,15,297
3127318,3,0,3,57,34,6,97,277,82,456
3127319,0,0,0,74,14,0,88,121,23,232
3127320,0,0,0,17,6,0,23,35,0,58
3127321,0,0,0,152,11,6,169,206,19,394
3127322,0,0,0,56,19,3,78,94,0,172
3127323,3,0,3,116,51,3,170,240,24,434
3127324,0,0,0,78,12,0,90,156,12,258
3127325,0,0,0,81,22,6,109,195,0,304
3127326,0,0,0,68,16,6,90,160,10,260
3127327,6,0,6,54,16,4,74,166,3,243
3127328,0,0,0,134,46,10,190,244,29,463
3127329,0,0,0,79,27,6,112,150,14,276
3127330,0,0,0,72,9,3,84,132,4,220
3127331,3,0,3,98,36,0,134,197,27,358
3127332,0,0,0,68,7,0,75,132,0,207
3127333,0,0,0,80,15,6,101,152,9,262
3127334,3,0,3,84,16,3,103,166,6,275
3127335,3,0,3,75,17,3,95,162,6,263
3127336,3,3,6,66,22,3,91,153,11,255
3127337,0,0,0,94,36,0,130,279,12,421
3127338,0,0,0,71,9,3,83,103,15,201
3127339,0,0,0,143,25,12,180,222,16,418
3127340,0,0,0,101,34,12,147,231,20,398
3127341,0,0,0,117,35,3,155,224,13,392
3127342,0,0,0,62,23,0,85,162,26,273
3127343,6,3,9,59,26,0,85,168,12,265
3127344,3,0,3,98,19,6,123,189,9,321
3127345,0,0,0,89,21,7,117,200,9,326
3127346,0,0,0,124,25,7,156,194,13,363
3127347,10,49,59,43,12,0,55,210,125,390
3127348,0,0,0,121,43,6,170,238,10,418
3127349,3,0,3,113,31,3,147,272,18,437
3127350,5,0,5,86,34,3,123,207,12,342
3127351,3,0,3,87,18,6,111,207,7,325
3127352,0,0,0,77,21,7,105,142,4,251
3127353,9,3,12,237,50,9,296,575,46,917
3127354,0,0,0,60,10,0,70,150,6,226
3127355,0,0,0,74,34,4,112,231,20,363
3127356,4,0,4,115,13,6,134,193,6,333
3127357,9,0,9,59,15,0,74,184,18,276
3127358,0,0,0,57,21,0,78,118,6,202
3127359,0,0,0,60,21,0,81,98,6,185
3127360,0,0,0,43,17,0,60,137,9,206
3127401,3,3,6,107,28,6,141,279,32,452
3127402,0,0,0,0,0,0,0,0,3,3
3127403,4,0,4,45,18,0,63,132,10,205
3127404,6,0,6,52,18,0,70,192,28,290
3127405,3,0,3,41,15,0,56,126,19,201
3127406,3,0,3,97,26,3,126,209,25,360
3127407,0,0,0,51,30,6,87,231,35,353
3127408,0,0,0,102,34,0,136,271,51,458
3127409,9,0,9,50,21,0,71,175,50,296
3127410,0,0,0,45,15,3,63,218,43,324
3127411,3,0,3,58,8,0,66,136,32,234
3127412,6,3,9,40,19,6,65,168,35,268
3127413,6,0,6,37,10,3,50,120,21,191
3127414,0,0,0,60,16,3,79,171,38,288
3127415,4,0,4,84,22,6,112,200,68,380
3127416,3,0,3,66,26,3,95,227,55,377
3127417,0,0,0,43,11,0,54,162,34,250
3127418,0,0,0,53,25,0,78,141,27,246
3127419,0,3,3,58,23,4,85,168,62,315
3127420,0,0,0,90,28,3,121,270,55,446
3127421,4,0,4,76,27,0,103,177,35,315
3127422,0,0,0,59,21,3,83,158,23,264
3127423,5,0,5,72,25,0,97,228,35,360
3127424,0,0,0,39,18,0,57,117,27,201
3127425,3,0,3,48,24,6,78,214,33,325
3127426,3,0,3,51,21,0,72,135,29,236
3127427,6,0,6,62,9,0,71,185,30,286
3127428,7,0,7,47,18,3,68,228,49,345
3127429,4,3,7,73,21,3,97,272,30,399
3127430,8,0,8,71,12,3,86,245,60,391
3127431,0,0,0,47,16,6,69,107,18,194
3127432,8,0,8,60,13,3,76,233,26,335
3127433,3,0,3,26,17,0,43,146,9,198
3127434,6,0,6,79,21,0,100,286,42,428
3127435,3,0,3,48,17,0,65,156,34,255
3127436,8,0,8,79,28,6,113,325,44,482
3127437,6,0,6,38,18,0,56,128,25,209
3127438,8,4,12,93,25,3,121,286,43,450
3127439,0,0,0,10,0,0,10,87,13,110
3127501,3,0,3,123,37,12,172,289,23,484
3127502,3,0,3,66,37,3,106,197,13,316
3127503,27,103,130,28,33,0,61,136,158,355
3127504,11,4,15,88,48,9,145,182,4,331
3127505,6,0,6,122,26,0,148,246,45,439
3127506,7,0,7,70,38,0,108,279,25,412
3127507,0,0,0,37,12,0,49,93,13,155
3127508,9,0,9,94,23,5,122,210,35,367
3127509,0,0,0,38,10,0,48,142,18,208
3127510,0,0,0,90,25,11,126,190,27,343
3127511,0,0,0,8,4,0,12,61,22,95
3127512,0,0,0,90,32,3,125,269,19,413
3127513,0,0,0,59,28,0,87,127,9,223
3127514,5,0,5,42,20,0,62,156,37,255
3127515,6,0,6,37,18,6,61,210,33,304
3127516,10,3,13,119,44,12,175,342,43,560
3127517,13,0,13,60,20,0,80,208,11,299
3127601,0,0,0,55,24,3,82,165,38,285
3127602,0,0,0,12,9,0,21,54,12,87
3127603,0,0,0,0,0,0,0,0,0,0
3127604,0,0,3,45,25,0,70,135,11,216
3127605,0,0,0,0,0,0,0,24,0,24
3127606,0,0,0,31,11,3,45,135,23,203
3127607,0,0,0,0,3,0,3,84,259,346
3127608,0,0,0,0,0,0,0,0,878,878
3127609,0,0,0,71,30,0,101,211,41,353
3127610,0,0,0,82,24,0,106,167,91,364
3127611,0,0,0,75,26,0,101,207,67,375
3127612,0,0,0,0,0,0,0,24,3,27
3127613,0,0,0,0,0,0,0,0,1075,1075
3127701,7,0,7,70,21,0,91,196,15,302
3127702,0,4,4,54,18,3,75,133,22,230
3127703,6,3,9,46,13,0,59,135,9,203
3127704,0,4,4,77,30,6,113,277,29,419
3127705,13,6,22,58,20,3,81,240,27,348
3127706,7,3,10,86,20,6,112,260,30,402
3127707,10,6,16,104,46,9,159,395,45,599
3127708,10,0,10,76,19,5,100,207,27,334
3127709,4,0,4,28,14,3,45,127,10,182
3127710,6,0,6,58,24,3,85,187,15,287
3127711,3,0,3,37,12,0,49,120,9,178
3127712,0,0,0,26,10,0,36,128,19,183
3127713,0,0,0,43,27,0,70,178,7,255
3127714,7,0,7,37,24,0,61,179,15,255
3127715,3,3,6,43,24,0,67,135,23,225
3127716,85,5,90,30,16,0,46,282,23,351
3127717,3,0,3,61,19,9,89,198,18,305
3127718,3,0,3,79,23,10,112,204,15,331
3127719,9,0,9,47,34,0,81,251,20,352
3127720,0,0,0,44,23,3,70,218,32,320
3127721,0,4,4,59,28,0,87,209,19,315
3127722,6,0,6,89,11,3,103,175,24,302
3127723,3,0,3,39,20,0,59,160,6,225
3127724,0,0,0,53,33,3,89,139,15,243
3127725,4,0,4,68,34,0,102,168,21,291
3127726,0,0,0,75,35,3,113,172,9,294
3127727,6,4,10,59,28,3,90,266,44,400
3127728,6,0,6,85,34,3,122,188,14,324
3127729,3,0,3,6,3,0,9,27,12,48
3127730,3,0,3,43,22,0,65,131,18,214
3127801,5,20,25,32,15,0,47,179,53,279
3127802,6,0,6,33,17,3,53,115,8,176
3127803,3,7,10,55,23,6,84,272,30,386
3127804,3,0,3,33,11,0,44,141,15,200
3127805,4,0,4,35,15,3,53,110,6,169
3127806,4,3,7,26,19,3,48,205,21,274
3127807,4,6,10,65,30,5,100,281,44,425
3127808,3,0,6,94,24,0,118,248,26,392
3127809,0,0,0,31,12,3,46,176,27,249
3127810,0,3,3,22,11,0,33,124,21,178
3127811,0,0,0,34,27,0,61,128,12,201
3127812,0,0,0,62,23,3,88,178,6,272
3127813,4,0,4,32,15,0,47,155,25,227
3127814,3,3,6,24,12,0,36,100,19,155
3127815,11,0,11,55,25,7,87,242,24,353
3127901,0,0,0,0,0,0,0,0,4,4
3128001,9,0,9,75,16,4,95,234,22,351
3128002,3,3,6,58,38,6,102,178,32,312
3128003,0,3,3,63,34,6,103,205,31,339
3128004,0,0,0,105,35,4,144,261,39,444
3128005,0,0,0,44,25,3,72,176,18,266
3128006,0,0,0,57,9,0,66,146,21,233
3128007,0,0,0,64,33,7,104,163,0,267
3128008,4,0,4,196,48,3,247,297,35,579
3128009,0,0,0,46,5,3,54,132,5,191
3128010,3,0,3,35,13,0,48,125,3,176
3128011,0,0,0,42,14,0,56,80,10,146
3128012,0,0,0,32,15,6,53,99,28,180
3128013,0,0,0,62,10,4,76,147,21,244
3128014,3,0,3,62,18,4,84,154,27,265
3128015,0,0,0,42,9,5,56,156,24,236
3128016,0,0,0,51,18,0,69,151,28,248
3128017,0,3,3,39,3,3,45,127,15,187
3128018,53,8,61,28,4,4,36,240,33,309
3128019,0,0,0,71,25,9,105,266,51,422
3128020,0,0,0,67,28,6,101,188,31,320
3128021,0,0,0,26,18,3,47,158,12,217
3128022,0,0,0,55,12,0,67,137,14,218
3128023,0,0,0,37,13,9,59,141,8,208
3128024,3,3,6,66,21,0,87,187,88,362
3128025,0,0,0,41,19,0,60,120,15,195
3128026,4,0,4,18,6,3,27,117,49,193
3128027,3,3,6,45,14,0,59,159,12,230
3128028,6,0,6,39,14,3,56,209,22,287
3128029,0,0,0,52,17,9,78,144,5,227
3128030,3,0,3,50,22,7,79,175,25,279
3128031,0,0,0,34,6,0,40,97,15,152
3128032,3,0,3,51,18,3,72,162,21,255
3128033,0,0,0,44,15,0,59,123,12,194
3128034,40,8,48,39,22,0,61,266,33,360
3128035,6,3,9,65,20,6,91,216,50,357
3128036,0,0,0,107,29,6,142,215,16,373
3128037,3,0,3,43,14,0,57,141,10,208
3128038,3,0,3,31,10,0,41,136,20,197
3128039,0,0,0,44,14,0,58,128,25,211
3128040,6,0,6,38,11,0,49,129,40,218
3128041,0,0,0,42,7,3,52,144,22,218
3128042,0,0,0,81,8,0,89,184,22,295
3128043,0,0,0,32,6,0,38,104,17,159
3128044,0,0,0,57,12,3,72,147,30,249
3128045,0,0,0,91,28,0,119,161,26,306
3128046,0,0,0,38,12,6,56,167,27,250
3128047,0,0,0,60,34,0,94,202,28,324
3128048,3,3,6,69,11,3,83,173,24,280
3128049,3,0,3,50,14,5,69,177,48,294
3128050,0,0,0,53,18,0,71,133,14,218
3128051,0,0,0,36,29,0,65,147,23,235
3128101,0,0,0,37,12,3,52,145,11,208
3128102,3,3,6,32,15,0,47,140,42,229
3128103,0,0,0,19,11,3,33,90,34,157
3128104,6,3,9,76,50,6,132,318,24,474
3128105,4,0,4,36,20,6,62,201,15,278
3128106,0,0,0,47,40,4,91,170,9,270
3128107,0,0,0,65,12,6,83,141,10,234
3128108,3,0,3,50,28,0,78,167,28,273
3128109,0,0,0,47,16,0,63,156,32,251
3128110,0,0,0,45,3,0,48,129,18,195
3128111,3,5,8,63,15,0,78,209,18,305
3128112,0,0,0,23,9,0,32,121,9,162
3128113,0,0,5,106,31,12,149,222,33,404
3128114,3,0,3,62,26,3,91,234,39,364
3128115,0,0,0,34,11,0,45,101,12,158
3128116,0,0,0,58,24,0,82,194,21,297
3128117,4,0,4,91,35,9,135,299,40,474
3128118,0,0,0,106,27,4,137,237,33,407
3128119,0,0,0,82,22,0,104,178,10,292
3128120,3,0,3,28,9,0,37,108,6,151
3128121,6,0,6,89,25,6,120,234,24,378
3128122,0,0,0,93,36,6,135,200,19,354
3128123,0,0,0,27,20,0,47,86,12,145
3128124,4,0,4,43,32,6,81,183,21,285
3128125,0,0,0,140,24,14,178,266,12,456
3128126,0,0,0,90,17,0,107,149,15,271
3128127,3,0,3,47,9,3,59,77,12,148
3128128,6,0,6,58,19,9,86,233,38,357
3128129,0,0,0,39,7,0,46,86,3,135
3128130,18,6,24,52,21,3,76,208,21,305
3128131,0,3,3,17,11,0,28,103,18,149
3128132,0,0,0,100,11,6,117,153,8,278
3128133,0,0,0,124,35,10,169,208,43,420
3128201,3,0,3,33,21,6,60,124,22,206
3128202,0,0,0,38,12,0,50,89,17,156
3128203,3,0,3,93,36,0,129,180,12,321
3128204,6,0,6,64,10,5,79,195,26,300
3128205,3,0,3,30,13,4,47,121,15,183
3128206,3,4,7,46,21,0,67,125,19,211
3128207,58,10,68,44,16,0,60,254,46,360
3128208,3,3,6,66,22,6,94,208,22,324
3128209,3,0,3,20,12,3,35,110,17,162
3128210,3,0,3,37,21,4,62,117,6,185
3128211,5,0,5,65,17,4,86,180,16,282
3128212,0,0,0,42,20,0,62,94,12,168
3128213,3,0,3,52,31,3,86,163,59,308
3128214,3,3,6,72,24,7,103,218,91,412
3128215,0,0,0,42,17,0,59,134,21,214
3128216,0,0,0,46,22,4,72,112,33,217
3128217,0,0,3,49,25,3,77,249,17,343
3128218,3,0,3,66,25,4,95,162,501,758
3128219,3,0,3,57,16,0,73,195,24,292
3128220,0,0,0,59,36,6,101,139,18,258
3128221,3,0,3,34,27,3,64,118,13,195
3128222,6,3,9,83,44,0,127,280,48,455
3128223,5,6,11,112,34,9,155,260,36,451
3128224,0,3,3,138,23,6,167,345,57,569
3128225,4,0,4,12,0,0,12,20,9,41
3128226,3,0,3,88,40,0,128,240,22,390
3128227,0,0,0,47,21,3,71,161,5,237
3128228,0,0,0,49,17,0,66,131,3,200
3128229,0,0,0,128,65,8,201,331,24,556
3128230,0,0,0,10,11,0,21,211,39,271
3128231,0,0,0,70,31,6,107,255,16,378
3128301,6,0,6,116,23,5,144,214,35,393
3128302,6,0,6,86,21,4,111,205,26,342
3128303,0,0,0,77,26,3,106,210,24,340
3128304,0,0,0,0,0,0,0,0,0,0
3128305,0,0,0,32,26,0,58,168,3,229
3128306,0,0,0,0,0,0,0,0,0,0
3128307,6,0,6,36,25,0,61,131,12,204
3128308,0,0,0,178,53,8,239,292,44,575
3128309,6,0,6,108,37,3,148,262,19,429
3128310,3,3,6,53,25,3,81,166,18,265
3128311,9,0,9,52,25,0,77,188,9,274
3128312,0,0,0,54,38,0,92,121,6,219
3128313,3,0,3,57,26,6,89,165,9,263
3128314,6,0,6,56,41,9,106,238,16,360
3128315,4,0,4,38,23,3,64,117,6,187
3128316,22,6,28,50,40,9,99,362,26,487
3128317,12,0,12,87,33,4,124,237,21,382
3128318,6,0,6,44,6,0,50,114,22,186
3128319,3,0,3,61,24,0,85,169,18,272
3128320,6,0,6,44,16,0,60,129,11,200
3128321,0,0,0,131,25,9,165,196,18,379
3128322,3,0,7,67,24,3,94,185,6,285
3128323,71,3,74,28,12,6,46,199,21,266
3128324,0,0,0,189,51,10,250,338,46,634
3128401,9,3,12,60,22,0,82,205,33,320
3128402,0,0,0,40,7,0,47,134,22,203
3128403,0,0,0,38,21,6,65,136,28,229
3128404,5,0,5,39,12,3,54,170,24,248
3128405,3,0,3,35,15,3,53,152,25,230
3128406,13,0,13,59,41,4,104,286,49,439
3128407,0,0,0,67,14,0,81,135,12,228
3128408,3,0,3,71,47,6,124,287,31,442
3128409,0,0,0,40,15,0,55,127,12,194
3128410,3,7,10,103,30,3,136,219,35,390
3128411,0,0,0,98,30,5,133,243,19,395
3128412,0,0,0,38,27,0,65,161,31,257
3128413,3,0,3,66,39,9,114,246,26,386
3128414,4,0,4,77,25,9,111,219,29,359
3128415,11,0,11,81,40,3,124,329,13,466
3128416,0,3,3,44,23,6,73,172,32,277
3128417,6,0,6,74,31,6,111,195,20,326
3128418,3,0,3,37,14,0,51,135,21,207
3128419,0,0,0,42,20,3,65,141,6,212
3128420,6,0,6,70,51,0,121,238,35,394
3128501,0,0,0,115,25,6,146,176,12,334
3128502,6,3,9,51,13,3,67,149,6,222
3128503,0,0,0,57,18,3,78,149,25,252
3128504,0,0,0,107,27,3,137,260,27,424
3128505,4,0,4,86,36,3,125,219,31,375
3128506,6,3,9,104,30,3,137,273,34,444
3128507,5,0,5,34,31,0,65,127,7,199
3128508,0,0,0,93,29,0,122,219,12,353
3128509,3,0,3,82,19,6,107,227,18,352
3128510,6,3,9,74,64,9,147,300,27,474
3128511,3,3,6,71,41,3,115,229,27,371
3128512,0,0,0,75,25,0,100,116,26,242
3128513,0,0,0,79,26,3,108,183,19,310
3128514,0,0,0,32,19,4,55,126,21,202
3128601,58,4,62,17,12,0,29,256,31,316
3128602,3,0,3,73,28,6,107,223,28,358
3128603,4,0,4,35,19,6,60,122,6,188
3128604,6,0,6,68,22,7,97,174,3,274
3128605,7,0,7,44,9,3,56,163,25,244
3128606,3,3,6,52,19,3,74,220,25,319
3128607,3,3,6,62,26,3,91,172,11,274
3128608,6,3,9,66,37,9,112,294,53,459
3128609,0,0,0,0,0,0,0,0,0,0
3128610,0,0,0,20,13,0,33,150,15,198
3128611,11,0,11,33,6,0,39,266,71,376
3128612,0,0,0,71,18,4,93,184,16,293
3128613,6,0,9,71,26,0,97,231,35,363
3128614,0,0,0,3,0,0,3,0,0,3
3128615,0,0,0,0,0,0,0,9,6,15
3128616,4,0,4,70,27,0,97,178,37,312
3128617,3,0,3,70,36,0,106,239,25,370
3128618,0,0,0,58,24,6,88,171,21,280
3128619,0,0,0,37,22,3,62,164,14,240
3128620,0,0,0,37,13,4,54,95,12,161
3128621,3,0,6,72,24,4,100,197,20,317
3128701,8,7,15,33,11,4,48,225,45,318
3128702,11,0,11,96,29,3,128,332,64,524
3128703,8,0,8,77,17,4,98,201,18,317
3128704,9,6,15,55,25,7,87,248,37,372
3128705,3,0,3,31,21,0,52,172,23,247
3128706,9,3,12,41,34,6,81,216,25,322
3128707,0,0,0,49,13,3,65,172,9,246
3128708,6,8,14,52,15,0,67,141,16,224
3128709,0,0,3,45,27,9,81,118,9,208
3128710,4,0,4,34,21,3,58,132,3,193
3128711,11,0,11,49,26,3,78,198,12,288
3128712,8,0,8,43,28,3,74,146,13,233
3128713,7,0,7,77,46,0,123,262,29,414
3128714,10,7,17,60,25,4,89,200,20,309
3128715,14,3,17,58,32,3,93,240,21,354
3128716,6,0,9,74,40,3,117,197,32,346
3128717,0,0,0,49,14,0,63,114,6,183
3128718,3,4,7,67,29,0,96,242,19,357
3128719,6,3,9,51,11,3,65,179,12,256
3128720,0,0,0,86,19,8,113,113,29,255
3128721,0,0,0,59,42,0,101,153,36,290
3128722,8,3,11,98,40,0,138,266,30,434
3128723,10,7,17,106,38,3,147,309,33,489
3128724,6,0,6,29,11,3,43,137,18,198
3128725,3,0,3,68,32,3,103,198,12,313
3128726,0,0,0,75,30,0,105,168,30,303
3128727,0,3,3,38,25,4,67,144,15,226
3128728,10,3,13,40,19,0,59,168,21,248
3128729,9,0,9,57,30,0,87,267,35,389
3128730,6,4,10,60,29,0,89,222,27,338
3128731,0,0,0,30,15,6,51,111,18,180
3128732,0,3,3,40,12,5,57,110,15,182
3128733,6,3,9,58,11,0,69,153,22,244
3128734,43,10,53,70,46,3,119,377,55,551
3128735,6,3,9,51,24,0,75,180,28,283
3128736,9,0,12,54,31,3,88,171,19,278
3128737,8,4,12,63,15,0,78,166,20,264
3128738,9,0,9,68,21,3,92,216,21,329
3128739,0,0,0,56,34,12,102,164,23,289
3128740,7,0,7,31,16,3,50,122,15,187
3128741,4,3,7,70,23,0,93,180,9,282
3128742,5,0,5,26,28,3,57,146,30,233
3128743,17,24,41,13,27,3,43,176,74,293
3128744,6,0,6,42,25,6,73,184,21,278
3128745,4,0,4,48,19,0,67,139,15,221
3128746,18,0,18,35,27,0,62,174,27,263
3128801,3,0,3,66,19,6,91,156,11,258
3128802,4,0,4,156,42,8,206,230,23,459
3128803,0,0,0,53,9,3,65,107,3,175
3128804,3,0,3,64,23,0,87,194,3,284
3128805,0,0,0,60,15,7,82,132,15,229
3128806,0,0,0,70,30,9,109,181,31,321
3128807,0,3,3,77,17,3,97,139,21,257
3128808,0,0,0,52,20,4,76,168,9,253
3128809,0,0,0,91,26,4,121,176,20,317
3128810,0,0,0,150,33,7,190,252,22,464
3128811,6,0,6,53,10,6,69,126,12,207
3128901,0,0,0,43,26,3,72,144,9,225
3128902,4,3,7,78,27,6,111,180,21,312
3128903,0,0,0,81,37,6,124,203,0,327
3128904,0,0,0,127,15,0,142,152,15,309
3128905,3,0,3,57,13,0,70,125,0,195
3128906,0,0,0,130,43,8,181,261,19,461
3128907,0,0,0,94,32,9,135,180,14,329
3128908,3,3,6,88,43,9,140,260,13,413
3128909,0,0,0,57,19,6,82,157,10,249
3128910,0,0,0,50,13,6,69,143,7,219
3128911,0,0,0,85,43,6,134,194,31,359
3128912,0,0,0,39,22,3,64,154,22,240
3129001,3,3,6,78,47,0,125,198,21,344
3129002,0,0,0,74,26,0,100,182,12,294
3129003,4,0,4,38,22,0,60,110,3,173
3129004,3,0,3,115,16,0,131,249,4,384
3129005,0,0,0,118,24,5,147,260,12,419
3129006,0,0,0,154,22,5,181,235,14,430
3129007,0,0,0,53,18,3,74,170,6,250
3129008,0,0,0,79,13,16,108,161,11,280
3129009,3,0,3,83,25,6,114,162,18,294
3129010,3,0,3,62,4,7,73,78,7,158
3129011,5,0,5,82,21,9,112,191,5,308
3129012,3,0,3,47,12,6,65,129,13,207
3129013,0,0,0,100,32,9,141,218,10,369
3129014,0,0,0,77,19,0,96,177,12,285
3129015,0,0,0,98,16,3,117,144,9,270
3129101,0,0,0,97,32,9,138,302,51,491
3129102,0,0,0,86,27,6,119,183,39,341
3129103,0,0,0,74,16,9,99,192,25,316
3129104,0,3,3,78,31,3,112,226,25,363
3129105,3,0,3,60,25,0,85,128,34,247
3129106,0,0,0,86,44,0,130,227,36,393
3129107,0,0,0,9,3,0,12,14,6,32
3129108,0,0,0,28,21,3,52,91,9,152
3129109,7,0,7,48,24,0,72,141,14,227
3129110,0,0,0,73,19,3,95,168,12,275
3129111,9,3,12,66,31,3,100,223,31,354
3129112,6,3,9,59,21,0,80,136,70,286
3129113,0,3,3,96,35,3,134,185,18,337
3129114,5,3,8,75,19,0,94,195,28,317
3129115,3,0,3,106,27,7,140,265,29,434
3129116,9,3,12,86,26,12,124,280,36,440
3129117,0,0,0,3,3,0,6,3,0,9
3129201,5,3,8,28,12,3,43,147,35,225
3129202,0,0,0,0,0,0,0,0,0,0
3129203,3,0,3,39,12,6,57,117,8,182
3129204,6,3,9,70,24,3,97,208,13,318
3129205,4,0,4,69,26,0,95,228,38,361
3129206,48,0,48,16,9,6,31,187,16,234
3129207,0,0,0,43,17,0,60,99,18,177
3129208,0,0,0,50,11,4,65,100,11,176
3129209,3,0,3,38,9,3,50,134,11,195
3129210,3,0,3,49,34,0,83,163,26,272
3129211,3,3,6,64,24,5,93,158,20,271
3129212,12,0,12,63,34,0,97,226,36,359
3129213,0,0,0,51,24,4,79,138,15,232
3129214,14,0,14,54,15,4,73,205,42,320
3129215,0,0,0,15,21,3,39,128,22,189
3129216,5,0,5,62,10,0,72,212,16,300
3129217,6,0,6,24,15,0,39,119,5,163
3129218,3,0,3,44,25,0,69,160,19,248
3129219,10,0,10,69,50,5,124,466,55,645
3129220,7,4,11,56,18,3,77,189,12,278
3129301,0,0,0,69,12,0,81,122,0,203
3129302,0,0,0,119,15,6,140,124,7,271
3129303,0,0,0,84,9,3,96,142,15,253
3129304,0,0,0,63,24,3,90,142,0,232
3129305,0,0,0,92,32,6,130,143,6,279
3129306,0,0,0,99,27,3,129,160,12,301
3129307,0,0,0,116,19,6,141,190,42,373
3129308,0,0,0,88,34,0,122,239,58,419
3129309,13,4,17,63,32,0,95,230,15,340
3129310,10,0,10,61,35,0,96,258,22,376
3129311,3,6,9,78,25,9,112,193,24,329
3129312,44,0,44,44,29,3,76,211,20,307
3129313,0,0,0,41,14,4,59,84,11,154
3129314,3,0,3,103,30,11,144,256,21,421
3129315,0,0,0,53,22,0,75,113,15,203
3129316,0,0,0,126,31,9,166,191,4,361
3129317,0,0,0,56,16,3,75,204,16,295
3129318,0,4,4,57,29,3,89,165,10,264
3129319,0,0,0,0,0,0,0,9,0,9
3129320,0,0,0,75,37,4,116,178,15,309
3129321,8,0,8,70,39,0,109,241,18,368
3129322,3,0,3,31,15,0,46,96,8,150
3129323,3,0,3,51,33,3,87,138,13,238
3129324,30,18,52,66,28,6,100,217,47,364
3129325,3,0,3,63,36,6,105,228,24,357
3129326,0,0,0,51,21,6,78,164,18,260
3129327,3,0,3,43,27,0,70,112,0,182
3129328,0,0,0,101,30,4,135,198,21,354
3129329,3,0,3,26,23,6,55,94,3,152
3129330,3,0,3,186,38,9,233,313,42,588
3129331,0,0,0,0,0,0,0,18,0,18
3129332,0,0,0,66,26,0,92,157,21,270
3129333,3,0,6,74,33,0,107,219,32,358
3129334,0,0,0,71,28,3,102,153,41,296
3129335,12,0,12,57,24,3,84,217,36,337
3129336,27,8,35,169,27,12,208,529,69,806
3129401,4,0,4,93,30,9,132,211,22,365
3129402,0,0,0,52,25,9,86,181,5,272
3129403,3,0,3,61,33,6,100,153,12,265
3129404,0,0,0,65,29,6,100,139,20,259
3129405,0,0,0,36,23,5,64,97,9,170
3129406,0,0,0,87,21,4,112,107,7,226
3129407,0,0,0,93,25,9,127,134,11,272
3129408,0,0,0,114,14,11,139,121,21,281
3129501,63,3,69,47,21,3,71,324,31,426
3129502,0,0,0,31,12,6,49,165,44,258
3129503,0,0,0,0,3,0,3,7,3,13
3129504,0,3,3,28,18,0,46,117,6,169
3129505,3,0,3,48,35,0,83,176,39,298
3129506,3,0,3,61,40,6,107,220,52,379
3129507,0,0,0,35,28,4,67,125,27,219
3129508,3,0,3,42,30,6,78,217,17,312
3129509,0,0,0,69,24,9,102,162,58,322
3129510,0,0,0,0,0,0,0,0,0,0
3129601,0,0,0,9,0,0,9,25,0,34
3129602,0,0,0,132,34,8,174,143,14,331
3129603,0,0,0,253,52,10,315,283,32,630
3129604,0,3,3,209,43,8,260,300,30,590
3129605,0,0,0,159,41,3,203,266,18,487
3129606,0,0,0,103,50,8,161,273,52,486
3129607,3,3,6,51,37,4,92,178,15,285
3129608,0,0,0,59,22,3,84,141,10,235
3129609,3,0,3,67,22,6,95,201,15,311
3129610,3,0,3,105,37,3,145,222,60,427
3129611,0,0,0,36,23,7,66,242,21,329
3129612,0,0,0,94,23,6,123,190,30,343
3129613,0,0,0,3,3,0,6,6,0,12
3129614,0,0,0,49,12,3,64,110,14,188
3129615,4,0,4,54,42,5,101,211,14,326
3129616,3,0,3,56,26,7,89,187,29,305
3129617,0,4,4,98,43,6,147,237,19,403
3129618,0,0,0,76,10,0,86,141,18,245
3129619,0,0,0,118,11,12,141,200,20,361
3129701,0,0,0,50,33,0,83,166,22,271
3129702,4,0,4,55,24,0,79,180,35,294
3129703,3,0,3,47,17,5,69,230,46,345
3129704,0,0,0,75,34,5,114,240,22,376
3129705,0,0,0,45,21,6,72,99,9,180
3129706,0,3,3,32,10,0,42,117,19,178
3129707,3,0,3,101,30,3,134,238,35,407
3129708,0,0,0,59,25,9,93,158,14,265
3129709,6,0,6,85,21,5,111,228,31,370
3129710,0,0,0,37,21,9,67,138,13,218
3129711,0,0,0,21,9,0,30,128,3,161
3129712,3,0,3,100,31,0,131,295,33,459
3129713,0,0,0,66,9,0,75,144,20,239
3129714,0,0,0,0,0,0,0,0,0,0
3129715,0,0,0,48,25,3,76,100,18,194
3129716,0,0,0,56,18,3,77,184,14,275
3129717,3,0,3,75,27,5,107,192,24,323
3129718,3,0,3,72,32,8,112,189,38,339
3129719,3,0,3,103,34,4,141,274,28,443
3129720,3,0,3,105,46,7,158,278,24,460
3129721,0,0,0,60,45,9,114,236,16,366
3129722,3,0,3,66,26,6,98,161,16,275
3129723,0,0,0,50,12,9,71,165,15,251
3129724,4,0,4,75,29,3,107,229,18,354
3129801,0,0,0,3,0,0,3,3,0,6
3129901,0,0,0,40,24,3,67,119,12,198
3129902,4,0,4,38,18,4,60,110,12,182
3129903,3,0,3,53,20,9,82,147,15,244
3129904,0,0,0,46,28,0,74,142,10,226
3129905,6,0,6,71,44,9,124,254,21,399
3129906,4,0,4,103,29,6,138,245,18,401
3129907,0,0,0,91,18,3,112,165,11,288
3129908,0,0,0,76,11,0,87,134,19,240
3129909,0,0,0,114,15,0,129,145,19,293
3129910,0,0,0,74,20,6,100,144,16,260
3129911,0,0,0,53,3,0,56,93,12,161
3129912,0,3,3,95,28,0,123,226,8,357
3129913,19,7,26,27,12,3,42,218,35,295
3129914,0,0,0,219,33,9,261,301,45,607
3129915,0,0,0,109,35,6,150,185,12,347
3129916,0,3,3,122,26,3,151,177,47,375
3129917,0,0,0,3,0,0,3,0,0,3
3129918,0,0,0,0,0,0,0,0,0,0
3129919,0,0,0,0,0,0,0,0,0,0
3129920,0,0,0,4,3,0,7,17,3,27
3129921,0,0,0,34,9,6,49,121,0,170
3129922,3,0,3,18,10,0,28,132,15,175
3129923,3,0,3,34,25,0,59,197,12,268
3129924,0,0,0,64,16,3,83,131,9,223
3130001,3,0,3,63,12,0,75,159,18,252
3130002,0,0,0,78,33,3,114,238,38,390
3130003,8,3,11,63,31,0,94,235,50,379
3130004,0,0,0,101,30,0,131,143,13,287
3130005,3,0,3,155,42,6,203,258,28,489
3130006,6,0,6,59,18,0,77,266,36,379
3130007,3,3,6,38,12,0,50,113,12,175
3130008,0,0,0,103,31,0,134,181,18,333
3130009,0,0,0,48,20,6,74,149,12,235
3130010,5,0,5,53,19,0,72,149,17,238
3130011,0,0,0,24,15,0,39,69,33,141
3130012,0,0,0,34,23,9,66,109,16,191
3130013,0,0,0,75,36,0,111,215,16,342
3130014,0,0,0,46,13,3,62,88,27,177
3130015,0,0,0,96,29,7,132,172,31,335
3130016,0,0,0,137,48,12,197,248,23,468
3130017,0,0,0,93,23,7,123,117,16,256
3130018,3,3,6,78,28,3,109,219,27,355
3130019,0,0,0,162,42,15,219,300,65,584
3130020,4,0,4,71,30,0,101,195,33,329
3130021,8,0,8,51,44,7,102,234,36,372
3130101,0,0,0,0,0,0,0,0,0,0
3130201,0,0,0,122,21,6,149,242,41,432
3130202,0,0,0,0,0,0,0,6,0,6
3130203,0,0,0,163,24,6,193,204,34,431
3130204,4,0,4,214,54,11,279,347,33,659
3130205,3,3,6,82,29,4,115,211,44,370
3130206,3,0,3,7,0,0,7,18,0,25
3130207,0,0,0,94,29,4,127,240,47,414
3130208,0,0,0,59,22,0,81,184,27,292
3130209,0,0,0,75,23,3,101,197,19,317
3130210,0,0,0,74,34,3,111,165,21,297
3130211,3,0,3,62,25,0,87,152,8,247
3130212,0,0,0,61,16,0,77,145,21,243
3130213,0,0,0,219,59,18,296,439,80,815
3130214,3,0,3,333,64,10,407,552,94,1053
3130215,0,0,0,99,34,4,137,261,14,412
3130216,4,0,4,106,16,3,125,183,28,336
3130217,0,0,0,160,47,4,211,216,70,497
3130218,0,0,0,143,18,6,167,186,33,386
3130219,6,0,6,65,29,0,94,153,25,272
3130220,0,0,0,57,4,4,65,176,16,257
3130221,6,0,6,125,33,3,161,204,24,389
3130222,0,3,3,57,30,0,87,157,20,264
3130223,0,0,0,66,28,0,94,187,13,294
3130224,0,0,0,64,27,0,91,134,28,253
3130225,0,0,0,55,22,0,77,145,27,249
3130226,0,0,0,56,19,0,75,131,3,209
3130227,0,3,3,104,36,4,144,269,33,446
3130228,0,0,0,41,30,0,71,112,18,201
3130229,3,0,3,90,33,0,123,273,12,408
3130230,0,0,0,96,11,7,114,154,19,287
3130301,0,0,0,83,30,9,122,200,12,334
3130302,6,0,6,127,22,16,165,224,36,425
3130303,0,0,0,117,30,6,153,177,17,347
3130304,0,0,0,66,14,4,84,105,10,199
3130305,0,0,0,93,36,8,137,204,15,356
3130306,0,0,0,233,48,16,297,306,30,633
3130307,0,0,0,57,15,0,72,74,12,158
3130308,0,0,0,103,29,3,135,195,23,353
3130309,4,0,4,125,40,6,171,254,22,447
3130310,0,0,0,172,41,11,224,281,26,531
3130311,0,0,0,114,24,12,150,169,17,336
3130312,3,0,3,68,21,0,89,99,22,210
3130313,3,0,3,99,32,3,134,198,13,345
3130314,0,0,0,0,0,0,0,6,0,6
3130401,3,0,3,160,44,16,220,234,13,467
3130402,0,0,4,259,47,6,312,369,21,702
3130403,0,0,0,108,23,4,135,155,16,306
3130404,3,0,6,278,79,15,372,602,36,1010
3130405,0,0,0,3,0,0,3,3,0,6
3130406,0,0,0,102,27,9,138,145,19,302
3130407,0,0,0,99,20,5,124,111,9,244
3130408,0,0,0,82,15,9,106,88,15,209
3130409,0,0,0,142,28,0,170,249,13,432
3130410,6,0,6,164,33,5,202,233,15,450
3130411,0,0,0,100,27,4,131,131,12,274
3130412,0,0,0,90,23,3,116,155,3,274
3130413,0,0,0,96,18,6,120,101,24,245
3130414,0,0,0,117,5,5,127,144,15,286
3130415,0,0,0,93,19,0,112,137,11,260
3130416,0,0,0,105,14,6,125,136,6,267
3130417,0,0,0,6,7,0,13,75,9,97
3130418,3,0,3,87,9,0,96,113,13,222
3130419,0,0,0,156,41,9,206,259,18,483
3130420,4,0,4,186,40,13,239,266,27,532
3130421,0,0,0,104,22,0,126,135,25,286
3130501,3,0,3,49,18,0,67,116,18,201
3130502,11,0,11,36,22,3,61,166,5,232
3130503,12,0,12,92,30,3,125,217,43,385
3130504,6,0,6,32,13,0,45,132,21,198
3130505,81,3,84,40,23,3,66,282,34,382
3130506,18,4,22,79,32,0,111,303,40,454
3130507,9,3,12,49,20,5,74,175,27,276
3130508,14,6,20,84,25,3,112,268,35,415
3130509,4,0,4,49,17,6,72,227,27,326
3130510,0,0,3,104,29,6,139,323,36,498
3130511,40,0,40,189,55,12,256,456,66,778
3130512,0,0,0,69,22,10,101,195,38,334
3130513,0,3,3,49,29,0,78,161,18,257
3130514,3,4,7,194,45,7,246,322,26,594
3130515,0,0,0,43,21,3,67,141,12,220
3130516,0,0,0,139,37,8,184,252,19,455
3130517,0,0,0,64,36,3,103,241,24,368
3130518,3,0,3,55,19,6,80,143,9,232
3130519,4,0,4,23,18,3,44,89,14,147
3130520,6,0,6,110,36,3,149,244,43,436
3130521,4,0,4,43,21,3,67,217,18,302
3130522,3,0,3,35,5,4,44,92,15,151
3130523,0,3,3,28,21,9,58,142,24,224
3130524,4,0,4,73,32,3,108,226,16,350
3130525,3,3,6,25,6,0,31,100,24,155
3130526,0,0,0,45,15,3,63,141,30,234
3130527,8,0,8,64,32,6,102,249,32,383
3130528,3,0,3,30,15,0,45,139,15,199
3130529,0,0,0,16,7,6,29,81,83,193
3130530,4,0,4,42,15,3,60,271,17,348
3130601,0,0,0,0,0,0,0,10,3,13
3130602,0,0,0,47,6,6,59,102,21,182
3130603,6,0,6,78,27,6,111,240,25,376
3130604,3,0,3,82,33,9,124,198,39,361
3130605,3,0,3,26,21,4,51,131,21,203
3130606,0,0,0,63,18,3,84,184,43,311
3130607,0,3,3,63,17,0,80,112,22,214
3130608,0,0,0,109,28,0,137,277,53,467
3130609,0,3,3,84,34,3,121,218,62,401
3130610,3,3,6,46,31,3,80,166,44,290
3130611,6,3,9,97,36,3,136,268,57,461
3130612,0,0,0,34,18,6,58,131,74,263
3130613,0,0,0,32,17,3,52,136,47,235
3130614,8,5,13,54,18,0,72,243,117,432
3130615,0,0,0,67,38,9,114,226,34,374
3130616,0,0,0,52,31,3,86,147,16,249
3130617,26,0,26,70,29,9,108,306,59,473
3130618,10,0,10,43,15,6,64,321,30,415
3130619,24,6,30,15,16,0,31,151,28,210
3130620,3,0,3,36,15,0,51,175,39,265
3130621,4,3,7,22,31,0,53,134,13,200
3130622,0,0,0,0,0,0,0,3,0,3
3130623,4,0,4,40,13,7,60,114,6,180
3130701,4,0,4,85,12,3,100,202,31,333
3130702,0,0,0,60,29,5,94,253,44,391
3130703,0,0,0,58,24,3,85,250,35,370
3130704,0,0,0,47,30,6,83,217,24,324
3130705,0,0,0,25,3,0,28,31,3,62
3130706,0,0,0,9,0,0,9,8,3,20
3130707,21,3,24,12,31,0,43,302,50,395
3130708,17,0,17,52,64,0,116,528,42,686
3130709,0,0,0,240,44,14,298,372,87,757
3130710,0,0,0,129,36,8,173,238,30,441
3130711,0,0,0,31,16,9,56,74,24,154
3130712,5,0,5,119,40,15,174,262,34,470
3130713,3,0,3,61,23,7,91,239,27,357
3130714,11,6,17,157,40,6,203,422,70,695
3130715,3,0,3,67,14,4,85,170,24,279
3130716,11,3,14,75,21,0,96,222,24,342
3130717,3,0,3,83,30,0,113,212,22,347
3130718,0,0,0,79,23,4,106,213,60,379
3130719,0,3,3,52,54,4,110,347,28,485
3130720,0,0,0,30,4,3,37,63,33,133
3130721,0,0,0,69,25,0,94,232,50,376
3130722,4,0,4,53,15,7,75,243,54,372
3130723,3,3,6,60,41,5,106,281,33,420
3130724,4,0,4,47,10,3,60,119,10,189
3130725,0,0,0,140,24,6,170,237,52,459
3130801,0,0,0,90,18,5,113,133,18,264
3130802,0,0,0,133,29,10,172,302,22,496
3130803,0,0,0,48,18,0,66,161,18,245
3130804,0,3,3,87,36,10,133,227,18,378
3130805,4,0,4,101,18,3,122,222,26,370
3130806,0,0,0,78,25,4,107,186,12,305
3130807,0,0,0,106,29,4,139,195,13,347
3130808,0,0,0,56,35,12,103,165,10,278
3130809,0,0,0,57,15,3,75,150,18,243
3130810,0,0,0,46,9,0,55,102,12,169
3130811,0,0,0,58,27,3,88,137,7,232
3130812,0,0,0,169,42,13,224,287,46,557
3130813,44,5,49,66,19,6,91,263,31,385
3130814,4,0,4,91,27,3,121,243,36,400
3130815,3,0,3,81,15,3,99,131,19,249
3130901,0,0,0,116,17,10,143,246,15,404
3130902,0,0,0,69,19,3,91,154,11,256
3130903,3,0,3,110,33,6,149,216,6,371
3130904,30,11,41,0,3,0,3,183,20,206
3130905,3,0,3,114,37,0,151,204,24,379
3130906,3,3,6,59,36,5,100,163,10,273
3130907,0,0,0,60,24,0,84,155,9,248
3130908,16,3,19,34,33,6,73,187,29,289
3130909,8,0,8,57,30,6,93,270,35,398
3130910,3,3,6,57,22,6,85,162,15,262
3130911,3,0,3,56,19,3,78,127,18,223
3130912,3,0,3,42,18,0,60,112,10,182
3130913,3,0,3,74,18,4,96,218,22,336
3130914,3,0,3,36,22,0,58,123,9,190
3130915,0,0,0,66,38,3,107,199,22,328
3130916,0,0,0,41,7,0,48,99,10,157
3131001,8,0,8,40,16,0,56,171,24,251
3131002,0,0,0,106,43,3,152,276,9,437
3131003,3,0,3,103,31,9,143,271,18,432
3131004,4,0,4,112,46,18,176,348,27,551
3131005,0,0,0,65,43,0,108,271,12,391
3131006,3,0,3,49,13,3,65,142,30,237
3131007,0,0,0,138,41,0,179,259,35,473
3131008,3,0,3,95,35,5,135,281,15,431
3131009,0,0,0,46,26,4,76,172,19,267
3131010,0,0,0,124,38,6,168,282,37,487
3131011,0,0,0,28,26,0,54,212,13,279
3131101,0,0,0,58,19,6,83,157,15,255
3131102,0,0,0,106,27,3,136,166,26,328
3131103,0,0,0,90,25,12,127,251,36,414
3131104,0,0,0,119,36,10,165,232,28,425
3131105,3,0,3,82,38,7,127,232,25,384
3131106,3,0,3,111,35,10,156,292,21,469
3131107,4,0,4,101,29,3,133,173,37,343
3131108,0,0,3,51,22,3,76,251,24,351
3131109,17,4,21,38,63,0,101,502,86,689
3131110,0,0,0,32,13,0,45,102,17,164
3131111,0,0,0,40,20,4,64,123,42,229
3131112,0,0,0,26,15,3,44,113,3,160
3131113,0,0,0,36,20,3,59,154,28,241
3131114,0,0,0,55,25,0,80,244,30,354
3131115,3,0,3,62,30,0,92,205,18,315
3131116,0,0,0,34,34,9,77,166,19,262
3131117,44,0,44,40,36,3,79,328,14,421
3131118,0,3,3,48,30,6,84,154,20,258
3131119,19,0,19,4,21,0,25,240,33,298
3131120,3,0,3,39,14,5,58,113,21,192
3131121,0,0,0,0,0,0,0,0,0,0
3131122,63,8,71,108,34,6,148,381,38,567
3131123,0,0,0,75,9,7,91,98,10,199
3131124,0,0,0,80,31,9,120,163,22,305
3131125,0,0,0,85,9,7,101,137,18,256
3131126,3,0,3,99,34,4,137,178,24,339
3131127,3,0,3,110,31,0,141,234,33,408
3131128,3,0,3,106,23,4,133,254,19,406
3131129,3,0,3,33,18,0,51,104,9,164
3131201,0,0,0,91,30,0,121,239,14,374
3131202,3,0,3,28,18,0,46,103,13,162
3131203,0,0,0,43,6,0,49,135,21,205
3131204,0,3,3,56,10,0,66,163,13,242
3131205,0,0,0,72,20,0,92,148,21,261
3131206,0,0,0,86,34,4,124,262,25,411
3131207,0,0,0,103,30,0,133,205,22,360
3131208,3,3,6,56,16,0,72,165,42,279
3131209,0,0,0,0,0,0,0,0,0,0
3131210,3,0,3,64,26,0,90,139,24,253
3131211,3,3,6,97,29,6,132,255,21,408
3131212,4,57,61,201,37,8,246,447,163,856
3131213,5,0,5,86,43,6,135,237,18,390
3131214,0,4,4,61,38,0,99,196,22,317
3131215,3,3,6,72,33,3,108,216,33,357
3131216,0,0,0,67,29,6,102,162,20,284
3131301,3,0,3,40,14,5,59,127,15,201
3131302,0,0,0,43,18,6,67,152,25,244
3131303,4,0,4,45,9,6,60,90,7,157
3131304,3,0,3,39,27,0,66,156,24,246
3131305,6,0,6,79,42,0,121,375,27,523
3131306,3,0,3,52,17,3,72,214,21,307
3131307,0,0,0,32,16,0,48,99,16,163
3131308,0,3,3,53,20,0,73,156,24,253
3131309,3,0,3,83,27,9,119,232,18,369
3131310,0,0,0,87,24,5,116,206,18,340
3131311,3,0,3,43,15,3,61,152,3,216
3131401,0,0,0,93,22,12,127,175,22,324
3131402,0,0,0,59,14,6,79,192,20,291
3131403,0,0,0,84,7,11,102,100,21,223
3131404,0,0,0,76,17,0,93,147,31,271
3131405,0,0,0,93,35,0,128,159,19,306
3131406,3,0,3,79,21,0,100,175,18,293
3131407,0,0,0,163,34,9,206,273,34,513
3131408,0,0,0,105,15,6,126,165,27,318
3131409,0,0,0,0,0,0,0,0,0,0
3131410,0,0,0,85,22,7,114,210,37,361
3131411,0,0,0,91,44,0,135,222,34,391
3131412,0,0,0,0,0,0,0,0,0,0
3131413,0,0,0,117,18,0,135,132,23,290
3131414,0,0,0,110,16,10,136,187,30,353
3131415,0,0,0,76,22,0,98,122,11,231
3131416,0,0,0,99,18,6,123,207,21,351
3131417,0,0,0,83,18,8,109,138,27,274
3131418,0,0,0,67,18,9,94,122,9,225
3131419,0,0,0,84,22,0,106,187,29,322
3131420,0,0,0,66,40,9,115,240,48,403
3131421,0,0,0,87,26,6,119,194,30,343
3131422,0,0,0,70,24,0,94,143,21,258
3131423,0,0,0,79,22,3,104,193,21,318
3131424,0,0,0,61,10,0,71,141,16,228
3131425,0,0,0,80,23,0,103,217,37,357
3131426,0,0,0,80,16,6,102,105,9,216
3131427,0,0,0,145,29,12,186,209,30,425
3131501,0,0,0,0,0,0,0,0,0,0
3131601,36,3,39,80,16,7,103,214,24,341
3131602,3,0,3,70,24,3,97,172,8,277
3131603,0,0,0,54,27,3,84,84,0,168
3131604,0,0,0,114,24,9,147,222,21,390
3131605,0,0,0,93,16,4,113,222,25,360
3131606,6,0,6,36,3,13,52,126,10,188
3131607,0,0,0,63,29,0,92,152,19,263
3131608,0,0,0,85,39,6,130,282,43,455
3131609,4,0,7,96,32,0,128,216,25,369
3131610,0,3,3,72,16,3,91,179,21,291
3131611,0,0,0,53,15,4,72,225,28,325
3131612,0,0,0,52,16,3,71,151,27,249
3131613,0,0,0,0,0,0,0,6,0,6
3131614,0,0,0,76,21,0,97,198,18,313
3131615,3,0,3,76,30,0,106,238,18,362
3131616,3,0,3,34,24,6,64,150,12,226
3131617,4,0,4,126,47,10,183,282,24,489
3131618,3,0,3,64,37,3,104,264,15,383
3131619,0,0,0,79,18,3,100,197,19,316
3131620,0,0,0,54,14,9,77,153,16,246
3131701,0,0,0,42,15,0,57,80,14,151
3131702,0,3,3,135,48,11,194,271,94,559
3131703,0,0,0,108,25,7,140,215,61,416
3131704,6,0,6,37,15,0,52,162,35,249
3131705,17,6,23,95,40,9,144,305,85,534
3131706,0,0,0,94,32,10,136,232,43,411
3131707,0,0,0,105,12,10,127,160,15,302
3131708,0,0,0,189,51,0,240,362,79,681
3131709,0,0,0,80,13,3,96,178,22,296
3131710,0,0,0,44,22,4,70,160,15,245
3131711,3,0,3,86,28,7,121,167,42,330
3131712,0,0,0,44,19,3,66,167,28,261
3131713,3,0,3,40,21,3,64,105,18,187
3131714,4,0,4,38,26,9,73,83,8,164
3131715,0,0,0,87,36,11,134,241,36,411
3131716,0,0,0,163,25,8,196,265,37,498
3131717,0,0,0,104,30,6,140,156,22,318
3131718,0,0,0,31,21,0,52,100,18,170
3131719,0,0,0,93,31,6,130,293,21,444
3131720,0,0,0,51,15,3,69,129,13,211
3131721,0,0,0,39,16,12,67,175,13,255
3131722,7,0,7,37,12,4,53,129,20,202
3131723,0,0,0,98,30,7,135,248,31,414
3131724,0,0,0,95,28,3,126,182,29,337
3131725,0,6,6,30,9,0,39,119,13,171
3131726,0,0,0,0,0,0,0,0,0,0
3131801,0,0,0,42,15,6,63,158,13,234
3131802,3,0,3,88,18,6,112,135,16,263
3131803,0,0,0,32,11,0,43,104,9,156
3131804,0,0,0,51,16,6,73,104,15,192
3131805,3,0,3,52,16,3,71,156,17,244
3131806,0,0,0,37,15,0,52,142,28,222
3131807,4,0,4,59,25,0,84,220,23,327
3131808,3,3,6,68,25,0,93,208,20,321
3131809,0,0,0,64,31,5,100,183,6,289
3131810,0,0,0,74,26,3,103,208,18,329
3131811,0,0,0,69,25,4,98,177,10,285
3131812,0,0,0,60,18,3,81,202,7,290
3131813,4,0,4,54,13,0,67,157,7,231
3131814,0,0,0,55,14,6,75,145,5,225
3131901,0,0,0,44,16,3,63,137,30,230
3131902,3,0,3,91,27,3,121,201,19,341
3131903,0,0,0,63,15,0,78,132,6,216
3131904,3,0,3,106,26,0,132,198,18,348
3131905,0,0,0,51,23,3,77,108,6,191
3131906,3,0,3,78,33,3,114,225,15,354
3131907,0,0,0,78,28,10,116,203,7,326
3131908,0,3,3,113,33,7,153,270,23,446
3131909,0,0,0,92,27,3,122,216,23,361
3131910,3,0,3,80,21,9,110,144,27,281
3131911,0,0,0,96,35,0,131,156,16,303
3131912,3,0,3,152,37,3,192,253,21,466
3131913,6,0,6,83,27,5,115,192,12,319
3131914,6,0,6,81,31,4,116,191,20,327
3131915,0,0,0,52,15,0,67,215,9,291
3131916,0,0,0,84,15,0,99,187,12,298
3131917,4,0,4,92,24,10,126,221,10,357
3131918,4,0,4,86,56,6,148,236,17,401
3131919,0,0,0,138,35,6,179,302,23,504
3131920,3,0,3,316,64,21,401,472,101,974
3131921,0,0,0,91,26,9,126,181,23,330
3131922,3,0,3,69,26,0,95,132,14,241
3131923,0,0,0,61,6,0,67,103,11,181
3131924,3,0,3,86,21,0,107,180,24,311
3131925,3,0,3,83,45,9,137,235,31,403
3131926,4,0,4,81,35,6,122,267,27,416
3131927,0,0,0,0,0,0,0,0,0,0
3131928,0,0,0,156,22,9,187,210,38,435
3131929,0,0,0,69,29,7,105,208,28,341
3131930,3,0,3,77,25,6,108,231,36,375
3131931,0,3,3,84,15,6,105,227,42,374
3131932,0,0,0,3,0,0,3,0,0,3
3131933,3,0,3,63,35,4,102,197,21,320
3131934,0,5,5,43,18,0,61,172,9,242
3131935,0,0,0,65,40,0,105,230,9,344
3132001,0,0,0,51,16,3,70,116,36,222
3132002,0,0,0,55,28,0,83,136,14,233
3132003,0,0,0,107,28,6,141,158,20,319
3132004,0,0,0,319,42,9,370,315,36,721
3132005,3,0,3,43,28,0,71,111,6,188
3132006,0,0,0,49,10,0,59,142,22,223
3132007,0,0,0,32,18,3,53,98,3,154
3132008,0,0,0,109,38,3,150,247,19,416
3132009,0,0,0,34,23,3,60,123,16,199
3132010,3,0,3,44,22,6,72,196,28,296
3132011,0,0,0,11,9,0,20,65,20,105
3132012,3,0,3,64,9,0,73,151,12,236
3132013,0,0,0,92,33,9,134,276,34,444
3132014,0,0,0,77,14,3,94,164,18,276
3132015,5,0,5,125,29,6,160,195,17,372
3132016,0,0,0,36,5,0,41,137,17,195
3132017,0,0,0,85,43,9,137,211,18,366
3132018,0,0,0,255,69,14,338,279,13,630
3132019,3,0,3,97,15,0,112,177,14,303
3132020,0,0,0,150,32,9,191,269,31,491
3132021,3,0,3,73,17,9,99,187,8,294
3132022,3,0,3,41,19,9,69,135,7,211
3132023,0,3,3,43,22,0,65,116,15,196
3132024,0,3,3,51,36,3,90,200,11,301
3132025,0,0,0,0,0,0,0,0,0,0
3132026,3,0,3,112,28,3,143,163,3,309
3132027,0,0,0,79,24,10,113,123,15,251
3132028,0,0,0,69,25,6,100,134,7,241
3132029,3,0,3,212,35,3,250,242,6,498
3132101,0,0,0,59,33,6,98,179,45,322
3132102,0,0,0,57,18,0,75,124,24,223
3132103,0,0,0,93,12,7,112,142,26,280
3132104,0,0,0,100,19,3,122,137,35,294
3132105,0,0,0,129,25,0,154,181,25,360
3132106,3,0,3,100,15,0,115,159,19,293
3132107,3,0,3,64,32,0,96,218,24,338
3132108,0,0,0,80,34,3,117,207,19,343
3132109,0,3,3,28,22,0,50,109,14,173
3132110,3,0,3,71,26,4,101,199,21,321
3132111,0,0,0,59,12,7,78,135,9,222
3132112,0,0,0,145,32,13,190,196,9,395
3132113,0,0,0,81,24,0,105,130,10,245
3132114,0,0,0,232,47,14,293,321,49,663
3132115,0,0,0,35,19,6,60,154,12,226
3132116,0,0,0,145,29,7,181,177,21,379
3132117,0,0,0,157,47,12,216,239,23,478
3132118,3,3,6,297,58,10,365,281,38,684
3132119,0,0,0,76,18,3,97,243,13,353
3132120,3,0,3,52,7,0,59,154,21,234
3132121,8,0,8,174,42,5,221,274,13,508
3132122,0,0,0,119,44,9,172,220,35,427
3132123,0,0,0,77,25,3,105,172,22,299
3132124,0,0,0,42,27,0,69,120,9,198
3132125,0,0,0,180,26,10,216,173,6,395
3132126,0,0,0,64,13,7,84,126,17,227
3132127,0,0,0,135,21,6,162,245,20,427
3132128,0,0,0,49,15,0,64,118,6,188
3132129,0,0,0,108,38,4,150,192,21,363
3132130,0,0,0,67,24,3,94,199,6,299
3132131,0,0,0,29,12,3,44,97,21,162
3132132,4,0,4,76,18,6,100,161,27,288
3132133,0,0,0,78,31,3,112,161,22,295
3132134,0,0,0,59,25,0,84,94,6,184
3132135,0,0,0,42,19,4,65,114,6,185
3132136,3,0,3,59,23,3,85,141,15,241
3132137,0,3,3,116,32,8,156,152,22,330
3132138,3,0,3,67,16,0,83,109,6,198
3132139,6,0,6,39,25,0,64,166,15,245
3132140,6,0,6,85,35,3,123,192,23,338
3132141,0,0,0,68,28,0,96,221,24,341
3132142,0,0,0,77,34,6,117,177,13,307
3132143,0,3,3,81,17,6,104,195,24,323
3132144,0,0,0,122,20,15,157,221,12,390
3132145,3,3,6,97,36,6,139,271,11,421
3132201,0,0,0,38,16,4,58,111,18,187
3132202,0,0,0,64,23,0,87,173,32,292
3132203,3,0,3,78,19,0,97,170,18,285
3132204,0,0,0,62,21,6,89,151,11,251
3132205,0,0,0,101,21,8,130,239,15,384
3132206,3,0,3,77,26,6,109,150,12,271
3132207,0,0,0,56,22,0,78,179,22,279
3132208,6,0,6,56,27,7,90,204,36,330
3132209,3,4,7,37,12,0,49,76,22,147
3132210,0,0,0,63,18,0,81,118,33,232
3132211,0,0,0,50,26,0,76,146,19,241
3132212,0,6,6,36,12,6,54,183,33,270
3132213,0,0,0,55,9,0,64,130,20,214
3132214,6,0,6,59,40,8,107,251,24,382
3132215,0,0,0,37,20,0,57,98,31,186
3132216,0,0,0,29,24,9,62,116,12,190
3132217,0,0,0,40,28,0,68,94,18,180
3132218,0,0,0,44,21,3,68,206,44,318
3132301,0,0,0,39,10,0,49,85,45,179
3132302,38,14,52,3,13,0,16,252,39,307
3132303,9,57,66,44,19,0,63,173,128,364
3132304,7,3,10,90,24,0,114,193,38,345
3132305,0,0,0,76,27,4,107,127,30,264
3132306,6,8,14,101,41,0,142,297,40,479
3132307,3,0,3,73,29,4,106,259,16,381
3132308,0,0,0,103,41,23,167,201,22,390
3132309,3,0,3,69,28,7,104,187,21,312
3132310,45,14,59,3,27,0,30,415,69,514
3132311,37,46,83,3,8,0,11,244,124,379
3132312,6,23,29,81,19,0,100,191,58,349
3132313,0,0,0,189,40,9,238,339,25,602
3132314,0,0,0,40,20,3,63,89,11,163
3132315,0,0,0,0,0,0,0,3,0,3
3132316,0,3,3,85,29,0,114,207,33,354
3132317,0,0,0,19,15,0,34,100,3,137
3132318,3,0,3,45,12,3,60,114,9,183
3132319,3,0,3,85,39,6,130,212,25,367
3132320,0,0,0,154,40,9,203,250,30,483
3132321,3,0,3,40,12,0,52,161,43,256
3132401,0,0,0,54,12,10,76,125,9,210
3132402,0,0,0,42,15,3,60,132,9,201
3132403,0,0,0,54,26,3,83,199,15,297
3132404,0,0,0,75,42,6,123,232,11,366
3132405,0,0,0,72,22,0,94,169,18,281
3132406,0,0,0,79,30,6,115,237,18,370
3132407,0,0,0,46,31,3,80,171,15,266
3132408,3,0,3,38,15,0,53,115,19,187
3132409,0,0,0,38,32,3,73,153,11,237
3132410,0,0,0,44,19,0,63,176,5,244
3132411,6,0,6,27,19,0,46,117,17,180
3132412,3,0,3,62,34,6,102,205,20,327
3132413,0,0,0,68,18,0,86,129,10,225
3132414,9,0,9,82,45,7,134,301,14,449
3132415,0,0,0,77,20,3,100,205,30,335
3132416,0,0,0,4,13,0,17,147,31,195
3132417,30,0,30,28,14,0,42,106,18,166
3132418,0,0,0,44,30,6,80,163,6,249
3132419,3,0,3,47,25,5,77,198,18,293
3132420,0,0,0,69,37,6,112,205,33,350
3132421,10,0,10,93,34,3,130,270,27,427
3132422,6,0,6,85,26,6,117,219,11,347
3132423,0,0,0,71,34,3,108,178,17,303
3132501,0,0,0,141,41,3,185,183,9,377
3132502,0,0,0,84,19,3,106,185,9,300
3132503,0,0,0,84,21,0,105,159,7,271
3132504,0,0,0,53,17,0,70,141,4,215
3132505,0,0,0,55,29,3,87,215,19,321
3132506,6,0,6,44,25,0,69,156,6,231
3132507,0,0,0,87,9,3,99,129,5,233
3132508,0,0,0,89,22,7,118,212,15,345
3132509,3,0,3,50,22,6,78,162,3,243
3132510,0,0,0,61,19,0,80,119,20,219
3132511,0,0,0,60,16,0,76,144,0,220
3132512,0,0,0,15,21,3,39,88,13,140
3132513,4,0,4,69,19,7,95,147,15,257
3132514,0,0,0,151,28,7,186,220,20,426
3132515,0,3,3,112,32,3,147,204,21,372
3132516,3,0,3,104,42,9,155,256,38,449
3132517,3,0,3,47,18,6,71,146,12,229
3132518,3,3,6,68,36,3,107,178,30,315
3132519,0,0,0,0,0,0,0,0,0,0
3132520,0,0,0,97,24,3,124,281,62,467
3132521,0,0,0,149,67,12,228,299,35,562
3132522,0,0,0,133,23,9,165,246,22,433
3132523,0,0,0,121,35,0,156,258,23,437
3132524,0,0,0,59,19,0,78,122,25,225
3132525,0,0,0,0,0,0,0,0,0,0
3132526,3,0,3,82,35,0,117,305,24,446
3132527,4,0,4,52,30,3,85,215,36,336
3132528,0,0,0,33,21,0,54,115,3,172
3132601,3,0,3,22,16,0,38,140,7,185
3132602,6,0,6,49,26,0,75,166,16,257
3132603,0,0,0,121,16,4,141,240,36,417
3132604,0,0,0,79,14,10,103,166,12,281
3132605,3,0,3,66,19,13,98,167,24,289
3132606,0,0,0,94,25,3,122,208,21,351
3132607,3,0,3,90,40,3,133,172,28,333
3132608,0,0,0,77,32,0,109,232,36,377
3132609,0,0,0,100,23,4,127,214,60,401
3132610,3,0,3,66,20,0,86,183,39,308
3132611,0,0,0,43,23,0,66,184,36,286
3132612,9,0,9,69,31,3,103,285,54,442
3132613,0,0,0,80,26,7,113,240,34,387
3132614,0,0,0,95,45,12,152,348,51,551
3132615,6,0,6,94,45,12,151,202,22,375
3132616,3,3,6,88,28,13,129,225,21,375
3132617,0,0,0,0,0,0,0,0,0,0
3132618,0,0,0,70,40,8,118,220,28,366
3132619,0,0,0,0,3,0,3,18,3,24
3132620,6,6,12,72,26,3,101,179,44,324
3132621,0,0,0,0,0,0,0,0,0,0
3132622,0,0,0,116,38,4,158,264,21,443
3132623,0,0,0,76,28,9,113,190,27,330
3132701,6,0,6,116,52,4,172,284,11,467
3132702,0,0,0,62,28,0,90,226,0,316
3132703,0,0,0,78,26,3,107,181,18,306
3132704,3,0,3,58,21,9,88,215,11,314
3132705,4,0,4,74,45,6,125,211,15,351
3132706,0,0,0,28,12,0,40,100,3,143
3132707,0,0,0,72,45,0,117,172,5,294
3132708,0,6,6,69,22,6,97,259,15,371
3132709,3,0,3,92,25,0,117,221,3,341
3132710,7,0,7,62,35,0,97,247,18,362
3132711,4,0,4,35,17,0,52,146,7,205
3132712,6,0,6,48,15,0,63,172,16,251
3132713,3,0,3,59,13,0,72,177,20,269
3132714,0,0,0,42,7,5,54,99,6,159
3132715,6,0,6,101,33,11,145,278,23,446
3132716,0,0,0,48,18,6,72,204,9,285
3132717,0,0,0,58,31,3,92,285,4,381
3132718,0,0,0,86,22,3,111,159,13,283
3132719,0,0,3,116,45,3,164,287,15,466
3132720,0,0,0,39,23,6,68,131,3,202
3132721,0,0,0,96,31,0,127,208,12,347
3132722,0,0,0,60,25,7,92,211,5,308
3132723,6,0,6,77,43,4,124,226,15,365
3132724,0,0,0,72,14,0,86,208,15,309
3132725,0,0,0,83,24,6,113,183,5,301
3132726,0,0,0,79,24,0,103,147,3,253
3132727,3,0,3,88,26,6,120,218,14,352
3132728,3,0,3,42,23,3,68,104,6,178
3132729,0,0,0,80,36,0,116,234,36,386
3132801,0,0,0,47,22,0,69,155,15,239
3132802,0,0,0,88,26,3,117,257,28,402
3132803,0,0,0,105,34,10,149,289,26,464
3132804,3,0,3,81,62,0,143,274,40,457
3132805,0,0,0,31,17,6,54,107,13,174
3132806,36,11,47,21,29,3,53,323,54,430
3132807,0,0,0,122,33,3,158,288,33,479
3132808,0,0,0,219,27,6,252,300,29,581
3132809,0,0,0,33,11,6,50,82,9,141
3132810,0,0,0,106,25,6,137,193,37,367
3132811,0,0,0,46,9,0,55,112,25,192
3132812,0,0,0,96,40,5,141,229,46,416
3132813,3,0,3,80,33,7,120,236,39,395
3132814,3,0,3,49,22,3,74,140,11,225
3132815,0,0,0,84,23,5,112,241,56,409
3132901,4,0,4,89,28,9,126,187,9,322
3132902,3,0,3,43,15,0,58,136,19,213
3132903,0,0,0,60,37,0,97,228,14,339
3132904,6,0,6,42,28,6,76,125,12,213
3132905,3,3,6,67,31,4,102,191,12,305
3132906,0,3,3,166,42,13,221,324,30,575
3132907,0,0,0,82,44,4,130,227,22,379
3132908,3,0,3,80,46,5,131,238,15,384
3132909,4,0,4,40,27,9,76,142,0,218
3132910,0,0,0,0,0,0,0,0,0,0
3132911,0,0,0,89,43,7,139,223,15,377
3132912,7,0,7,77,22,6,105,191,13,309
3132913,6,3,9,49,18,0,67,265,30,362
3132914,3,0,3,62,17,3,82,167,15,264
3132915,0,3,3,55,32,6,93,195,15,303
3132916,3,0,3,44,19,3,66,156,4,226
3132917,3,0,3,45,14,0,59,137,6,202
3133001,0,0,0,52,30,3,85,166,63,314
3133002,0,3,3,45,23,3,71,172,36,279
3133003,7,0,7,49,23,0,72,254,45,371
3133004,3,3,6,78,22,3,103,185,40,328
3133005,0,3,3,62,26,0,88,195,62,345
3133006,0,0,0,61,33,3,97,157,38,292
3133007,0,0,0,0,0,0,0,0,3,3
3133008,5,0,5,63,25,0,88,226,81,395
3133009,0,0,0,35,20,0,55,146,31,232
3133010,0,0,0,58,23,0,81,147,32,260
3133011,0,0,0,67,29,3,99,154,41,294
3133012,3,6,9,65,30,4,99,199,48,346
3133013,0,0,0,57,19,0,76,169,32,277
3133014,3,3,6,94,36,11,141,271,54,466
3133015,0,0,0,94,21,0,115,172,55,342
3133016,0,0,0,87,29,6,122,232,46,400
3133017,0,0,0,48,24,0,72,133,15,220
3133018,0,0,0,106,22,7,135,205,60,400
3133019,0,0,0,23,9,0,32,62,15,109
3133020,3,3,6,88,26,3,117,244,29,390
3133021,3,0,3,73,35,8,116,209,45,370
3133022,4,0,4,55,25,6,86,169,29,284
3133023,0,0,0,43,21,6,70,216,29,315
3133024,3,0,3,38,16,0,54,138,23,215
3133025,0,0,0,3,0,0,3,0,3,6
3133026,0,0,0,61,23,3,87,180,33,300
3133101,0,0,0,35,10,0,45,118,21,184
3133102,0,0,0,83,27,0,110,227,27,364
3133103,0,0,0,16,0,0,16,44,10,70
3133104,6,0,6,58,36,3,97,238,93,428
3133105,4,0,4,26,12,3,41,113,35,189
3133106,3,0,3,89,38,0,127,275,55,457
3133107,0,0,0,53,35,0,88,216,49,353
3133108,6,0,6,54,15,3,72,148,17,237
3133109,0,4,4,51,27,0,78,251,102,431
3133110,0,0,0,63,33,3,99,265,55,419
3133111,4,0,4,63,10,0,73,154,52,279
3133112,5,0,5,55,26,3,84,167,23,274
3133113,3,0,3,87,58,15,160,261,23,444
3133114,0,0,0,55,32,0,87,237,36,360
3133115,3,0,3,53,34,0,87,149,22,258
3133201,0,0,0,51,15,0,66,127,16,209
3133202,0,0,0,59,21,6,86,195,26,307
3133203,0,0,0,73,23,0,96,160,14,270
3133204,3,3,6,80,38,0,118,223,25,366
3133205,3,0,3,60,21,3,84,242,19,345
3133206,3,0,3,89,31,3,123,298,13,434
3133207,3,0,3,79,36,3,118,252,18,388
3133208,0,0,0,58,25,9,92,142,12,246
3133209,42,9,51,53,33,0,86,265,33,384
3133210,6,0,6,41,29,3,73,223,9,305
3133211,0,0,0,87,28,3,118,311,16,445
3133212,0,0,0,19,13,3,35,69,0,104
3133213,0,0,0,73,34,4,111,163,18,292
3133214,0,3,3,53,25,0,78,153,18,249
3133215,3,3,6,101,22,0,123,233,24,380
3133216,0,3,3,104,27,6,137,211,19,367
3133217,0,0,0,93,39,8,140,227,12,379
3133218,4,0,4,37,15,6,58,138,19,215
3133219,0,0,0,46,22,0,68,164,12,244
3133220,0,0,3,67,27,0,94,155,18,267
3133221,7,0,7,78,30,0,108,253,18,379
3133222,0,0,0,43,19,3,65,138,3,206
3133223,0,0,0,86,34,9,129,198,26,353
3133224,3,0,3,57,29,9,95,199,13,307
3133225,0,3,3,50,21,3,74,180,24,278
3133226,7,0,7,43,13,3,59,202,16,277
3133227,3,0,3,60,19,3,82,124,9,215
3133228,4,0,4,112,29,3,144,251,17,412
3133229,6,0,6,69,17,0,86,142,4,232
3133230,3,0,3,29,13,0,42,134,12,188
3133231,7,0,7,66,31,0,97,171,9,277
3133232,12,0,12,101,34,3,138,264,18,420
3133233,4,0,4,91,24,6,121,192,30,343
3133234,0,0,0,49,15,0,64,140,9,213
3133235,0,0,0,56,20,8,84,215,10,309
3133236,0,0,0,60,16,0,76,147,6,229
3133237,0,0,0,108,39,6,153,275,18,446
3133238,0,0,0,58,21,0,79,155,10,244
3133239,0,0,0,52,19,0,71,131,6,208
3133240,6,0,6,79,21,3,103,180,9,292
3133301,7,6,13,46,24,0,70,143,23,236
3133302,0,0,0,72,44,3,119,223,17,359
3133303,0,0,0,65,49,6,120,233,18,371
3133304,4,0,4,83,39,3,125,250,53,428
3133305,0,0,0,0,0,0,0,16,0,16
3133306,0,0,0,70,22,0,92,221,23,336
3133307,10,5,15,33,12,0,45,170,41,256
3133308,0,0,0,32,6,7,45,154,21,220
3133309,0,0,0,62,30,3,95,195,32,322
3133310,0,0,0,26,25,0,51,103,25,179
3133311,0,3,3,28,21,3,52,140,48,240
3133312,0,0,0,37,12,0,49,104,0,153
3133313,0,0,0,86,33,0,119,157,6,282
3133314,0,0,0,26,11,0,37,126,7,170
3133315,31,36,67,51,17,6,74,226,84,384
3133316,3,0,3,91,57,6,154,273,13,440
3133317,3,3,6,56,35,4,95,108,24,227
3133318,3,3,6,92,47,0,139,254,20,413
3133319,4,0,4,65,34,0,99,214,29,342
3133320,6,0,6,94,46,3,143,236,21,400
3133321,0,0,0,53,22,0,75,215,54,344
3133322,4,0,4,92,23,3,118,270,54,442
3133323,0,0,3,59,27,3,89,150,51,290
3133324,0,0,0,58,21,0,79,123,40,242
3133325,0,0,0,66,21,3,90,206,43,339
3133326,3,3,6,71,26,0,97,178,54,329
3133327,0,0,0,63,24,7,94,155,53,302
3133401,3,0,3,96,53,0,149,294,26,469
3133402,5,0,5,100,21,3,124,309,14,447
3133403,3,0,3,58,8,0,66,147,21,234
3133404,0,0,0,63,23,3,89,109,11,209
3133405,4,0,4,71,46,4,121,310,39,470
3133406,3,0,3,72,31,3,106,231,31,368
3133407,4,3,7,73,29,3,105,242,21,368
3133408,3,0,3,61,35,0,96,171,15,282
3133409,59,7,66,57,35,0,92,310,35,437
3133410,6,0,6,78,55,6,139,339,18,496
3133411,0,0,0,104,49,3,156,264,15,435
3133412,0,0,0,36,20,0,56,134,8,198
3133413,0,0,0,54,34,3,91,168,6,265
3133414,4,0,4,54,21,4,79,213,16,308
3133415,4,0,4,90,33,3,126,251,17,394
3133416,0,0,0,77,38,7,122,256,11,389
3133417,6,3,9,104,29,11,144,243,19,406
3133418,3,0,3,41,26,0,67,141,9,217
3133419,0,0,0,41,10,0,51,179,19,249
3133420,0,0,0,32,16,0,48,201,0,249
3133421,0,0,3,30,21,0,51,153,3,207
3133422,6,0,6,56,24,0,80,151,12,243
3133501,3,0,3,207,48,6,261,435,37,733
3133502,3,3,6,70,34,0,104,245,37,386
3133503,0,5,5,69,21,3,93,197,9,299
3133504,0,4,4,78,29,9,116,177,21,314
3133505,0,0,0,66,19,0,85,94,12,191
3133506,0,0,0,0,0,0,0,3,0,3
3133507,0,0,0,78,26,0,104,167,9,280
3133508,0,0,0,72,15,0,87,183,13,283
3133509,0,0,0,51,15,3,69,132,13,214
3133510,0,0,0,151,22,9,182,290,29,501
3133511,3,0,3,25,21,3,49,82,3,134
3133512,3,0,3,109,29,6,144,234,46,424
3133513,0,3,3,82,42,5,129,210,33,372
3133601,0,0,0,82,16,0,98,243,38,379
3133602,3,0,3,94,12,4,110,256,30,396
3133603,3,0,3,67,9,6,82,203,79,364
3133604,3,0,3,83,36,3,122,338,57,517
3133605,0,0,0,32,21,3,56,131,21,208
3133606,0,0,0,32,20,3,55,114,25,194
3133607,6,0,10,65,30,0,95,189,43,327
3133608,0,0,0,64,19,0,83,198,38,319
3133609,3,0,3,63,11,0,74,162,16,252
3133610,0,0,0,86,19,3,108,214,29,351
3133611,3,0,3,61,33,0,94,208,41,343
3133612,0,0,0,32,18,6,56,110,18,184
3133613,5,0,5,44,25,4,73,168,40,281
3133614,0,0,0,59,16,6,81,235,35,351
3133615,0,0,0,64,13,0,77,118,32,227
3133616,0,0,0,38,16,3,57,103,15,175
3133617,0,0,0,47,22,5,74,148,21,243
3133618,0,0,0,73,25,0,98,206,46,350
3133619,0,0,0,48,18,3,69,213,35,317
3133620,0,0,0,24,9,0,33,98,30,161
3133621,0,0,0,50,18,6,74,138,21,233
3133622,67,7,74,30,10,0,40,303,25,368
3133623,0,0,0,54,17,3,74,235,28,337
3133624,0,0,0,99,37,6,142,305,73,520
3133625,0,0,0,48,12,3,63,85,31,179
3133626,0,0,0,44,10,8,62,132,39,233
3133627,0,0,0,56,19,3,78,193,30,301
3133628,0,0,0,71,15,9,95,223,54,372
3133629,0,3,3,71,40,0,111,195,34,340
3133630,0,0,0,110,36,0,146,260,30,436
3133631,5,0,5,73,26,7,106,195,32,333
3133701,0,0,0,42,9,0,51,128,20,199
3133702,5,0,5,76,14,6,96,261,44,401
3133703,0,0,0,29,23,0,52,218,26,296
3133704,0,0,0,66,21,3,90,174,17,281
3133705,3,6,9,66,17,13,96,258,73,427
3133706,4,0,4,48,20,3,71,184,44,299
3133707,4,3,7,44,24,3,71,160,50,281
3133708,6,0,6,56,23,5,84,312,64,460
3133709,0,6,6,54,21,4,79,147,44,270
3133710,22,0,22,55,3,13,71,195,45,311
3133711,3,0,3,73,28,9,110,262,73,445
3133712,6,0,6,36,6,0,42,157,44,243
3133713,7,0,7,89,13,12,114,253,28,395
3133714,4,0,4,54,24,3,81,275,50,406
3133715,3,3,6,60,18,6,84,221,26,331
3133716,0,3,3,35,21,0,56,148,24,228
3133717,6,0,6,97,29,15,141,235,38,414
3133718,3,3,6,54,21,3,78,298,89,465
3133719,3,4,7,47,17,10,74,275,83,432
3133720,0,6,6,39,15,6,60,230,50,340
3133721,32,10,42,17,7,3,27,202,22,251
3133801,0,0,0,142,27,9,178,208,84,470
3133802,0,0,0,130,32,12,174,182,30,386
3133803,0,0,0,54,9,6,69,97,19,185
3133804,0,0,0,89,13,0,102,100,15,217
3133805,0,0,0,113,12,3,128,166,7,301
3133806,0,0,0,144,20,15,179,133,54,366
3133807,0,0,0,34,4,0,38,193,95,326
3133808,0,0,0,83,17,3,103,143,54,300
3133809,0,0,0,66,19,3,88,186,36,310
3133810,0,0,0,64,19,6,89,267,213,569
3133811,3,0,3,47,22,3,72,195,56,323
3133812,0,0,0,63,12,4,79,116,45,240
3133813,0,0,0,89,15,0,104,95,11,210
3133814,0,0,0,138,17,3,158,293,42,493
3133815,0,0,0,50,12,3,65,103,82,250
3133816,0,0,0,56,13,0,69,61,18,148
3133817,0,0,0,45,7,0,52,93,16,161
3133818,0,0,0,66,12,3,81,163,35,279
3133819,0,0,0,58,6,4,68,120,15,203
3133820,0,0,0,73,16,6,95,178,55,328
3133821,3,4,7,26,12,0,38,247,71,356
3133822,0,0,0,61,14,3,78,88,7,173
3133823,0,0,0,75,19,6,100,195,76,371
3133824,0,0,0,91,10,13,114,111,15,240
3133825,0,0,0,0,0,0,0,0,0,0
3133826,0,0,0,30,13,3,46,181,30,257
3133827,0,0,0,0,0,0,0,0,0,0
3133828,0,0,0,17,0,0,17,22,0,39
3133901,16,0,16,46,19,0,65,182,31,278
3133902,3,0,3,84,22,0,106,182,15,303
3133903,0,0,0,75,3,3,81,119,5,205
3133904,7,3,10,48,23,0,71,201,35,307
3133905,5,0,5,75,18,3,96,164,22,282
3133906,4,3,7,91,17,4,112,171,37,320
3133907,4,0,4,149,70,6,225,377,88,690
3133908,0,0,0,103,21,4,128,190,18,336
3133909,0,0,0,49,6,4,59,93,7,159
3134001,0,6,6,26,9,0,35,98,36,169
3134002,7,0,10,20,14,0,34,133,45,212
3134003,7,0,7,34,8,3,45,133,19,197
3134004,6,0,6,40,10,0,50,149,42,241
3134005,6,0,6,51,9,0,60,114,33,207
3134006,0,3,3,37,10,0,47,103,45,195
3134007,0,0,0,46,24,0,70,127,66,263
3134008,3,0,3,94,12,5,111,292,54,457
3134009,0,0,0,41,17,0,58,125,26,209
3134010,0,0,0,30,11,0,41,117,28,186
3134011,3,0,3,13,5,0,18,96,15,129
3134012,0,0,0,73,22,6,101,220,30,351
3134013,0,0,0,54,12,0,66,126,25,217
3134014,0,0,0,0,0,0,0,0,0,0
3134015,4,0,4,31,13,0,44,147,26,217
3134101,0,0,0,12,0,0,12,16,11,39
3134102,0,0,0,315,27,14,356,261,22,639
3134103,0,0,0,86,11,9,106,126,24,256
3134104,0,0,0,177,32,17,226,179,26,431
3134105,0,0,0,100,10,5,115,193,20,328
3134106,0,0,0,93,23,8,124,194,25,343
3134107,0,0,0,55,0,0,55,83,17,155
3134108,0,0,0,93,25,7,125,129,10,264
3134109,0,0,0,94,7,11,112,247,18,377
3134110,0,0,0,96,18,3,117,158,51,326
3134111,0,0,0,15,6,0,21,80,107,208
3134112,0,0,0,75,7,3,85,111,21,217
3134113,0,0,0,86,15,3,104,167,34,305
3134114,0,0,0,28,9,3,40,165,114,319
3134115,0,0,0,188,9,11,208,120,15,343
3134116,0,0,0,123,6,7,136,149,21,306
3134117,3,0,3,39,6,0,45,104,10,159
3134118,0,0,0,74,12,6,92,158,28,278
3134119,0,0,0,64,12,7,83,136,18,237
3134120,0,0,0,69,12,3,84,234,53,371
3134121,0,0,0,73,18,3,94,158,18,270
3134122,0,0,0,81,24,3,108,183,30,321
3134201,3,0,3,90,31,5,126,186,40,352
3134202,3,0,3,113,37,13,163,290,25,478
3134203,3,0,3,86,18,3,107,171,15,293
3134204,0,6,6,66,20,3,89,254,32,375
3134205,0,4,4,76,34,10,120,226,21,367
3134206,0,0,0,23,3,0,26,41,0,67
3134207,0,0,0,69,21,0,90,93,21,204
3134208,0,0,0,6,0,0,6,6,0,12
3134209,6,0,6,99,21,9,129,293,32,454
3134210,0,0,0,91,34,3,128,181,25,334
3134211,0,0,0,50,10,0,60,127,11,198
3134212,3,0,3,58,15,4,77,146,13,236
3134213,3,0,3,42,10,0,52,99,15,166
3134214,3,0,3,67,26,6,99,220,21,340
3134215,0,0,0,100,37,3,140,189,36,365
3134216,0,3,3,81,18,6,105,136,46,287
3134217,0,4,4,72,22,0,94,141,29,264
3134218,0,0,0,41,13,0,54,102,12,168
3134219,8,0,8,81,30,3,114,193,23,330
3134220,8,0,8,76,34,4,114,266,28,408
3134221,24,3,27,56,44,6,106,300,38,444
3134222,0,0,0,73,15,4,92,180,20,292
3134223,0,0,0,197,48,12,257,334,50,641
3134224,3,0,3,58,18,3,79,132,7,218
3134225,0,0,0,69,13,5,87,124,26,237
3134226,3,0,3,113,39,9,161,212,33,406
3134227,0,0,0,79,36,5,120,234,9,363
3134228,4,0,4,91,39,7,137,250,21,408
3134229,3,0,3,73,28,3,104,296,48,448
3134230,6,0,6,60,22,9,91,192,15,298
3134231,0,0,0,92,36,3,131,381,90,602
3134232,0,0,0,60,20,3,83,123,19,225
3134233,21,12,33,124,49,6,179,416,87,682
3134234,3,0,3,38,25,6,69,129,15,213
3134301,0,0,0,56,15,0,71,146,13,230
3134302,0,0,0,76,33,5,114,251,38,403
3134303,0,0,0,0,0,0,0,0,0,0
3134304,6,0,6,57,24,0,81,164,10,255
3134305,0,0,0,61,3,3,67,109,17,193
3134306,0,0,0,0,0,0,0,0,0,0
3134307,15,4,19,55,13,0,68,274,50,392
3134308,3,0,3,39,19,0,58,181,43,282
3134309,3,0,3,55,29,0,84,185,34,303
3134310,4,0,4,66,25,3,94,162,21,277
3134311,0,0,0,68,10,0,78,225,13,316
3134312,97,10,107,30,12,0,42,265,43,350
3134401,0,0,0,123,23,9,155,165,20,340
3134402,0,0,0,97,22,0,119,194,18,331
3134403,0,0,0,60,13,9,82,115,15,212
3134404,0,0,0,39,26,0,65,123,10,198
3134405,0,0,0,71,25,0,96,221,41,358
3134406,0,0,0,191,21,11,223,304,33,560
3134407,0,0,0,96,20,4,120,136,33,289
3134408,0,0,0,93,26,3,122,194,27,343
3134409,0,0,0,224,33,17,274,388,71,733
3134410,3,0,3,130,34,6,170,261,54,485
3134411,3,0,3,81,19,0,100,199,24,323
3134412,0,0,0,123,31,3,157,285,38,480
3134413,0,0,0,60,31,3,94,167,30,291
3134414,0,0,0,140,45,10,195,278,30,503
3134415,0,0,0,55,9,3,67,89,16,172
3134416,0,0,0,98,25,13,136,192,24,352
3134417,0,0,0,191,50,12,253,343,49,645
3134418,0,0,0,79,27,9,115,209,38,362
3134419,0,0,0,75,15,0,90,129,17,236
3134420,0,0,0,50,21,3,74,103,15,192
3134501,0,0,0,0,0,0,0,6,0,6
3134601,10,0,10,53,22,6,81,214,46,341
3134602,4,0,4,46,12,3,61,181,65,307
3134603,3,0,6,51,6,4,61,185,49,295
3134604,0,0,0,53,23,0,76,200,41,317
3134605,6,3,9,38,24,3,65,281,41,387
3134606,0,0,0,81,29,0,110,241,19,370
3134607,5,3,8,61,11,0,72,350,64,486
3134608,9,0,9,71,27,6,104,275,62,441
3134609,0,0,0,27,3,0,30,82,15,127
3134610,6,0,6,40,9,0,49,246,74,369
3134701,6,3,9,52,29,7,88,314,61,463
3134801,6,0,9,45,6,0,51,109,29,189
3134802,3,0,3,64,24,0,88,149,30,267
3134803,6,6,12,68,19,6,93,193,27,313
3134804,4,0,4,51,23,6,80,173,19,272
3134805,0,0,0,42,18,0,60,118,15,193
3134806,5,0,5,128,31,11,170,287,30,487
3134807,0,0,0,46,21,0,67,92,10,169
3134808,4,3,7,37,13,3,53,140,16,209
3134809,3,3,6,290,49,7,346,458,48,852
3134810,18,30,48,80,38,9,127,272,94,493
3134811,6,0,6,74,40,0,114,248,22,384
3134812,6,3,9,83,48,0,131,256,33,420
3134813,27,3,30,124,51,8,183,492,72,747
3134814,0,0,0,50,28,0,78,143,9,230
3134815,6,0,6,117,28,0,145,212,21,378
3134816,0,0,0,33,14,4,51,94,7,152
3134817,6,3,9,54,23,3,80,112,9,201
3134818,0,0,0,73,40,3,116,135,20,271
3134819,3,0,3,57,21,0,78,163,10,251
3134820,0,0,0,77,16,3,96,152,15,263
3134821,0,0,0,64,24,9,97,199,23,319
3134822,0,0,0,80,24,0,104,172,24,300
3134823,0,0,0,140,37,3,180,229,50,459
3134824,0,0,0,84,22,0,106,203,35,344
3134825,6,0,6,58,25,0,83,116,20,219
3134901,6,0,6,51,8,0,59,170,18,247
3134902,0,0,0,40,24,0,64,122,23,209
3134903,3,0,3,77,20,6,103,202,33,338
3134904,6,0,6,86,24,5,115,209,29,353
3134905,0,0,0,3,12,0,15,75,15,105
3134906,5,0,5,77,33,3,113,218,65,396
3134907,3,0,3,43,23,7,73,212,24,309
3134908,5,5,10,79,27,0,106,278,44,428
3134909,4,0,4,81,32,7,120,212,53,385
3134910,20,0,20,18,65,0,83,258,34,375
3134911,3,3,6,45,19,3,67,178,16,261
3134912,40,7,47,61,28,0,89,224,18,331
3134913,0,0,0,18,3,0,21,120,11,152
3134914,6,3,9,71,34,6,111,259,52,422
3134915,0,3,3,30,3,3,36,155,16,207
3134916,4,0,4,56,20,3,79,215,27,321
3134917,4,3,7,83,30,7,120,240,34,394
3134918,6,3,9,48,21,3,72,198,38,308
3134919,0,0,0,3,0,0,3,21,3,27
3135001,0,0,0,11,4,0,15,31,6,52
3135002,0,0,0,74,21,0,95,233,40,368
3135003,0,0,0,69,23,7,99,234,39,372
3135004,5,0,5,39,7,0,46,188,23,257
3135005,0,0,0,169,56,9,234,412,44,690
3135006,0,6,6,44,34,0,78,175,31,284
3135007,0,0,0,72,23,6,101,179,41,321
3135008,4,0,4,33,12,0,45,137,13,195
3135009,3,0,3,120,45,15,180,359,52,591
3135010,3,0,3,40,12,0,52,129,15,196
3135101,0,3,3,63,29,6,98,190,28,316
3135102,0,0,0,41,14,3,58,149,10,217
3135103,0,0,0,49,12,0,61,103,18,182
3135104,6,6,12,50,11,6,67,184,23,274
3135105,6,0,6,53,13,7,73,138,10,221
3135106,3,0,3,99,32,0,131,213,31,375
3135107,0,0,0,138,31,3,172,309,25,506
3135108,0,0,0,112,19,0,131,236,46,413
3135109,0,0,0,96,25,3,124,258,42,424
3135110,3,0,3,120,35,4,159,267,39,465
3135111,0,0,0,286,51,17,354,456,79,889
3135112,4,0,4,96,22,6,124,142,21,287
3135113,4,0,4,22,21,0,43,135,23,201
3135114,0,0,0,113,21,6,140,205,20,365
3135115,27,3,30,31,13,0,44,158,18,220
3135201,0,0,0,36,17,3,56,122,21,199
3135202,0,0,0,0,0,0,0,0,0,0
3135203,0,0,0,52,14,0,66,83,11,160
3135204,8,4,12,139,45,6,190,369,45,604
3135205,4,0,4,59,20,10,89,170,34,293
3135206,3,0,3,33,20,0,53,122,19,194
3135207,42,6,48,62,20,0,82,295,57,434
3135208,5,0,5,32,15,3,50,146,27,223
3135209,4,0,4,32,7,0,39,133,31,203
3135210,3,0,3,77,35,3,115,208,26,349
3135211,3,0,3,98,29,9,136,273,59,468
3135212,7,4,11,363,150,36,549,992,146,1687
3135213,3,0,3,38,9,3,50,146,33,229
3135214,0,0,0,51,13,0,64,114,17,195
3135215,0,0,0,30,6,5,41,95,6,142
3135216,0,0,0,44,15,3,62,184,28,274
3135217,0,0,0,114,17,9,140,261,48,449
3135218,3,0,3,26,6,0,32,96,21,149
3135219,0,0,0,55,29,0,84,168,26,278
3135220,0,0,0,100,41,7,148,359,60,567
3135221,3,3,6,81,28,6,115,233,30,378
3135222,0,3,3,101,31,6,138,279,47,464
3135223,0,0,0,58,21,0,79,135,23,237
3135224,0,0,0,45,18,3,66,206,28,300
3135225,0,0,0,0,0,0,0,0,0,0
3135226,0,3,3,132,50,3,185,394,65,644
3135301,3,0,3,15,3,0,18,83,0,101
3135302,0,0,0,35,13,0,48,147,24,219
3135303,0,0,0,20,18,3,41,80,6,127
3135304,0,0,0,0,0,0,0,0,0,0
3135305,0,0,0,3,3,0,6,85,16,107
3135306,0,0,0,29,15,0,44,128,33,205
3135307,3,0,3,71,12,0,83,233,37,353
3135308,3,0,3,18,9,0,27,64,6,97
3135309,0,0,0,37,20,3,60,140,32,232
3135310,3,0,3,72,20,0,92,228,35,355
3135311,3,0,3,82,25,3,110,206,35,351
3135312,0,0,0,27,18,0,45,150,27,222
3135313,0,0,0,95,31,6,132,220,10,362
3135314,0,0,0,78,23,0,101,150,19,270
3135315,3,0,3,37,12,6,55,160,22,237
3135316,0,0,0,50,14,3,67,147,33,247
3135317,0,0,0,49,18,6,73,135,15,223
3135318,0,0,0,78,12,0,90,236,36,362
3135319,4,0,4,37,11,0,48,139,18,205
3135320,4,0,4,38,17,0,55,190,41,286
3135321,3,3,6,39,7,3,49,115,27,191
3135322,0,0,0,73,17,3,93,146,29,268
3135323,4,0,4,106,34,9,149,192,29,370
3135324,3,0,3,59,19,0,78,138,22,238
3135325,0,0,0,66,21,3,90,211,30,331
3135326,0,0,0,79,25,0,104,180,23,307
3135327,3,5,8,49,16,3,68,156,12,236
3135328,0,0,0,41,12,0,53,130,13,196
3135401,0,0,0,115,23,4,142,211,21,374
3135402,0,0,0,132,29,0,161,222,54,437
3135403,0,0,0,56,21,3,80,113,24,217
3135404,4,0,4,74,18,8,100,231,8,339
3135405,0,0,0,152,43,6,201,252,44,497
3135406,0,0,0,84,18,7,109,149,21,279
3135407,3,0,3,194,36,9,239,270,29,538
3135408,0,0,0,33,13,4,50,91,19,160
3135409,0,0,0,26,0,0,26,32,15,73
3135410,6,0,6,68,17,8,93,187,18,298
3135411,3,0,3,72,44,6,122,174,25,321
3135412,0,0,0,53,18,0,71,160,14,245
3135413,3,0,3,42,21,4,67,176,19,262
3135501,0,0,0,23,18,3,44,104,16,164
3135502,0,5,5,69,33,0,102,167,30,299
3135503,5,0,5,37,3,0,40,157,22,219
3135504,3,0,3,50,16,9,75,129,36,240
3135505,0,0,0,79,15,0,94,221,47,362
3135506,3,0,3,74,18,0,92,237,36,365
3135507,0,0,0,105,28,5,138,173,33,344
3135508,3,0,3,42,16,0,58,99,17,174
3135509,0,3,3,55,21,3,79,181,32,292
3135510,0,0,0,79,29,3,111,215,30,356
3135511,3,0,6,43,27,0,70,103,17,190
3135512,0,0,0,0,0,0,0,3,0,3
3135513,0,0,0,0,0,0,0,0,0,0
3135601,3,0,3,68,21,3,92,212,32,336
3135602,9,3,12,42,23,0,65,195,28,288
3135603,0,0,0,44,21,6,71,148,26,245
3135604,3,0,3,80,27,6,113,233,21,367
3135605,3,0,3,79,32,6,117,173,31,321
3135606,7,0,7,107,39,9,155,319,33,507
3135607,10,3,13,80,29,3,112,384,41,537
3135608,6,0,6,59,33,3,95,260,72,427
3135609,3,0,3,63,28,6,97,224,38,359
3135610,6,3,12,66,25,7,98,266,50,414
3135611,3,0,3,45,31,6,82,192,26,300
3135612,10,0,10,63,14,7,84,171,18,273
3135613,0,5,5,40,25,3,68,172,31,271
3135614,0,0,0,0,0,0,0,0,0,0
3135615,3,3,6,49,16,0,65,194,22,281
3135616,3,3,6,55,31,6,92,207,29,328
3135617,0,0,0,65,23,3,91,167,24,282
3135618,0,0,0,56,31,0,87,210,38,335
3135619,0,0,0,32,18,0,50,128,21,199
3135701,0,0,0,18,12,6,36,71,3,110
3135702,6,0,6,69,18,6,93,156,10,259
3135703,0,0,0,46,17,4,67,138,20,225
3135704,0,0,0,71,29,3,103,206,20,329
3135705,0,0,0,52,30,3,85,192,26,303
3135706,0,0,0,72,16,3,91,158,29,278
3135707,0,0,0,79,27,6,112,206,27,345
3135708,3,3,6,45,20,0,65,138,15,218
3135709,0,0,0,81,32,3,116,231,21,368
3135710,0,0,0,49,10,0,59,107,18,184
3135711,3,0,3,57,37,6,100,201,21,322
3135712,0,0,0,100,22,9,131,198,28,357
3135713,3,0,3,29,19,0,48,104,16,168
3135714,0,0,0,60,20,0,80,136,16,232
3135715,0,3,3,51,17,0,68,127,15,210
3135716,6,0,6,69,32,6,107,153,15,275
3135717,3,3,6,61,17,10,88,180,19,287
3135718,0,0,0,41,9,4,54,124,21,199
3135719,0,0,0,75,21,0,96,111,22,229
3135720,0,0,0,120,23,9,152,222,29,403
3135721,0,0,0,66,21,4,91,154,24,269
3135722,0,0,0,85,32,6,123,214,30,367
3135723,0,0,0,189,42,7,238,323,45,606
3135801,6,3,9,70,16,0,86,226,22,334
3135802,6,0,6,68,27,6,101,242,28,371
3135803,5,0,5,52,4,5,61,121,14,196
3135804,54,5,59,60,24,3,87,306,36,429
3135805,15,3,18,69,27,0,96,304,42,442
3135806,0,0,0,69,26,3,98,161,20,279
3135807,0,0,0,0,4,0,4,10,0,14
3135808,5,0,5,75,22,4,101,210,22,333
3135809,0,0,0,32,18,3,53,147,19,219
3135810,6,0,6,94,39,0,133,239,14,386
3135811,71,3,78,47,22,0,69,318,28,415
3135812,6,0,6,92,27,0,119,309,38,466
3135813,3,5,8,38,15,0,53,150,21,224
3135814,6,3,9,43,12,9,64,148,24,236
3135815,6,0,6,31,6,3,40,147,26,213
3135816,10,0,10,89,37,0,126,236,15,377
3135817,6,3,9,62,45,0,107,194,36,337
3135901,3,0,3,23,18,0,41,142,43,226
3135902,0,0,0,12,3,0,15,147,50,212
3135903,0,0,0,24,13,3,40,208,53,301
3135904,0,0,0,45,18,3,66,140,31,237
3135905,3,0,3,100,36,6,142,613,342,1097
3135906,0,0,0,16,0,0,16,203,75,294
3135907,0,0,0,94,16,6,116,231,22,369
3135908,0,0,0,56,9,0,65,125,40,230
3135909,0,4,4,71,24,7,102,191,66,359
3135910,0,0,0,70,26,3,99,354,78,531
3135911,0,0,0,79,18,6,103,199,37,339
3135912,0,0,0,67,6,0,73,146,29,248
3135913,0,3,3,62,15,7,84,143,30,257
3135914,0,0,0,79,10,6,95,222,45,362
3135915,0,0,0,12,10,0,22,68,30,120
3135916,0,0,0,10,0,0,10,64,6,80
3135917,0,0,0,0,0,0,0,0,0,0
3135918,7,0,7,3,6,0,9,73,9,91
3135919,0,0,0,15,12,3,30,101,16,147
3135920,0,0,0,46,24,7,77,154,36,267
3135921,0,0,0,56,30,3,89,282,35,406
3135922,0,0,0,94,16,9,119,257,44,420
3135923,0,0,0,40,17,0,57,132,17,206
3135924,0,0,0,20,6,0,26,103,22,151
3135925,0,0,0,53,21,3,77,214,54,345
3135926,0,0,0,16,6,0,22,211,73,306
3135927,3,0,3,74,6,0,80,187,33,300
3135928,0,0,0,133,24,18,175,337,55,567
3135929,0,0,0,96,7,4,107,189,40,336
3136001,0,0,0,0,0,0,0,0,0,0
3136101,3,0,3,100,26,8,134,200,36,370
3136102,3,0,3,121,21,4,146,241,35,422
3136103,3,0,3,74,16,9,99,191,9,299
3136104,3,0,3,56,20,3,79,171,3,253
3136105,0,0,0,86,32,0,118,266,13,397
3136106,0,0,0,71,22,9,102,242,18,362
3136107,3,0,3,38,15,3,56,205,14,275
3136108,0,0,0,46,13,0,59,99,20,178
3136109,3,4,7,68,39,9,116,161,39,316
3136110,39,3,42,71,24,3,98,262,34,394
3136111,0,0,0,19,6,0,25,52,0,77
3136112,3,0,3,54,24,0,78,162,18,258
3136113,0,3,3,43,25,3,71,263,42,376
3136114,6,3,9,90,30,3,123,189,43,355
3136115,3,0,3,24,21,0,45,131,22,198
3136116,4,0,4,67,21,4,92,186,37,315
3136117,11,0,15,39,16,0,55,158,31,244
3136118,6,3,9,64,25,3,92,163,19,274
3136119,0,0,0,60,24,0,84,177,20,281
3136120,0,0,0,46,19,3,68,188,18,274
3136121,0,0,0,0,0,0,0,0,0,0
3136122,0,0,0,50,23,0,73,116,16,205
3136123,0,0,0,36,12,0,48,123,7,178
3136201,0,4,4,68,31,6,105,234,22,361
3136202,0,0,0,72,7,0,79,104,16,199
3136203,3,3,6,159,41,24,224,335,92,651
3136204,0,0,0,0,0,0,0,9,0,9
3136205,9,7,16,23,21,0,44,307,43,394
3136206,3,0,3,175,71,12,258,438,32,728
3136207,4,0,4,30,27,0,57,129,19,205
3136208,6,3,9,40,30,6,76,298,34,408
3136209,3,3,6,51,22,3,76,190,37,303
3136210,7,7,14,32,18,0,50,183,36,269
3136211,6,0,6,45,23,9,77,187,16,280
3136212,6,0,6,38,13,0,51,156,12,219
3136213,6,0,6,64,16,0,80,161,13,254
3136214,3,7,10,114,21,3,138,289,22,449
3136215,11,0,11,45,27,9,81,227,24,332
3136216,3,0,3,80,31,4,115,167,22,304
3136217,13,3,16,75,34,9,118,312,35,465
3136218,4,0,4,35,24,3,62,181,15,258
3136219,6,0,6,121,22,12,155,319,35,509
3136220,3,0,3,58,15,0,73,257,15,345
3136221,8,3,11,26,35,3,64,218,24,306
3136222,0,3,3,21,16,0,37,146,13,196
3136223,6,0,6,83,14,0,97,191,12,300
3136224,7,0,7,43,27,3,73,340,20,433
3136225,0,3,3,27,25,0,52,163,15,230
3136226,6,0,6,54,47,9,110,311,19,440
3136227,6,0,6,53,23,6,82,278,29,389
3136228,0,0,0,43,33,4,80,235,25,340
3136229,0,0,5,78,28,6,112,217,30,359
3136230,3,0,3,69,22,4,95,244,57,396
3136231,3,3,6,51,13,0,64,227,42,333
3136232,9,6,15,33,16,0,49,186,70,305
3136301,5,6,11,56,42,3,101,246,35,382
3136302,13,0,13,60,41,3,104,358,14,476
3136303,6,4,10,45,33,4,82,274,29,385
3136304,6,3,9,38,18,4,60,246,38,344
3136305,5,0,5,49,27,0,76,205,33,314
3136306,22,3,25,51,26,0,77,322,37,436
3136307,10,3,13,9,17,3,29,147,15,191
3136308,5,0,5,31,12,0,43,182,46,271
3136309,17,4,21,44,22,0,66,259,27,352
3136310,3,0,3,29,11,6,46,192,48,286
3136311,3,0,3,31,14,0,45,235,40,320
3136312,0,0,0,41,34,0,75,241,23,339
3136313,9,0,9,29,17,0,46,122,9,177
3136314,9,0,9,66,36,6,108,343,31,482
3136315,11,6,17,83,38,0,121,289,42,452
3136316,7,3,10,32,30,3,65,241,63,369
3136317,11,0,11,50,20,5,75,317,38,430
3136318,26,0,26,18,15,0,33,273,37,343
3136319,3,0,3,139,50,7,196,436,36,668
3136320,0,0,0,0,0,0,0,0,3,3
3136321,0,0,0,0,0,0,0,0,0,0
3136322,0,0,0,19,7,0,26,92,4,122
3136323,25,11,36,40,37,0,77,291,49,417
3136324,80,3,83,25,21,0,46,465,48,559
3136325,9,0,9,32,10,4,46,181,14,241
3136326,12,0,12,45,22,6,73,281,18,372
3136327,3,0,3,22,32,9,63,138,15,216
3136328,0,0,0,29,15,0,44,175,15,234
3136329,16,8,24,67,38,3,108,345,49,502
3136330,0,0,0,0,0,0,0,0,0,0
3136331,118,6,124,16,14,0,30,509,51,590
3136332,19,3,22,48,28,4,80,350,41,471
3136333,11,0,11,47,23,0,70,209,38,317
3136334,8,10,18,23,18,0,41,173,35,249
3136335,13,8,21,51,30,0,81,297,34,412
3136336,18,5,23,57,42,3,102,402,69,573
3136337,3,4,7,12,22,3,37,151,13,201
3136338,6,0,6,30,33,4,67,292,11,370
3136339,4,0,4,44,9,3,56,169,18,243
3136340,0,0,0,87,24,0,111,254,12,377
3136341,6,3,9,48,39,3,90,254,40,384
3136342,8,0,8,16,17,0,33,209,24,266
3136343,6,0,6,26,12,0,38,236,19,293
3136344,0,0,0,9,13,0,22,73,0,95
3136345,31,13,44,0,21,0,21,344,52,417
3136401,0,0,0,30,10,3,43,107,39,189
3136402,0,0,0,86,35,0,121,170,29,320
3136403,0,0,0,78,36,6,120,183,29,332
3136404,3,0,3,75,20,0,95,156,45,296
3136405,3,0,3,49,29,3,81,186,7,274
3136406,3,0,3,85,49,3,137,236,35,408
3136407,3,0,3,75,30,4,109,125,15,249
3136408,0,0,0,108,21,0,129,184,17,330
3136409,3,0,3,64,21,0,85,155,35,275
3136410,3,0,3,37,12,0,49,108,21,178
3136501,6,0,6,66,36,0,102,231,24,357
3136502,40,117,157,17,7,0,24,157,195,376
3136503,0,0,0,53,12,3,68,154,33,255
3136504,0,0,0,83,37,6,126,200,41,367
3136505,0,0,0,89,21,4,114,166,39,319
3136506,4,0,4,43,12,0,55,147,15,217
3136507,5,0,5,108,28,0,136,285,55,476
3136508,0,0,0,98,52,4,154,262,38,454
3136509,0,0,0,75,7,0,82,137,14,233
3136510,3,0,3,104,36,13,153,275,25,453
3136511,20,10,30,27,19,0,46,202,51,299
3136512,3,3,6,12,10,4,26,70,25,121
3136513,73,17,90,51,42,3,96,424,43,563
3136514,0,0,0,40,21,5,66,145,17,228
3136515,5,0,5,70,28,6,104,229,24,357
3136516,0,0,0,197,35,17,249,292,67,608
3136517,0,0,0,126,43,4,173,228,31,432
3136518,0,0,0,81,25,12,118,155,27,300
3136519,3,0,3,72,12,12,96,117,16,229
3136520,50,3,53,73,22,6,101,307,31,439
3136521,3,0,3,63,24,0,87,294,14,395
3136522,3,0,3,33,16,7,56,125,15,196
3136523,0,0,0,50,15,6,71,168,9,248
3136524,3,0,3,110,45,4,159,312,35,506
3136525,7,3,10,78,31,5,114,300,43,457
3136526,0,0,0,10,9,0,19,95,7,121
3136527,0,0,0,107,39,0,146,231,15,392
3136528,40,11,51,28,13,9,50,286,70,406
3136529,0,0,0,35,19,10,64,114,39,217
3136530,3,3,6,113,20,17,150,191,39,380
3136531,0,0,0,108,27,10,145,236,55,436
3136532,7,0,7,62,22,3,87,334,70,491
3136533,6,0,6,67,37,3,107,282,99,488
3136534,3,0,3,175,35,18,228,341,84,653
3136535,0,0,0,134,43,9,186,233,34,453
3136536,0,3,3,46,8,0,54,92,27,173
3136537,6,0,6,105,36,12,153,288,75,516
3136538,0,0,0,59,19,11,89,121,41,251
3136539,8,0,8,86,39,0,125,221,27,373
3136540,3,0,3,87,40,0,127,212,24,363
3136541,9,0,9,75,26,6,107,220,24,351
3136542,5,0,5,51,31,0,82,218,11,311
3136543,0,55,55,38,15,3,56,148,187,391
3136544,4,0,4,50,13,4,67,153,24,244
3136545,7,3,10,86,26,9,121,326,78,525
3136546,3,3,6,46,21,3,70,171,44,285
3136547,4,0,4,34,0,0,34,75,12,121
3136548,0,0,4,83,31,6,120,231,29,380
3136601,0,0,0,120,26,16,162,204,19,385
3136602,3,4,7,50,19,3,72,126,13,211
3136603,0,0,0,92,13,9,114,145,30,289
3136604,0,0,0,54,15,3,72,146,32,250
3136605,18,6,24,28,9,3,40,177,27,244
3136606,0,3,3,33,18,3,54,113,15,182
3136607,3,0,3,130,39,15,184,206,36,426
3136608,9,0,9,96,35,3,134,279,27,440
3136609,4,0,4,99,24,7,130,200,53,383
3136610,45,12,57,60,18,3,81,214,41,336
3136611,10,4,14,69,23,0,92,247,26,365
3136612,0,0,0,0,0,0,0,0,0,0
3136613,11,0,11,88,31,3,122,262,31,415
3136614,6,0,6,130,48,0,178,227,29,434
3136615,0,0,0,130,28,7,165,244,41,450
3136616,3,0,3,94,28,3,125,191,37,353
3136617,0,0,0,159,32,18,209,252,24,485
3136618,3,0,3,43,29,9,81,199,21,301
3136619,0,0,0,58,10,6,74,108,22,204
3136620,0,3,3,87,24,9,120,203,30,353
3136621,3,0,3,88,37,9,134,250,36,420
3136622,4,0,4,115,33,7,155,246,27,428
3136623,0,0,0,277,56,11,344,464,102,910
3136624,8,0,8,61,25,9,95,216,33,344
3136625,0,0,0,69,21,6,96,177,43,316
3136626,6,0,6,43,21,0,64,208,23,295
3136627,6,0,6,97,35,7,139,225,40,404
3136628,0,0,0,63,20,3,86,157,32,275
3136629,4,0,4,39,14,3,56,116,34,206
3136630,4,4,8,47,38,4,89,180,33,302
3136631,3,0,3,150,35,9,194,217,73,484
3136632,3,0,3,245,53,7,305,415,62,782
3136633,11,0,11,202,45,9,256,472,40,768
3136634,3,0,3,59,27,6,92,184,16,292
3136635,0,0,0,40,24,9,73,201,29,303
3136636,0,0,0,69,24,6,99,193,28,320
3136637,0,0,0,97,32,10,139,217,23,379
3136701,6,0,6,101,21,6,128,200,30,358
3136702,0,0,0,73,27,12,112,182,30,324
3136703,0,0,0,91,11,0,102,167,19,288
3136704,0,3,3,52,17,0,69,147,13,229
3136705,3,0,3,55,21,0,76,201,39,316
3136706,0,0,0,47,18,6,71,142,18,231
3136707,3,0,3,40,12,7,59,98,12,169
3136708,0,0,0,71,27,0,98,180,32,310
3136709,0,0,0,95,35,3,133,184,12,329
3136710,4,0,4,68,33,6,107,182,8,297
3136801,0,0,0,26,12,6,44,97,19,160
3136802,0,0,0,77,38,0,115,235,23,373
3136803,3,0,3,47,23,3,73,178,31,282
3136804,0,0,0,83,21,5,109,240,36,385
3136805,0,0,0,43,15,0,58,103,15,176
3136806,0,4,4,73,34,10,117,173,31,321
3136807,7,0,7,60,27,0,87,211,11,309
3136808,3,0,6,158,41,8,207,233,23,463
3136809,0,0,0,82,43,9,134,297,28,459
3136810,3,0,3,74,15,9,98,189,24,311
3136811,0,0,0,128,45,7,180,318,33,531
3136812,0,0,0,134,19,9,162,167,52,381
3136813,6,0,6,191,39,13,243,447,63,753
3136814,3,0,3,116,29,4,149,236,27,412
3136901,3,0,3,40,15,3,58,106,12,176
3136902,3,0,3,32,20,0,52,141,5,198
3136903,6,0,6,37,31,6,74,149,9,232
3136904,0,0,0,73,28,0,101,237,6,344
3136905,3,0,3,87,25,4,116,208,18,342
3136906,3,0,3,68,35,3,106,294,24,424
3136907,4,0,4,177,58,7,242,369,20,631
3136908,0,0,0,80,31,3,114,365,44,523
3137001,29,5,34,59,20,0,79,226,40,345
3137002,4,0,4,49,19,0,68,163,31,262
3137003,0,3,3,39,18,0,57,160,36,253
3137004,0,0,0,50,20,6,76,178,13,267
3137005,6,0,6,69,32,0,101,236,28,365
3137006,0,0,0,101,24,0,125,277,35,437
3137007,3,0,3,41,18,0,59,147,16,222
3137008,0,0,0,46,9,0,55,121,20,196
3137009,3,0,3,98,29,7,134,247,24,405
3137010,8,0,8,24,14,9,47,196,12,255
3137011,3,0,3,59,35,0,94,222,32,348
3137012,4,0,4,69,24,4,97,133,21,251
3137013,3,6,9,35,16,0,51,165,30,246
3137101,4,0,4,49,19,3,71,213,24,308
3137102,0,0,0,0,0,0,0,0,552,552
3137103,0,3,3,36,18,3,57,170,12,239
3137104,9,0,9,84,39,6,129,261,23,413
3137105,9,4,13,80,29,12,121,296,31,448
3137106,7,3,10,67,24,9,100,227,18,345
3137107,3,3,6,154,42,13,209,338,79,626
3137108,0,0,0,145,33,9,187,310,36,533
3137109,0,0,0,9,3,0,12,38,6,56
3137110,0,0,0,29,15,3,47,76,15,138
3137111,4,0,4,84,28,12,124,227,19,370
3137112,3,0,3,18,6,0,24,93,16,133
3137113,4,0,4,89,23,9,121,268,37,426
3137114,3,0,3,23,7,3,33,72,15,120
3137115,0,0,0,46,24,3,73,157,18,248
3137116,0,0,0,38,28,6,72,174,20,266
3137201,4,0,4,26,20,9,55,99,12,166
3137202,8,0,8,93,25,12,130,250,36,416
3137203,3,0,3,75,19,0,94,116,14,224
3137204,0,0,0,93,21,6,120,172,8,300
3137205,0,0,0,0,0,0,0,0,0,0
3137206,3,0,3,48,17,0,65,144,0,209
3137207,0,0,0,49,18,0,67,131,11,209
3137208,0,0,0,49,7,0,56,118,13,187
3137209,3,3,6,50,12,0,62,117,9,188
3137210,39,7,46,124,47,13,184,337,54,575
3137211,0,0,0,56,37,0,93,151,6,250
3137212,15,0,15,28,21,0,49,276,32,357
3137213,0,0,0,28,23,0,51,141,19,211
3137214,0,0,0,30,14,9,53,106,6,165
3137215,3,0,3,107,38,4,149,207,15,371
3137216,3,4,7,65,32,0,97,164,4,265
3137217,3,0,6,58,36,0,94,201,21,316
3137218,0,0,0,36,24,0,60,156,9,225
3137219,0,3,6,104,28,9,141,206,33,380
3137220,4,0,4,66,26,6,98,142,15,255
3137221,3,0,3,90,30,3,123,188,22,333
3137222,0,0,0,44,9,3,56,105,3,164
3137223,6,0,6,94,11,0,105,184,19,308
3137224,0,0,0,65,21,0,86,182,11,279
3137225,0,0,0,92,20,4,116,178,22,316
3137226,0,0,0,105,25,3,133,229,37,399
3137227,4,0,4,68,28,6,102,181,21,304
3137228,6,3,9,86,40,5,131,223,15,369
3137229,0,3,3,84,35,6,125,293,32,450
3137230,0,0,0,90,24,5,119,230,30,379
3137231,3,3,6,38,12,3,53,131,15,199
3137232,0,0,0,121,48,10,179,334,30,543
3137233,3,0,3,60,14,7,81,114,0,195
3137234,0,0,0,73,26,6,105,227,14,346
3137235,0,0,0,80,20,4,104,167,3,274
3137301,0,0,0,84,37,9,130,230,40,400
3137302,4,0,4,57,19,3,79,159,27,265
3137303,6,42,48,47,6,6,59,116,83,258
3137304,0,0,0,101,34,9,144,233,38,415
3137305,3,0,3,113,44,6,163,279,54,496
3137306,0,3,3,63,22,0,85,236,24,345
3137307,0,0,0,63,21,0,84,155,19,258
3137308,3,3,6,35,6,3,44,138,18,200
3137309,0,4,4,88,27,8,123,149,18,290
3137310,0,0,0,50,19,4,73,103,13,189
3137311,0,0,0,62,28,0,90,193,24,307
3137312,3,0,3,145,38,13,196,336,85,617
3137313,0,0,0,0,0,0,0,0,0,0
3137314,37,8,45,6,42,0,48,459,75,582
3137315,3,0,3,40,17,0,57,108,18,183
3137316,0,0,0,75,6,0,81,103,24,208
3137317,0,0,0,38,16,3,57,78,21,156
3137318,0,0,0,116,53,7,176,222,38,436
3137319,0,0,0,83,28,0,111,213,18,342
3137320,3,0,3,112,39,7,158,230,50,438
3137321,0,0,0,59,18,6,83,108,26,217
3137322,0,0,0,94,22,9,125,190,46,361
3137323,0,0,0,118,28,9,155,201,12,368
3137324,0,0,0,74,23,8,105,128,9,242
3137325,3,0,3,50,22,0,72,139,15,226
3137326,3,0,3,48,18,0,66,134,25,225
3137327,0,0,0,0,0,0,0,0,0,0
3137328,12,5,17,0,19,0,19,266,35,320
3137329,0,0,0,9,9,4,22,50,0,72
3137330,6,3,9,70,30,0,100,210,18,328
3137331,0,3,3,52,33,0,85,173,10,268
3137332,3,3,10,118,34,6,158,216,26,400
3137333,0,0,0,140,45,9,194,233,34,461
3137334,0,0,0,44,23,3,70,182,20,272
3137335,0,0,0,57,27,3,87,160,18,265
3137336,0,0,0,31,10,0,41,80,10,131
3137337,0,0,0,0,0,0,0,0,0,0
3137338,3,5,8,37,7,6,50,147,15,212
3137339,0,0,0,74,21,3,98,222,39,359
3137340,0,0,0,48,24,0,72,169,18,259
3137341,0,0,0,41,35,0,76,198,27,301
3137342,0,0,0,86,46,12,144,169,33,346
3137343,6,0,6,51,27,4,82,184,25,291
3137344,3,0,3,45,22,9,76,165,13,254
3137345,0,0,0,49,8,5,62,134,22,218
3137346,0,0,0,34,11,6,51,120,27,198
3137347,64,7,71,84,41,6,131,414,79,624
3137348,30,10,40,3,10,0,13,363,48,424
3137349,0,3,3,72,25,3,100,222,42,364
3137350,3,0,3,104,38,12,154,248,42,444
3137351,8,3,11,75,24,11,110,301,57,468
3137352,6,0,6,48,11,0,59,142,52,253
3137353,4,0,4,61,30,0,91,175,66,332
3137354,5,0,5,58,40,4,102,158,21,281
3137355,0,0,0,63,23,7,93,171,18,282
3137356,3,0,3,48,31,0,79,167,16,262
3137401,0,0,0,54,21,3,78,105,15,198
3137402,0,0,0,36,31,3,70,158,5,233
3137403,6,0,6,101,28,6,135,169,19,323
3137404,3,0,3,75,20,4,99,166,20,285
3137405,0,0,0,53,23,0,76,111,10,197
3137406,0,0,0,41,22,0,63,168,15,246
3137407,7,0,7,54,38,0,92,237,23,352
3137408,3,0,3,62,30,6,98,141,14,253
3137409,0,0,0,48,30,3,81,165,17,263
3137410,0,0,0,52,16,0,68,159,6,233
3137411,0,0,0,72,20,0,92,213,23,328
3137412,0,0,0,65,23,4,92,154,17,263
3137413,0,0,0,42,22,9,73,194,15,282
3137414,0,0,0,58,14,6,78,139,9,226
3137415,0,0,0,30,6,6,42,114,4,160
3137501,0,0,0,95,10,8,113,137,22,272
3137502,0,0,0,154,30,10,194,238,24,456
3137503,0,0,0,99,26,0,125,162,23,310
3137504,0,0,0,84,15,11,110,104,3,217
3137505,0,0,0,89,38,5,132,152,21,305
3137506,0,0,0,39,6,3,48,116,3,167
3137507,0,0,0,74,12,0,86,151,6,243
3137508,4,0,4,298,81,14,393,468,56,917
3137509,0,0,0,59,42,4,105,248,25,378
3137510,0,0,0,83,34,0,117,219,26,362
3137511,4,0,4,48,28,4,80,172,15,267
3137512,3,0,3,247,43,9,299,311,15,625
3137513,0,0,0,196,28,15,239,220,9,468
3137514,0,0,0,87,50,0,137,223,5,365
3137515,0,0,0,106,40,6,152,283,24,459
3137516,3,0,3,49,33,8,90,179,6,275
3137517,3,0,3,98,36,3,137,190,13,340
3137518,0,0,0,86,22,0,108,153,11,272
3137519,0,0,0,83,24,6,113,164,19,296
3137520,3,0,3,79,31,5,115,147,7,269
3137521,3,0,3,83,20,8,111,110,12,233
3137522,3,0,3,112,41,9,162,226,6,394
3137523,6,0,6,133,39,7,179,255,24,458
3137524,0,0,3,106,22,6,134,145,3,282
3137525,0,0,0,207,32,12,251,225,18,494
3137526,0,0,0,95,28,8,131,165,9,305
3137527,0,0,0,63,22,7,92,139,0,231
3137528,3,0,3,143,18,3,164,173,28,365
3137529,0,0,0,156,47,6,209,191,27,427
3137530,3,0,3,112,21,6,139,242,9,390
3137531,3,3,6,44,21,0,65,142,25,232
3137532,0,0,0,0,4,0,4,0,0,4
3137533,4,0,4,76,16,10,102,97,4,203
3137534,3,0,3,78,5,4,87,109,7,203
3137535,0,0,0,68,13,0,81,70,12,163
3137601,0,0,0,0,0,0,0,0,0,0
3137602,0,0,0,80,31,3,114,168,7,289
3137603,0,0,0,41,14,3,58,143,7,208
3137604,0,0,0,51,35,3,89,174,24,287
3137605,0,3,3,46,17,3,66,151,26,243
3137606,3,0,3,77,34,3,114,221,18,353
3137607,3,0,3,53,18,4,75,126,3,204
3137608,3,0,3,61,35,0,96,161,5,262
3137609,3,0,3,86,26,6,118,198,29,345
3137701,0,0,0,0,0,0,0,0,3,3
3137702,0,0,0,6,3,0,9,15,4,28
3137703,0,0,0,0,0,0,0,0,0,0
3137704,8,0,8,24,16,4,44,171,28,243
3137705,10,3,13,76,15,0,91,218,27,336
3137706,0,0,0,71,21,3,95,168,10,273
3137707,3,4,7,47,32,0,79,270,38,387
3137708,3,3,6,91,36,0,127,281,33,441
3137709,10,0,10,53,28,3,84,220,14,318
3137710,3,3,6,45,18,0,63,234,23,320
3137711,51,13,64,28,29,0,57,204,18,279
3137712,3,0,6,61,21,0,82,237,29,348
3137713,10,0,10,71,42,8,121,221,40,382
3137714,11,3,14,86,39,9,134,409,38,581
3137715,6,0,6,70,28,3,101,217,12,330
3137716,38,4,42,28,11,6,45,199,7,251
3137717,10,0,10,75,33,8,116,272,20,408
3137718,5,0,5,44,27,3,74,124,15,213
3137719,19,0,19,81,29,6,116,328,24,468
3137720,4,0,4,88,27,9,124,249,21,394
3137721,5,0,5,71,34,6,111,231,18,360
3137722,0,0,0,35,10,9,54,94,13,161
3137801,3,0,3,47,14,0,61,245,15,321
3137802,6,0,6,37,22,6,65,139,25,229
3137803,3,5,8,56,28,0,84,284,37,405
3137804,0,3,3,60,22,0,82,247,39,368
3137805,5,0,5,54,15,6,75,171,23,269
3137806,12,0,12,77,30,0,107,303,20,430
3137807,3,3,6,56,16,3,75,128,12,215
3137808,8,0,8,36,27,0,63,187,18,268
3137809,7,0,7,56,44,0,100,253,26,379
3137810,6,3,9,33,20,0,53,128,15,196
3137811,10,0,10,36,21,0,57,185,24,266
3137812,11,3,17,66,27,0,93,238,31,362
3137813,10,0,10,86,32,9,127,271,33,431
3137814,6,8,14,70,26,0,96,190,33,319
3137815,12,0,12,70,25,8,103,258,32,393
3137816,10,0,10,44,21,0,65,202,47,314
3137817,7,3,10,64,32,9,105,242,25,372
3137818,0,0,0,28,15,6,49,112,38,199
3137819,13,0,13,88,32,6,126,272,31,429
3137820,7,0,7,63,19,4,86,255,25,366
3137821,26,3,29,59,28,6,93,270,39,402
3137822,8,6,14,54,17,7,78,303,49,430
3137823,4,3,7,53,22,3,78,172,27,277
3137824,3,0,3,51,18,0,69,201,21,291
3137825,7,0,7,37,23,3,63,144,19,226
3137826,6,0,6,91,36,0,127,301,44,472
3137827,4,0,4,52,14,3,69,142,18,229
3137828,0,6,6,46,18,6,70,288,42,400
3137901,19,3,22,26,22,0,48,232,15,295
3137902,3,3,6,60,27,3,90,234,21,345
3137903,0,3,3,60,15,0,75,146,15,236
3137904,0,0,0,82,15,0,97,188,15,300
3137905,3,3,6,58,17,6,81,236,26,343
3137906,0,0,0,53,22,3,78,157,28,263
3137907,6,0,6,51,18,7,76,215,38,329
3137908,0,0,0,45,13,7,65,138,21,224
3137909,6,3,9,61,12,0,73,198,21,292
3137910,9,5,14,54,41,0,95,448,112,655
3137911,5,3,8,40,33,6,79,219,77,375
3137912,6,4,10,54,24,0,78,209,58,345
3137913,11,10,21,59,31,3,93,305,50,448
3137914,11,11,22,54,33,0,87,350,40,477
3137915,6,5,11,62,22,0,84,242,26,352
3137916,8,0,8,57,23,0,80,250,22,352
3137917,0,0,0,44,27,3,74,156,31,261
3137918,9,0,9,53,42,0,95,305,41,441
3137919,0,0,0,0,0,0,0,0,6,6
3137920,10,3,13,90,48,3,141,285,21,447
3137921,7,0,7,23,13,0,36,112,15,163
3137922,5,3,8,21,9,0,30,108,42,180
3137923,3,0,3,76,29,7,112,189,10,311
3137924,7,4,11,50,16,3,69,208,56,333
3138001,7,0,7,47,24,3,74,192,27,293
3138002,0,0,0,85,16,3,104,197,19,320
3138003,81,4,85,133,36,4,173,422,39,634
3138004,3,3,6,196,38,6,240,283,50,573
3138005,6,3,9,165,63,7,235,371,67,673
3138006,0,0,0,56,39,4,99,186,15,300
3138007,0,0,0,47,18,3,68,183,29,280
3138008,71,7,78,49,33,6,88,301,28,417
3138009,17,3,20,42,31,3,76,182,15,273
3138010,3,0,3,63,18,3,84,214,15,313
3138011,3,0,3,56,29,4,89,152,7,248
3138012,3,0,3,60,27,3,90,177,9,276
3138013,0,0,0,62,38,4,104,242,34,380
3138014,3,0,3,159,42,16,217,300,45,562
3138015,0,0,0,46,15,4,65,163,9,237
3138016,5,0,5,61,19,3,83,212,18,313
3138017,16,7,23,34,48,6,88,240,19,347
3138018,7,3,10,52,30,0,82,221,18,321
3138019,0,0,0,84,30,11,125,205,15,345
3138020,0,5,5,29,14,4,47,145,12,204
3138021,4,4,8,65,26,3,94,247,26,367
3138022,0,0,0,46,6,6,58,90,9,157
3138023,7,3,10,60,21,6,87,279,30,396
3138024,3,3,6,57,22,3,82,124,30,236
3138025,6,0,6,35,29,0,64,136,3,203
3138026,30,0,30,113,32,3,148,396,59,603
3138027,3,0,3,86,38,11,135,215,21,371
3138028,3,0,6,54,15,0,69,146,15,230
3138029,3,0,3,65,26,3,94,195,35,324
3138030,3,6,9,48,20,3,71,173,33,277
3138031,24,8,32,45,24,0,69,248,37,354
3138032,11,6,17,58,39,3,100,236,22,358
3138033,92,5,97,37,21,7,65,382,31,478
3138034,0,0,0,39,10,0,49,150,38,237
3138035,6,3,12,79,45,6,130,291,20,441
3138036,6,0,6,46,21,0,67,143,18,228
3138037,0,0,0,0,0,0,0,3,0,3
3138038,12,3,15,40,47,4,91,260,34,385
3138039,0,0,0,0,0,0,0,0,0,0
3138040,0,0,0,0,0,0,0,0,0,0
3138041,3,0,3,27,6,0,33,43,3,79
3138042,0,0,0,56,19,0,75,101,19,195
3138101,6,3,9,30,21,0,51,169,25,245
3138102,3,0,3,16,23,0,39,136,18,193
3138103,3,3,6,89,23,0,112,208,28,348
3138104,8,0,8,59,38,6,103,282,30,415
3138105,6,0,6,54,23,3,80,148,12,240
3138106,3,0,3,76,11,6,93,171,24,288
3138107,0,0,0,49,21,3,73,218,18,309
3138108,31,7,38,57,18,0,75,250,23,348
3138109,127,11,144,13,18,0,31,320,29,380
3138110,0,0,0,42,32,3,77,181,6,264
3138111,8,0,8,34,32,0,66,166,15,247
3138112,0,0,0,64,9,0,73,96,15,184
3138113,7,0,7,46,42,0,88,191,7,286
3138114,5,0,5,49,37,6,92,250,18,360
3138115,0,0,0,36,35,3,74,173,8,255
3138116,0,0,0,41,24,0,65,148,15,228
3138117,0,0,0,76,33,6,115,198,23,336
3138118,8,0,8,33,43,0,76,241,19,336
3138119,6,0,6,41,20,0,61,126,18,205
3138120,4,3,7,63,24,0,87,215,21,323
3138121,6,0,6,83,39,9,131,356,36,523
3138122,18,3,21,60,40,0,100,346,21,467
3138123,15,0,15,60,33,0,93,181,20,294
3138124,13,0,13,75,27,3,105,225,15,345
3138125,10,4,14,47,27,6,80,264,30,374
3138126,6,0,6,58,12,3,73,125,9,207
3138127,8,0,11,48,24,0,72,236,12,320
3138128,4,0,4,48,24,0,72,235,21,328
3138129,5,0,5,49,28,0,77,233,32,342
3138130,10,0,10,55,34,7,96,315,22,433
3138201,0,0,0,136,28,7,171,271,0,442
3138202,0,0,0,73,12,3,88,107,3,198
3138203,0,6,6,65,19,6,90,176,9,275
3138204,3,0,3,67,13,0,80,116,3,199
3138205,0,0,0,106,55,6,167,238,12,417
3138206,3,0,3,96,12,7,115,222,10,347
3138207,0,0,0,82,23,9,114,283,9,406
3138208,0,0,0,43,16,3,62,162,5,229
3138209,0,0,0,119,29,3,151,313,21,485
3138210,0,0,0,35,13,0,48,156,0,204
3138211,0,0,0,43,22,3,68,121,10,199
3138212,0,3,3,51,20,3,74,164,15,253
3138213,0,4,4,88,43,8,139,295,33,467
3138214,8,0,8,56,40,0,96,194,14,304
3138215,3,0,3,71,32,4,107,220,35,362
3138216,4,0,4,38,14,6,58,170,10,238
3138217,3,0,3,46,29,3,78,202,7,287
3138218,0,0,0,145,48,5,198,238,15,451
3138219,98,51,149,0,11,0,11,292,115,418
3138220,6,0,6,71,25,6,102,250,10,362
3138221,0,0,0,78,9,4,91,91,0,182
3138222,0,0,0,52,24,0,76,211,3,290
3138223,0,0,0,51,18,0,69,174,3,246
3138224,0,0,0,0,0,0,0,0,0,0
3138225,0,0,0,163,27,5,195,342,27,564
3138226,0,0,0,45,17,6,68,164,6,238
3138227,0,0,0,73,27,8,108,186,12,306
3138228,0,0,0,70,23,0,93,234,12,339
3138229,0,0,0,87,24,11,122,147,9,278
3138230,4,0,4,72,31,6,109,153,9,271
3138231,4,0,4,80,34,3,117,179,7,303
3138232,0,0,0,46,19,0,65,154,6,225
3138233,3,0,3,108,37,0,145,231,11,387
3138234,5,0,5,107,47,3,157,244,9,410
3138235,0,0,0,106,25,0,131,158,13,302
3138236,0,0,0,81,25,0,106,146,0,252
3138237,6,0,6,64,24,12,100,198,3,301
3138238,0,0,0,59,19,4,82,128,14,224
3138239,3,0,3,79,24,3,106,189,3,298
3138240,0,3,3,73,27,0,100,177,24,301
3138241,0,0,0,61,18,3,82,83,12,177
3138301,0,4,4,88,35,3,126,240,16,382
3138302,0,0,0,63,14,0,77,170,16,263
3138303,6,0,6,62,33,3,98,152,4,254
3138304,3,0,3,58,19,3,80,170,10,260
3138305,0,0,0,30,18,3,51,110,9,170
3138306,3,0,3,32,28,0,60,131,12,203
3138307,3,0,3,25,28,6,59,147,9,215
3138308,0,0,0,190,40,12,242,327,35,604
3138309,0,0,0,78,22,3,103,221,12,336
3138310,0,0,0,43,15,6,64,104,9,177
3138311,0,0,0,148,21,3,172,215,12,399
3138312,0,0,0,173,26,19,218,148,20,386
3138313,3,0,3,203,63,7,273,338,21,632
3138314,3,0,3,197,32,4,233,389,34,656
3138315,3,0,3,62,12,6,80,121,3,204
3138316,4,0,4,120,29,6,155,194,6,355
3138317,0,0,0,83,13,7,103,120,10,233
3138318,4,0,4,49,36,0,85,178,5,268
3138319,3,0,3,217,42,13,272,234,9,515
3138320,0,0,0,142,24,14,180,154,9,343
3138321,0,0,0,96,16,3,115,244,23,382
3138322,6,0,6,102,32,3,137,271,13,421
3138323,0,0,0,123,36,6,165,199,9,373
3138324,0,0,0,90,17,0,107,142,9,258
3138325,0,0,0,87,18,0,105,164,3,272
3138326,3,0,3,123,35,7,165,201,15,381
3138327,0,0,0,72,21,3,96,145,3,244
3138328,4,0,4,138,53,9,200,247,10,457
3138329,3,0,3,111,32,6,149,176,18,343
3138330,6,0,6,102,27,4,133,241,16,390
3138331,0,0,0,43,19,7,69,118,3,190
3138332,0,0,0,165,40,3,208,228,3,439
3138333,0,0,0,148,35,7,190,192,8,390
3138401,3,0,3,99,55,11,165,203,16,384
3138402,0,0,0,63,15,4,82,111,12,205
3138403,6,0,6,68,14,3,85,163,12,260
3138404,0,0,0,50,15,0,65,97,12,174
3138405,0,3,3,53,16,6,75,129,18,222
3138406,0,0,0,33,25,0,58,134,9,201
3138407,3,0,3,27,28,6,61,162,20,243
3138408,0,0,0,75,20,6,101,150,6,257
3138409,0,0,0,66,27,0,93,126,9,228
3138410,0,4,4,81,32,3,116,209,31,356
3138411,0,0,0,42,4,6,52,133,11,196
3138412,0,0,0,54,22,3,79,189,20,288
3138413,0,0,0,66,25,3,94,194,13,301
3138414,3,0,3,40,33,0,73,212,15,300
3138415,3,0,3,65,18,5,88,205,10,303
3138416,3,0,3,35,27,12,74,93,9,176
3138417,0,0,0,93,19,7,119,135,14,268
3138418,0,0,0,94,23,0,117,241,24,382
3138419,0,0,0,124,33,7,164,221,22,407
3138420,0,0,0,142,19,9,170,202,12,384
3138421,7,0,7,91,42,8,141,223,0,364
3138501,0,0,0,100,26,6,132,219,31,382
3138502,0,0,0,83,20,4,107,276,16,399
3138503,0,0,0,92,14,7,113,134,5,252
3138504,0,0,0,128,15,7,150,134,3,287
3138505,0,0,0,125,18,3,146,161,3,310
3138506,0,0,0,30,9,9,48,117,10,175
3138507,0,0,0,121,18,6,145,174,30,349
3138508,0,0,0,103,30,6,139,206,19,364
3138509,0,0,0,116,19,10,145,145,15,305
3138510,3,0,3,40,9,3,52,121,6,179
3138511,0,0,0,187,17,9,213,220,25,458
3138512,0,0,0,75,12,6,93,92,3,188
3138513,0,3,3,51,21,0,72,164,15,251
3138514,0,0,0,95,31,4,130,223,6,359
3138515,0,3,3,137,31,7,175,190,18,383
3138516,0,0,0,65,6,3,74,74,9,157
3138517,0,0,0,55,24,9,88,141,30,259
3138518,0,0,0,65,26,3,94,139,12,245
3138519,0,0,0,133,30,6,169,186,3,358
3138520,0,0,0,68,21,0,89,97,0,186
3138601,0,0,0,36,24,0,60,201,6,267
3138602,9,0,9,74,41,3,118,307,6,431
3138603,0,0,0,75,43,3,121,234,7,362
3138604,3,0,3,59,17,3,79,119,7,205
3138605,0,0,0,79,31,11,121,262,14,397
3138606,0,0,0,66,12,3,81,77,3,161
3138607,0,0,0,150,26,9,185,210,12,407
3138608,0,0,0,106,30,4,140,185,8,333
3138609,6,0,6,101,46,0,147,263,19,429
3138610,3,0,3,89,35,0,124,238,28,390
3138611,0,0,0,43,19,0,62,115,0,177
3138612,3,0,3,124,38,0,162,296,18,476
3138613,3,0,3,55,21,0,76,166,13,255
3138614,4,0,4,113,17,6,136,146,12,294
3138615,0,0,0,64,32,9,105,141,12,258
3138616,6,0,6,73,50,9,132,162,0,294
3138617,0,0,0,89,25,4,118,135,12,265
3138618,3,0,3,95,46,6,147,277,22,446
3138619,0,0,0,60,10,7,77,89,3,169
3138620,3,0,3,122,49,4,175,303,20,498
3138621,0,0,0,54,18,4,76,101,9,186
3138622,3,0,3,82,19,3,104,219,16,339
3138623,0,0,0,36,12,3,51,102,12,165
3138624,3,0,3,66,14,0,80,103,7,190
3138625,0,0,0,171,51,11,233,209,12,454
3138626,0,0,0,51,19,3,73,113,3,189
3138627,0,0,0,0,0,0,0,0,0,0
3138628,0,0,0,52,23,3,78,155,7,240
3138629,0,0,0,88,20,3,111,120,12,243
3138630,0,0,0,46,23,0,69,122,6,197
3138631,3,0,3,53,19,4,76,149,9,234
3138632,0,0,0,151,32,0,183,269,20,472
3138633,0,0,0,79,21,3,103,178,25,306
3138634,3,0,3,107,27,4,138,190,24,352
3138635,0,0,0,60,29,3,92,158,16,266
3138636,6,0,6,111,51,0,162,224,6,392
3138637,0,0,0,44,22,0,66,111,4,181
3138638,0,0,0,91,34,0,125,136,6,267
3138639,5,0,5,62,49,13,124,193,8,325
3138640,6,0,6,60,29,6,95,199,9,303
3138641,3,0,3,39,17,0,56,101,3,160
3138642,0,0,0,63,37,10,110,172,0,282
3138643,0,0,0,84,39,3,126,161,7,294
3138644,3,0,3,99,42,3,144,260,11,415
3138645,6,3,9,100,31,0,131,223,18,372
3138646,3,0,3,73,27,7,107,188,10,305
3138647,6,0,6,95,38,0,133,320,30,483
3138648,0,3,3,95,35,4,134,249,12,395
3138649,0,0,0,66,24,7,97,234,0,331
3138650,0,0,0,69,33,10,112,149,9,270
3138651,0,0,0,49,19,0,68,83,10,161
3138652,0,0,0,81,20,0,101,148,8,257
3138653,0,0,0,86,15,0,101,115,12,228
3138654,0,0,0,111,31,5,147,208,3,358
3138655,0,0,0,78,17,11,106,163,4,273
3138656,0,0,0,46,42,4,92,179,21,292
3138657,0,0,0,46,28,3,77,175,3,255
3138658,0,0,0,56,15,8,79,129,11,219
3138659,0,0,0,44,19,3,66,168,3,237
3138660,45,18,63,25,17,0,42,160,50,252
3138661,0,0,0,0,3,0,3,0,0,3
3138701,0,0,0,113,39,3,155,189,9,353
3138702,0,0,0,120,12,0,132,172,4,308
3138703,3,0,3,76,10,3,89,151,15,255
3138704,3,0,3,82,25,0,107,215,12,334
3138705,0,0,0,49,18,4,71,150,10,231
3138706,0,0,0,95,30,3,128,192,19,339
3138707,0,0,0,49,22,0,71,110,0,181
3138708,0,0,0,96,30,3,129,202,18,349
3138709,3,4,7,38,12,6,56,123,4,183
3138710,0,0,0,67,10,0,77,148,4,229
3138711,0,0,0,43,32,0,75,140,17,232
3138712,0,0,0,126,35,15,176,241,15,432
3138713,0,0,0,104,19,6,129,232,15,376
3138714,0,0,0,88,29,0,117,229,12,358
3138715,3,0,3,107,41,9,157,258,18,433
3138716,10,0,10,47,24,7,78,150,3,231
3138717,0,0,0,43,15,3,61,155,18,234
3138718,3,0,3,134,32,7,173,277,32,482
3138719,3,0,3,98,41,12,151,201,20,372
3138720,5,0,5,112,27,7,146,182,15,343
3138721,0,0,0,52,28,3,83,241,13,337
3138722,5,0,5,60,14,3,77,140,13,230
3138723,5,0,5,89,31,0,120,221,14,355
3138724,3,4,7,90,36,4,130,181,7,318
3138725,0,0,0,75,16,9,100,171,27,298
3138726,3,0,3,62,20,3,85,155,22,262
3138727,0,0,0,73,22,0,95,137,4,236
3138728,0,0,0,24,9,3,36,57,9,102
3138801,0,3,3,48,21,3,72,178,43,293
3138802,0,4,4,37,11,3,51,144,4,199
3138803,0,0,0,92,42,4,138,233,18,389
3138804,3,0,3,47,13,6,66,123,10,199
3138805,9,3,12,60,27,0,87,235,18,340
3138806,0,0,3,90,35,3,128,183,20,331
3138807,0,0,0,92,38,8,138,165,16,319
3138808,4,0,4,105,30,3,138,213,37,388
3138809,0,0,0,112,37,12,161,243,16,420
3138810,0,0,0,121,43,0,164,219,10,393
3138811,0,0,0,63,26,0,89,123,4,216
3138812,3,0,3,31,23,3,57,127,12,196
3138813,3,0,3,39,34,3,76,165,15,256
3138814,0,0,0,96,34,0,130,196,9,335
3138815,0,0,0,0,0,3,3,13,0,16
3138816,11,0,11,72,39,9,120,213,25,358
3138817,48,9,57,102,41,12,155,344,50,549
3138818,0,0,0,47,24,0,71,149,10,230
3138819,3,0,3,87,22,9,118,227,23,368
3138820,0,0,0,80,20,0,100,171,22,293
3138821,0,0,0,100,36,4,140,247,31,418
3138822,0,0,0,42,12,3,57,91,6,154
3138823,0,0,0,72,6,3,81,101,6,188
3138824,3,0,3,136,39,6,181,284,25,490
3138825,3,3,6,126,43,8,177,407,36,620
3138826,0,3,3,111,42,11,164,301,42,507
3138827,3,0,3,80,38,9,127,233,3,363
3138828,4,0,4,79,34,3,116,130,6,252
3138829,6,0,6,110,40,0,150,380,37,567
3138830,73,0,73,42,30,3,75,284,18,377
3138831,3,4,7,72,38,6,116,249,30,395
3138832,11,5,16,81,22,10,113,290,36,439
3138833,3,3,6,81,26,0,107,165,34,306
3138834,0,0,0,58,17,3,78,143,12,233
3138835,0,0,0,86,13,3,102,223,27,352
3138836,0,0,0,103,33,7,143,174,24,341
3138837,0,0,0,26,23,0,49,112,6,167
3138838,0,0,0,90,25,4,119,166,21,306
3138839,0,0,0,55,23,6,84,325,48,457
3138840,0,0,0,62,24,3,89,168,9,266
3138841,0,0,0,139,50,15,204,331,22,557
3138842,0,0,0,64,5,0,69,153,6,228
3138843,0,0,0,67,8,0,75,142,9,226
3138844,0,0,0,120,48,8,176,275,36,487
3138845,37,6,43,117,41,15,173,341,28,542
3138846,4,0,4,68,15,3,86,143,7,236
3138847,0,0,0,41,12,6,59,114,10,183
3138848,3,0,3,33,21,3,57,128,6,191
3138901,0,0,0,144,42,10,196,299,24,519
3138902,0,0,0,71,18,6,95,179,20,294
3138903,0,0,0,86,45,0,131,238,28,397
3138904,4,0,4,91,27,4,122,225,13,360
3138905,0,0,0,27,15,0,42,101,3,146
3138906,0,0,0,98,26,3,127,227,18,372
3138907,3,0,3,98,30,12,140,174,25,339
3138908,3,0,3,108,21,0,129,235,5,369
3138909,3,0,3,107,26,8,141,180,18,339
3138910,3,0,3,184,46,13,243,327,25,595
3138911,0,0,0,73,37,3,113,193,13,319
3138912,3,0,3,85,25,0,110,193,11,314
3138913,0,0,0,96,31,4,131,275,25,431
3138914,0,0,0,105,41,4,150,264,6,420
3138915,118,21,139,184,70,8,262,592,77,931
3138916,0,0,0,126,17,4,147,168,20,335
3138917,0,0,0,53,21,0,74,151,12,237
3138918,0,0,0,72,15,6,93,157,21,271
3138919,3,0,3,46,25,0,71,145,18,234
3138920,0,0,0,110,30,6,146,231,17,394
3138921,3,0,3,288,50,13,351,634,36,1021
3138922,0,0,0,133,31,0,164,199,23,386
3139001,0,0,0,269,39,17,325,412,23,760
3139002,0,0,0,0,0,0,0,0,0,0
3139003,6,0,6,76,19,8,103,148,3,254
3139004,0,0,0,102,23,0,125,154,11,290
3139005,0,3,3,96,18,13,127,77,21,225
3139006,4,0,4,485,69,19,573,624,51,1248
3139007,0,0,0,167,28,0,195,208,12,415
3139008,3,0,3,532,87,21,640,742,58,1440
3139009,0,0,0,0,0,0,0,0,0,0
3139010,0,0,0,49,7,4,60,75,3,138
3139011,0,0,0,161,35,5,201,186,18,405
3139012,40,7,47,97,28,0,125,321,36,482
3139013,4,0,4,87,21,6,114,166,29,309
3139014,6,0,6,232,38,5,275,368,19,662
3139015,0,0,0,331,81,11,423,509,30,962
3139016,0,0,0,115,33,7,155,277,12,444
3139017,67,69,136,0,14,0,14,353,123,490
3139018,3,0,3,67,21,9,97,104,15,216
3139019,0,0,0,94,22,0,116,130,6,252
3139020,0,0,0,57,10,3,70,81,9,160
3139021,0,3,3,109,7,7,123,115,18,256
3139022,0,3,3,128,15,0,143,156,6,305
3139023,0,0,0,117,36,9,162,189,15,366
3139024,0,0,0,73,15,4,92,151,17,260
3139025,4,0,4,71,18,9,98,106,3,207
3139026,6,0,6,203,52,13,268,337,19,624
3139027,0,0,0,59,9,4,72,86,9,167
3139028,3,3,6,152,37,9,198,248,20,466
3139029,0,0,0,96,20,13,129,177,19,325
3139030,0,0,0,142,25,0,167,192,9,368
3139031,6,0,6,58,12,9,79,196,24,299
3139032,3,0,3,91,31,3,125,159,19,303
3139033,0,0,0,51,15,3,69,108,11,188
3139034,3,0,3,121,21,9,151,159,9,319
3139035,0,0,0,112,12,3,127,126,9,262
3139101,0,0,0,78,18,3,99,127,18,244
3139102,0,0,0,57,8,6,71,127,3,201
3139103,0,0,0,36,14,6,56,93,9,158
3139104,0,0,0,98,23,3,124,225,12,361
3139105,0,0,0,159,33,6,198,265,26,489
3139106,0,0,0,72,17,7,96,144,6,246
3139107,3,0,3,65,25,6,96,169,15,280
3139108,8,0,8,34,33,0,67,175,16,258
3139109,0,0,0,99,24,3,126,265,26,417
3139110,0,0,0,65,34,0,99,149,15,263
3139111,3,53,56,101,27,0,128,178,106,412
3139112,3,0,3,66,20,8,94,188,17,299
3139113,0,0,0,219,44,13,276,293,24,593
3139114,0,0,0,70,30,6,106,213,21,340
3139115,3,0,3,27,15,3,45,104,6,155
3139116,7,0,7,96,37,0,133,314,27,474
3139117,3,8,11,58,39,6,103,195,25,323
3139118,6,0,6,79,41,12,132,241,3,376
3139119,0,0,0,44,10,8,62,143,7,212
3139120,3,0,3,72,27,0,99,164,12,275
3139121,3,0,3,74,35,3,112,275,24,411
3139122,3,0,3,79,29,5,113,236,18,367
3139123,0,0,0,40,16,0,56,92,24,172
3139124,8,5,13,96,44,0,140,281,21,442
3139201,3,0,3,37,30,0,67,211,41,319
3139202,4,0,4,83,48,0,131,257,29,417
3139203,3,3,6,92,26,6,124,132,13,269
3139204,3,0,3,87,16,8,111,147,9,267
3139205,18,41,59,73,9,3,85,216,85,386
3139206,0,0,0,99,37,9,145,284,12,441
3139207,0,0,0,81,40,10,131,260,40,431
3139208,4,0,4,78,39,0,117,236,12,365
3139209,3,0,3,49,15,0,64,135,17,216
3139210,0,0,0,29,12,3,44,120,15,179
3139211,0,0,0,74,38,0,112,218,9,339
3139212,3,0,3,54,12,3,69,166,9,244
3139213,4,0,4,45,26,3,74,208,22,304
3139214,9,4,13,59,26,6,91,282,42,415
3139301,6,0,6,47,21,0,68,106,0,174
3139302,3,0,3,74,30,3,107,189,6,302
3139303,0,0,0,73,18,0,91,83,10,184
3139304,3,0,6,56,19,0,75,170,6,251
3139305,0,0,0,49,14,0,63,137,7,207
3139306,4,0,4,45,28,3,76,233,10,319
3139307,0,0,0,71,32,3,106,191,11,308
3139308,3,0,3,66,29,3,98,194,12,304
3139309,0,0,0,32,22,0,54,195,27,276
3139310,0,0,0,66,14,4,84,126,17,227
3139311,3,0,3,87,21,5,113,191,11,315
3139312,6,0,6,80,15,6,101,147,11,259
3139313,0,3,3,39,12,6,57,122,15,194
3139314,0,0,0,67,25,0,92,172,16,280
3139315,6,0,6,35,20,0,55,117,23,195
3139316,0,0,0,93,31,3,127,198,24,349
3139317,3,0,3,63,28,9,100,175,17,292
3139318,6,0,6,100,27,6,133,217,11,361
3139319,3,0,3,41,17,4,62,80,21,163
3139320,0,0,0,146,28,3,177,249,24,450
3139321,0,0,0,0,0,0,0,0,0,0
3139322,0,0,0,83,25,6,114,193,10,317
3139323,0,0,0,87,24,0,111,152,12,275
3139324,0,0,0,68,27,6,101,200,6,307
3139325,0,0,0,69,28,9,106,147,9,262
3139401,0,0,0,49,17,3,69,137,15,221
3139402,3,0,3,53,19,3,75,161,10,246
3139403,7,0,7,80,26,4,110,211,23,344
3139404,6,3,9,72,56,4,132,339,32,503
3139405,0,0,0,3,0,3,6,12,0,18
3139406,0,0,0,45,22,0,67,128,7,202
3139407,3,0,3,43,12,9,64,125,6,195
3139408,0,0,0,144,27,14,185,314,20,519
3139409,19,3,22,67,24,4,95,407,33,535
3139410,0,0,0,62,19,7,88,172,8,268
3139411,6,0,6,61,29,5,95,183,14,292
3139412,0,0,0,82,26,5,113,266,24,403
3139413,0,0,0,97,48,0,145,278,21,444
3139414,3,0,3,64,17,4,85,194,18,297
3139415,3,0,3,55,22,6,83,148,0,231
3139416,0,0,0,71,36,3,110,171,14,295
3139417,0,0,0,23,14,0,37,115,0,152
3139418,0,0,0,47,7,8,62,135,13,210
3139419,12,0,12,28,17,0,45,212,23,280
3139420,0,0,0,0,3,0,3,0,0,3
3139421,0,0,0,0,3,0,3,14,0,17
3139422,10,0,10,69,50,8,127,196,36,359
3139423,0,0,0,63,45,3,111,223,27,361
3139424,0,0,0,67,23,0,90,205,19,314
3139425,0,0,0,85,72,4,161,290,25,476
3139426,3,0,3,37,18,3,58,155,20,233
3139427,6,3,9,92,36,6,134,211,30,375
3139428,6,0,6,71,41,3,115,250,15,380
3139429,4,0,4,46,32,0,78,202,34,314
3139430,14,3,17,79,46,3,128,324,17,469
3139501,0,0,5,178,203,34,415,406,77,898
3139502,0,0,0,0,3,0,3,3,3,9
3139601,3,0,6,168,130,18,316,327,32,675
3139602,0,0,0,12,0,0,12,116,40,168
3139603,0,0,0,9,6,0,15,38,8,61
3139604,0,3,3,56,11,3,70,227,37,334
3139605,0,0,0,48,39,0,87,124,0,211
3139606,0,0,0,14,0,0,14,62,12,88
3139607,0,0,0,51,27,4,82,203,34,319
3139608,0,0,0,0,0,0,0,10,6,16
3139609,0,0,0,21,3,0,24,145,33,202
3139610,6,0,6,57,15,0,72,123,6,201
3139611,0,0,0,6,0,0,6,25,8,39
3139612,0,0,0,0,0,0,0,8,451,459
3139613,0,0,0,133,125,39,297,259,9,565
3139614,0,0,0,78,90,21,189,142,9,340
3139615,0,0,0,6,0,0,6,25,6,37
3139616,0,3,3,29,18,0,47,146,32,225
3139617,4,0,4,40,17,0,57,175,24,256
3139618,3,0,3,48,12,4,64,172,13,249
3139619,4,0,4,53,27,6,86,231,63,380
3139620,0,3,3,71,32,6,109,229,31,369
3139621,0,0,0,30,6,0,36,85,18,139
3139622,0,0,0,0,0,0,0,15,0,15
3139623,0,0,0,24,6,0,30,79,5,114
3139701,0,0,0,34,12,3,49,125,11,185
3139702,0,0,0,58,12,0,70,182,38,290
3139703,3,0,3,43,8,0,51,171,32,254
3139704,0,3,3,58,0,0,58,129,44,231
3139801,0,0,0,0,0,0,0,0,0,0
3139802,0,0,0,194,168,22,384,341,13,738
3139803,0,0,0,0,0,0,0,0,0,0
3139804,0,0,0,117,105,3,225,259,12,496
3139901,0,0,0,0,0,0,0,4,0,4
3139902,0,0,0,0,0,0,0,0,0,0
3139903,3,0,9,220,93,0,313,328,33,674
3139904,3,0,3,59,35,0,94,93,3,190
3139905,0,0,0,25,24,0,49,94,18,161
3139906,0,0,0,60,13,0,73,86,20,179
3139907,3,0,3,67,12,0,79,170,22,271
3139908,0,0,0,0,0,0,0,0,0,0
3139909,0,0,0,3,0,0,3,0,0,3
3139910,0,0,0,0,0,0,0,15,0,15
3140001,0,0,0,21,13,3,37,71,558,666
3140002,0,0,0,28,7,0,35,98,15,148
3140003,5,3,8,49,15,3,67,198,26,291
3140004,0,0,0,62,16,3,81,199,25,305
3140005,0,0,0,53,0,3,56,178,11,245
3140006,0,3,3,57,8,0,65,170,21,256
3140007,6,0,6,34,7,3,44,196,48,288
3140008,5,0,5,42,16,0,58,166,58,282
3140009,6,0,6,81,22,5,108,192,17,317
3140010,3,0,3,41,27,0,68,142,14,224
3140011,0,0,0,43,18,4,65,116,47,228
3140012,0,0,0,38,13,0,51,136,30,217
3140013,4,3,7,58,24,6,88,294,24,406
3140014,0,0,0,70,16,0,86,291,37,414
3140015,6,0,6,35,14,0,49,147,24,220
3140101,0,0,0,0,0,0,0,0,0,0
3140102,0,0,0,0,0,0,0,0,0,0
3140103,0,0,0,0,0,0,0,0,0,0
3140104,0,0,0,0,0,0,0,0,0,0
3140105,8,3,11,51,11,3,65,147,41,253
3140106,0,0,0,24,13,0,37,108,21,166
3140107,6,0,6,70,31,0,101,194,63,358
3140108,0,0,0,0,3,0,3,16,6,25
3140109,0,0,0,95,26,4,125,216,69,410
3140110,0,0,0,11,0,0,11,32,6,49
3140111,0,0,0,0,3,0,3,16,0,19
3140112,0,0,0,0,0,0,0,0,0,0
3140113,0,0,0,0,0,0,0,0,0,0
3140114,3,0,3,101,34,3,138,215,63,416
3140115,0,0,0,60,21,9,90,199,81,370
3140116,0,0,0,44,6,6,56,133,32,221
3140201,0,0,0,65,22,0,87,90,20,197
3140202,0,0,0,43,37,16,96,65,0,161
3140203,4,0,4,22,29,0,51,51,0,102
3140204,0,0,0,87,34,7,128,111,12,251
3140205,0,0,0,70,38,0,108,118,18,244
3140206,3,0,3,26,4,0,30,98,7,135
3140207,3,0,3,19,7,0,26,46,15,87
3140208,0,0,0,38,10,0,48,92,7,147
3140209,3,0,3,3,6,0,9,24,3,36
3140210,0,0,0,98,43,5,146,94,43,283
3140211,0,0,0,147,73,22,242,222,10,474
3140212,0,0,0,69,0,0,69,75,6,150
3140213,0,0,0,16,19,0,35,60,3,98
3140214,3,0,3,45,18,0,63,119,0,182
3140215,0,0,0,54,43,6,103,53,9,165
3140301,0,0,0,0,0,0,0,10,11,21
3140302,0,0,0,156,35,13,204,340,60,604
3140303,0,0,0,84,22,6,112,206,43,361
3140304,0,0,0,120,39,10,169,210,70,449
3140305,0,0,0,81,23,7,111,231,87,429
3140306,0,0,0,66,21,6,93,233,42,368
3140307,0,0,0,0,0,0,0,0,0,0
3140308,0,0,0,71,7,9,87,115,20,222
3140401,0,0,0,0,0,0,0,15,0,15
3140402,3,0,3,155,155,45,355,348,22,725
3140403,3,0,3,61,18,3,82,358,58,498
3140404,0,0,0,38,22,3,63,119,65,247
3140405,0,0,0,30,24,0,54,115,33,202
3140406,4,0,4,31,9,0,40,114,41,195
3140407,7,0,7,234,70,14,318,457,10,785
3140408,0,0,0,36,6,0,42,150,26,218
3140409,0,0,0,55,28,0,83,170,65,318
3140410,0,0,0,19,7,0,26,95,34,155
3140411,0,0,0,31,29,0,60,119,84,263
3140412,0,0,0,0,0,0,0,0,0,0
3140501,0,0,0,109,33,0,142,238,38,418
3140502,0,0,0,37,9,6,52,115,44,211
3140503,0,0,0,38,18,3,59,210,92,361
3140504,0,0,0,33,8,0,41,111,20,172
3140505,0,0,0,34,17,0,51,166,51,268
3140506,4,3,7,66,29,4,99,220,68,387
3140507,0,0,0,75,28,5,108,165,54,327
3140508,0,3,3,59,6,0,65,118,42,225
3140509,0,0,0,75,18,0,93,196,43,332
3140510,4,0,4,93,31,0,124,287,99,510
3140511,3,0,3,75,35,3,113,160,63,336
3140512,0,0,0,66,8,0,74,160,35,269
3140513,0,0,0,91,15,3,109,170,37,316
3140514,0,0,3,74,12,3,89,138,31,258
3140515,0,0,0,37,12,0,49,98,26,173
3140516,0,0,0,89,25,4,118,208,9,335
3140517,0,0,0,95,24,11,130,123,14,267
3140518,0,0,0,53,15,5,73,92,12,177
3140519,0,0,0,83,27,12,122,241,65,428
3140520,6,0,6,71,22,3,96,147,56,299
3140521,0,0,0,68,28,3,99,218,54,371
3140522,3,0,3,65,24,3,92,187,68,347
3140523,22,0,22,92,33,6,131,249,55,435
3140524,0,0,0,88,27,3,118,199,45,362
3140525,3,0,3,97,30,12,139,274,43,456
3140526,3,0,3,40,18,3,61,146,79,286
3140527,0,0,0,87,22,6,115,230,29,374
3140528,0,0,0,104,35,0,139,217,68,424
3140529,0,0,0,99,24,3,126,194,84,404
3140530,0,0,0,25,3,0,28,26,4,58
3140531,0,0,0,100,22,3,125,243,75,443
3140532,0,0,0,43,10,6,59,134,66,259
3140533,0,0,0,0,0,0,0,0,0,0
3140534,0,0,0,65,18,8,91,221,50,362
3140535,0,0,0,68,16,3,87,182,87,356
3140536,0,0,0,42,18,0,60,205,48,313
3140537,0,0,0,56,10,3,69,109,36,214
3140538,3,0,3,35,17,4,56,153,34,243
3140539,0,0,0,62,18,3,83,145,47,275
3140540,0,0,0,77,17,0,94,151,64,309
3140541,4,0,4,78,18,3,99,204,54,357
3140542,0,0,0,81,20,6,107,195,53,355
3140543,0,0,0,66,23,6,95,116,43,254
3140544,0,0,0,67,17,4,88,153,38,279
3140545,0,0,0,77,8,8,93,130,35,258
3140546,3,0,6,68,31,6,105,222,77,404
3140547,0,0,0,55,23,0,78,178,141,397
3140548,0,0,0,85,25,20,130,174,42,346
3140549,0,0,0,50,18,0,68,154,26,248
3140550,0,0,0,14,9,3,26,85,32,143
3140551,0,0,0,46,4,0,50,91,16,157
3140601,0,0,0,71,27,6,104,177,44,325
3140602,0,0,0,56,7,0,63,137,12,212
3140603,0,5,5,50,21,0,71,177,60,308
3140604,0,0,0,40,12,3,55,145,32,232
3140605,0,0,0,29,16,0,45,50,28,123
3140606,0,4,4,61,12,0,73,221,114,408
3140607,0,0,0,66,24,6,96,241,102,439
3140608,0,0,0,41,13,0,54,99,28,181
3140609,0,0,0,38,18,0,56,152,49,257
3140610,5,0,5,45,17,3,65,155,32,252
3140611,3,0,3,52,15,0,67,237,46,350
3140701,0,0,0,0,0,0,0,3,0,3
3140702,0,0,0,32,18,9,59,69,12,140
3140703,5,0,5,42,26,0,68,116,6,190
3140704,6,0,6,40,14,0,54,167,45,266
3140705,0,0,0,51,18,3,72,189,36,297
3140706,6,0,6,27,9,0,36,125,29,190
3140707,6,0,6,50,13,0,63,132,24,219
3140708,3,3,6,55,12,3,70,177,36,283
3140709,0,0,0,59,24,0,83,175,27,285
3140710,0,3,3,63,3,0,66,149,24,239
3140711,4,4,8,52,13,0,65,151,21,237
3140712,3,0,3,53,18,4,75,229,78,382
3140713,4,0,4,58,14,0,72,146,11,229
3140801,0,0,0,47,34,0,81,190,18,289
3140802,0,3,3,64,13,0,77,166,28,271
3140803,5,0,5,81,17,3,101,199,27,327
3140804,0,0,0,49,12,0,61,168,11,240
3140805,5,0,5,46,18,0,64,158,18,240
3140806,3,0,3,39,15,0,54,107,21,182
3140807,3,0,3,69,17,0,86,156,30,272
3140808,4,0,4,64,6,0,70,173,13,256
3140809,0,0,0,55,18,0,73,147,16,236
3140810,0,4,4,60,13,3,76,158,20,254
3140811,0,0,0,42,19,0,61,123,10,194
3140812,18,4,22,70,19,3,92,261,33,386
3140813,0,0,0,74,14,6,94,273,28,395
3140814,0,0,0,43,9,0,52,119,25,196
3140815,0,0,0,71,10,0,81,212,4,297
3140816,7,0,7,36,16,0,52,152,30,234
3140901,3,0,3,61,25,0,86,208,37,331
3140902,0,3,3,78,21,0,99,188,36,323
3140903,0,0,0,25,0,3,28,76,7,111
3140904,0,0,0,19,18,0,37,103,0,140
3140905,3,3,6,78,29,3,110,211,37,358
3140906,0,3,3,55,25,0,80,178,51,309
3140907,5,0,5,85,26,3,114,210,27,351
3140908,11,0,11,45,9,3,57,158,32,247
3140909,4,0,4,28,8,0,36,93,19,148
3140910,3,3,6,78,17,0,95,258,50,403
3140911,20,0,20,56,17,3,76,167,30,273
3140912,9,4,13,36,15,0,51,194,25,270
3140913,4,0,4,44,3,3,50,137,15,202
3140914,0,3,3,25,6,6,37,72,13,122
3141001,4,4,8,61,24,3,88,200,34,322
3141002,8,0,8,32,12,0,44,123,8,175
3141003,0,0,0,32,6,3,41,118,10,169
3141004,0,0,0,28,21,0,49,135,18,202
3141005,0,0,0,38,12,3,53,192,18,263
3141006,3,0,3,51,10,3,64,222,28,314
3141007,4,0,4,51,9,0,60,214,16,290
3141008,0,0,0,37,4,3,44,175,15,234
3141101,4,0,4,50,26,6,82,164,19,265
3141102,4,0,4,32,10,0,42,136,12,190
3141103,0,0,0,0,0,0,0,0,0,0
3141104,3,0,3,65,20,9,94,203,24,321
3141105,0,0,0,38,18,0,56,134,26,216
3141106,7,0,7,42,16,0,58,146,29,233
3141107,0,0,0,42,27,3,72,185,26,283
3141108,6,0,6,20,11,0,31,103,19,153
3141109,0,0,0,22,12,0,34,114,20,168
3141110,0,0,0,42,17,3,62,75,16,153
3141111,0,0,0,25,7,0,32,155,8,195
3141112,4,0,4,76,18,0,94,229,28,351
3141201,4,0,4,44,4,8,56,85,16,157
3141202,3,3,6,50,16,0,66,161,24,251
3141203,0,7,7,43,4,3,50,122,14,186
3141204,6,0,6,51,9,0,60,128,4,192
3141205,4,0,4,70,19,6,95,245,27,367
3141206,23,0,23,54,14,3,71,200,21,292
3141207,3,0,3,46,29,0,75,139,27,241
3141208,0,0,0,43,6,0,49,97,9,155
3141209,0,0,0,29,18,3,50,123,10,183
3141210,0,4,4,69,9,3,81,150,19,250
3141211,4,0,4,40,10,3,53,154,11,218
3141212,3,0,3,71,21,3,95,114,8,217
3141213,6,3,9,40,15,6,61,176,23,260
3141214,3,0,7,44,14,0,58,120,13,191
3141215,0,0,0,0,0,0,0,0,0,0
3141301,3,0,3,67,14,8,89,130,15,234
3141302,6,0,6,80,14,0,94,259,19,372
3141303,190,23,213,0,11,0,11,475,68,554
3141304,3,0,3,76,23,6,105,165,15,285
3141305,0,0,0,59,26,6,91,220,8,319
3141306,6,0,6,85,30,3,118,269,23,410
3141307,6,3,9,72,27,4,103,216,15,334
3141308,6,6,12,35,14,0,49,160,12,221
3141309,10,6,16,61,50,0,111,292,27,430
3141310,8,7,15,39,6,3,48,202,19,269
3141311,20,0,20,64,22,11,97,272,24,393
3141312,116,8,127,51,18,10,79,379,24,482
3141313,24,4,28,68,31,3,102,269,15,386
3141314,11,0,11,70,29,6,105,254,20,379
3141315,0,0,0,29,10,0,39,134,9,182
3141316,3,0,3,77,28,0,105,212,18,335
3141317,3,0,3,71,19,9,99,129,15,243
3141318,8,0,8,134,37,0,171,346,24,541
3141319,9,4,13,81,25,0,106,287,20,413
3141320,17,5,22,47,35,3,85,246,30,361
3141321,9,3,12,89,38,0,127,293,6,426
3141322,5,0,5,76,19,0,95,223,21,339
3141323,0,0,0,75,18,0,93,209,16,318
3141324,3,0,3,114,29,6,149,249,34,432
3141325,5,7,12,37,20,7,64,175,28,267
3141326,65,11,76,30,23,0,53,344,29,426
3141327,39,9,48,32,37,3,72,433,31,536
3141328,74,18,92,33,8,3,44,201,31,276
3141329,13,3,16,65,16,9,90,208,14,312
3141330,3,0,3,36,21,0,57,152,12,221
3141331,0,0,0,101,28,3,132,264,26,422
3141332,0,3,3,94,49,6,149,203,15,367
3141333,0,0,0,146,36,4,186,285,17,488
3141334,28,7,35,96,32,9,137,292,28,457
3141335,0,0,0,54,15,3,72,127,3,202
3141336,0,0,0,0,6,0,6,13,0,19
3141401,3,0,3,95,15,6,116,173,11,300
3141402,3,0,3,59,19,6,84,185,6,275
3141403,0,0,0,77,38,3,118,195,9,322
3141404,3,4,7,100,28,6,134,206,16,356
3141405,0,0,0,109,22,6,137,309,22,468
3141406,0,0,0,70,25,0,95,126,0,221
3141407,0,0,0,81,24,9,114,243,31,388
3141408,0,0,0,40,18,0,58,167,13,238
3141409,3,0,3,84,17,6,107,174,12,293
3141410,0,0,0,78,13,3,94,178,14,286
3141411,6,3,9,144,33,18,195,299,24,518
3141412,3,0,3,92,23,9,124,242,13,379
3141413,6,0,6,45,15,4,64,111,12,187
3141414,3,0,3,58,20,3,81,199,22,302
3141415,0,0,0,62,24,3,89,241,10,340
3141416,3,0,3,79,39,6,124,266,15,405
3141417,0,0,0,0,0,0,0,0,0,0
3141418,45,10,55,0,7,0,7,208,36,251
3141419,3,0,3,37,8,3,48,169,6,223
3141420,13,0,13,112,33,0,145,334,30,509
3141421,8,0,8,24,21,0,45,212,28,285
3141422,3,0,3,129,29,12,170,287,18,475
3141423,0,0,0,54,16,3,73,135,12,220
3141424,0,0,0,119,28,7,154,219,11,384
3141425,0,0,0,43,12,3,58,95,6,159
3141426,0,3,3,66,9,0,75,72,6,153
3141427,6,0,6,88,21,0,109,199,12,320
3141428,6,0,6,46,27,3,76,178,15,269
3141429,6,3,9,73,38,9,120,275,9,404
3141430,0,0,0,0,0,0,0,0,0,0
3141431,3,0,3,51,10,0,61,101,12,174
3141432,8,0,8,77,22,3,102,142,15,259
3141433,0,0,0,206,36,14,256,334,18,608
3141434,3,0,3,179,37,16,232,365,18,615
3141435,3,3,6,60,24,3,87,195,22,304
3141436,7,0,7,67,35,3,105,252,19,376
3141501,6,0,6,84,21,0,105,281,16,402
3141502,3,3,6,77,20,8,105,164,24,293
3141503,6,3,9,118,48,9,175,261,10,446
3141504,0,0,0,107,22,10,139,202,18,359
3141505,3,0,3,134,34,5,173,219,15,407
3141506,3,0,3,108,26,8,142,393,35,570
3141507,3,4,7,79,18,3,100,182,45,327
3141508,11,0,11,81,31,3,115,297,21,433
3141509,0,0,0,112,21,6,139,250,21,410
3141510,3,0,3,35,19,0,54,159,11,224
3141511,0,0,0,57,7,0,64,118,4,186
3141512,0,0,0,40,17,3,60,205,12,277
3141513,3,0,3,63,36,3,102,202,12,316
3141514,3,0,3,225,67,16,308,471,42,821
3141515,0,0,0,0,0,0,0,0,0,0
3141601,0,0,0,0,0,0,0,0,0,0
3141602,112,38,150,16,56,0,72,1024,160,1256
3141603,48,0,48,79,26,3,108,262,11,381
3141604,0,0,0,103,28,6,137,219,9,365
3141605,4,0,4,66,22,0,88,96,9,193
3141606,6,3,9,132,28,3,163,274,21,458
3141607,0,0,0,24,16,0,40,334,44,418
3141608,0,0,0,104,21,9,134,134,9,277
3141609,0,0,0,46,22,0,68,333,16,417
3141610,0,0,0,111,27,3,141,231,18,390
3141611,6,0,6,114,18,8,140,234,10,384
3141612,6,0,6,80,31,12,123,156,12,291
3141613,4,0,4,106,30,12,148,236,9,393
3141614,0,0,4,111,31,0,142,183,14,339
3141615,4,0,4,75,21,3,99,125,6,230
3141616,3,0,3,109,17,5,131,165,9,305
3141617,0,0,0,90,16,6,112,180,12,304
3141618,3,0,3,215,41,12,268,400,38,706
3141619,0,0,0,0,0,0,0,10,0,10
3141701,39,0,39,49,28,9,86,333,41,460
3141702,0,0,0,65,35,3,103,120,8,231
3141703,3,4,7,35,16,4,55,107,10,172
3141704,7,3,10,62,13,0,75,205,34,314
3141705,0,0,0,44,15,9,68,115,8,191
3141706,94,3,97,84,33,3,120,293,19,432
3141707,9,0,9,88,31,3,122,244,21,387
3141708,6,0,6,53,9,6,68,174,9,251
3141709,7,0,7,49,24,0,73,169,7,249
3141710,10,3,13,93,28,7,128,291,15,434
3141711,3,0,3,53,27,0,80,235,0,315
3141712,9,0,9,98,45,0,143,303,8,454
3141713,6,0,6,26,16,6,48,172,9,229
3141714,0,0,0,65,24,3,92,203,4,299
3141715,0,0,0,80,31,3,114,249,6,369
3141716,7,3,10,72,38,0,110,237,45,392
3141717,4,0,4,30,24,3,57,115,20,192
3141718,0,0,0,0,0,0,0,0,0,0
3141719,5,0,5,60,18,6,84,132,33,249
3141720,6,0,6,72,32,0,104,231,25,360
3141721,12,3,15,82,37,9,128,313,25,466
3141722,0,0,0,120,32,9,161,240,13,414
3141723,4,0,4,75,16,0,91,91,15,197
3141724,4,5,9,77,20,4,101,222,18,341
3141725,4,0,4,94,39,6,139,174,19,332
3141801,34,7,41,27,16,0,43,328,34,405
3141802,6,6,12,58,36,3,97,230,26,353
3141803,6,3,9,50,36,9,95,180,15,290
3141804,0,0,0,33,12,6,51,134,8,193
3141805,6,0,6,49,34,3,86,196,9,291
3141806,10,0,10,42,18,0,60,142,15,217
3141807,0,0,0,73,30,6,109,277,9,395
3141808,3,0,3,73,21,0,94,248,15,357
3141809,4,0,4,19,14,0,33,180,21,234
3141810,14,3,17,75,34,6,115,297,12,424
3141811,5,3,8,36,6,4,46,147,18,211
3141812,14,0,14,93,35,6,134,259,13,406
3141813,8,0,8,71,13,7,91,200,19,310
3141814,10,10,20,92,29,3,124,255,20,399
3141815,12,0,12,78,18,9,105,202,4,311
3141816,11,0,11,77,21,0,98,230,12,340
3141901,4,0,4,31,31,0,62,202,27,291
3141902,3,0,3,54,15,9,78,204,89,371
3141903,0,0,0,65,24,4,93,264,36,393
3141904,3,4,7,64,26,3,93,283,69,445
3141905,0,0,0,43,43,0,86,273,20,379
3141906,12,3,15,64,19,6,89,242,17,348
3141907,6,6,12,61,38,3,102,367,75,544
3141908,13,3,16,25,26,0,51,251,28,330
3141909,16,6,22,42,35,0,77,248,40,365
3141910,9,5,14,13,12,0,25,123,26,174
3141911,15,0,15,32,19,0,51,202,12,265
3141912,39,4,43,0,7,0,7,234,28,269
3141913,33,106,139,49,18,12,79,269,237,585
3141914,0,0,0,56,23,0,79,184,31,294
3141915,0,0,0,0,0,0,0,0,0,0
3141916,8,0,8,29,24,3,56,264,32,352
3142001,7,0,7,137,39,9,185,283,17,485
3142002,45,45,90,21,11,6,38,312,89,439
3142003,0,0,0,79,12,5,96,143,9,248
3142004,21,0,21,0,18,0,18,407,40,465
3142005,0,0,0,136,24,8,168,148,9,325
3142006,0,0,0,196,34,12,242,259,23,524
3142007,7,0,7,126,34,5,165,240,14,419
3142008,0,0,0,3,0,0,3,0,0,3
3142009,6,3,9,62,6,4,72,149,25,246
3142010,3,6,9,49,23,0,72,108,23,203
3142011,0,0,0,33,11,0,44,155,11,210
3142012,6,0,9,41,27,9,77,156,28,261
3142013,0,0,0,56,27,0,83,241,36,360
3142014,4,0,4,189,53,15,257,368,22,647
3142015,0,0,0,177,21,6,204,192,14,410
3142016,0,0,3,91,37,6,134,230,15,379
3142017,0,0,0,179,45,4,228,219,21,468
3142018,11,0,11,9,12,0,21,225,35,281
3142019,13,0,13,17,7,0,24,315,30,369
3142020,6,0,6,97,50,9,156,324,38,518
3142021,40,3,43,108,28,6,142,231,31,404
3142022,0,0,0,74,30,0,104,134,18,256
3142023,0,0,0,307,75,25,407,460,37,904
3142024,4,0,4,99,33,3,135,235,3,373
3142025,4,0,4,59,22,5,86,108,13,207
3142026,3,0,3,193,40,13,246,236,26,508
3142027,0,0,0,125,12,10,147,125,13,285
3142028,3,0,3,63,9,0,72,299,31,402
3142029,0,0,0,75,36,4,115,189,15,319
3142030,17,6,23,27,20,0,47,211,30,288
3142031,0,0,0,89,18,8,115,131,14,260
3142101,16,4,20,54,23,9,86,250,20,356
3142102,14,3,17,41,16,3,60,206,21,287
3142103,23,6,29,73,22,0,95,299,28,422
3142104,6,3,9,28,17,0,45,168,13,226
3142105,0,0,0,152,18,7,177,263,13,453
3142106,7,0,7,68,34,3,105,154,9,268
3142107,24,0,24,41,17,6,64,220,20,304
3142108,14,0,14,59,23,0,82,209,17,308
3142109,69,8,77,41,50,0,91,416,32,539
3142110,0,3,3,65,30,3,98,171,3,272
3142111,0,0,0,63,20,3,86,156,11,253
3142112,54,10,64,34,21,3,58,188,38,284
3142113,18,9,27,36,18,0,54,292,31,377
3142114,0,0,0,0,0,0,0,0,0,0
3142115,8,4,12,40,21,0,61,255,22,338
3142116,10,3,13,85,23,0,108,263,34,405
3142117,9,3,15,49,34,3,86,172,7,265
3142118,15,3,18,28,29,3,60,280,36,376
3142119,3,3,6,70,29,0,99,259,12,370
3142120,0,0,0,59,27,3,89,207,10,306
3142121,4,0,4,60,26,0,86,280,22,388
3142122,0,0,0,9,3,0,12,27,0,39
3142123,13,0,13,58,51,0,109,425,25,559
3142124,0,0,0,77,16,4,97,183,15,295
3142125,0,0,0,88,28,0,116,185,6,307
3142126,0,0,0,96,52,3,151,373,27,551
3142201,8,3,11,49,13,0,62,156,23,241
3142202,10,6,19,54,25,3,82,194,12,288
3142203,3,6,9,31,15,0,46,100,26,172
3142204,6,0,9,30,26,9,65,152,29,246
3142205,9,0,9,58,26,9,93,215,9,317
3142206,3,3,6,46,13,3,62,138,12,212
3142207,6,0,6,69,38,3,110,228,26,364
3142208,5,3,8,86,37,3,126,281,39,446
3142209,10,6,19,57,41,3,101,277,39,417
3142210,4,0,4,76,33,6,115,201,24,340
3142211,14,3,17,52,14,8,74,206,9,289
3142212,3,0,3,59,36,0,95,191,32,318
3142213,7,0,7,96,24,3,123,249,21,393
3142214,7,3,10,67,18,8,93,229,28,350
3142215,6,0,6,36,19,3,58,134,24,216
3142216,6,0,6,77,14,7,98,214,15,327
3142217,35,5,40,70,32,3,105,283,25,413
3142218,4,0,7,56,36,3,95,199,39,333
3142219,10,11,21,78,39,3,120,251,42,413
3142220,33,6,39,36,32,0,68,226,35,329
3142301,0,0,0,0,0,0,0,0,0,0
3142302,0,0,0,67,22,0,89,159,13,261
3142303,3,3,6,38,9,6,53,132,9,194
3142304,3,0,3,71,16,4,91,186,18,295
3142305,6,0,6,53,8,0,61,159,10,230
3142306,3,0,3,65,18,3,86,183,9,278
3142307,16,3,19,28,15,0,43,298,38,379
3142308,0,0,0,57,21,6,84,214,21,319
3142309,11,7,18,22,30,0,52,229,22,303
3142310,0,0,0,110,38,4,152,400,46,598
3142311,0,0,0,65,54,3,122,276,37,435
3142312,0,0,0,150,43,7,200,437,44,681
3142313,0,0,0,24,6,6,36,118,9,163
3142314,0,0,0,64,15,0,79,228,8,315
3142315,0,0,0,45,21,0,66,112,14,192
3142316,3,0,3,52,19,6,77,153,8,238
3142317,0,0,0,69,24,0,93,148,15,256
3142318,5,0,5,65,19,0,84,155,5,244
3142319,0,0,0,83,21,7,111,215,27,353
3142320,0,0,0,102,21,6,129,255,29,413
3142321,128,20,148,11,24,0,35,496,64,595
3142322,0,0,0,0,0,0,0,0,0,0
3142323,4,9,13,109,30,10,149,354,31,534
3142324,0,0,0,3,0,0,3,9,0,12
3142325,0,3,3,72,15,0,87,144,21,252
3142401,7,0,7,107,42,5,154,260,27,441
3142402,6,0,6,68,22,3,93,185,15,293
3142403,11,3,14,67,22,4,93,280,30,403
3142404,3,0,3,59,36,3,98,195,12,305
3142405,36,16,52,43,21,0,64,352,44,460
3142406,5,0,5,79,51,3,133,239,22,394
3142407,3,0,3,100,31,0,131,239,27,397
3142408,5,0,5,111,28,12,151,297,36,484
3142409,8,3,11,106,37,9,152,314,15,481
3142410,7,6,13,93,36,0,129,301,38,468
3142411,0,0,0,86,16,0,102,229,5,336
3142412,3,0,3,60,17,3,80,159,14,253
3142413,0,0,0,0,0,0,0,0,0,0
3142501,0,0,0,47,18,3,68,132,9,209
3142502,43,8,51,59,13,0,72,265,28,365
3142503,13,0,13,84,39,9,132,276,45,453
3142504,3,3,6,11,6,0,17,114,19,150
3142505,9,0,9,39,24,0,63,196,19,278
3142506,6,0,6,81,16,3,100,166,19,285
3142507,6,3,9,86,35,9,130,212,34,376
3142508,3,3,6,46,19,6,71,215,42,328
3142509,5,0,5,63,22,9,94,196,11,301
3142510,44,3,47,94,25,9,128,311,17,456
3142511,4,0,4,70,5,0,75,130,20,225
3142512,15,0,15,44,32,0,76,280,28,384
3142513,3,0,3,62,57,6,125,248,8,381
3142514,0,0,0,59,27,3,89,161,23,273
3142515,0,0,0,79,10,9,98,174,24,296
3142516,6,3,9,177,42,7,226,286,33,545
3142517,0,0,0,87,19,6,112,224,22,358
3142518,0,0,0,127,26,13,166,221,12,399
3142519,0,0,0,76,22,6,104,191,24,319
3142520,0,0,0,98,21,3,122,148,14,284
3142521,0,0,0,77,20,5,102,178,14,294
3142522,0,0,0,80,18,3,101,119,9,229
3142523,7,3,10,68,17,6,91,176,24,291
3142524,3,0,3,118,23,10,151,211,13,375
3142525,3,0,3,50,19,3,72,161,27,260
3142526,6,0,6,76,18,4,98,194,20,312
3142527,56,0,56,99,37,3,139,401,38,578
3142528,3,0,3,40,27,3,70,209,26,305
3142529,0,0,0,0,0,0,0,0,0,0
3142530,0,0,0,57,15,4,76,87,23,186
3142531,0,6,6,222,40,9,271,295,34,600
3142532,4,0,4,67,24,0,91,178,22,291
3142533,0,0,0,19,0,0,19,25,0,44
3142601,0,0,0,92,27,6,125,290,21,436
3142602,4,0,4,49,24,0,73,226,6,305
3142603,6,0,6,71,30,9,110,247,14,371
3142604,0,0,0,80,23,0,103,256,32,391
3142605,0,4,4,48,37,3,88,283,22,393
3142606,0,0,0,57,30,6,93,129,9,231
3142607,0,0,0,19,0,0,19,46,6,71
3142608,3,0,3,69,16,3,88,130,16,234
3142609,0,0,0,0,0,0,0,0,0,0
3142610,0,0,0,62,22,8,92,135,34,261
3142611,0,0,0,73,26,6,105,172,32,309
3142612,5,0,5,46,24,6,76,179,33,288
3142613,0,0,0,44,21,3,68,151,16,235
3142614,0,0,0,77,13,0,90,164,16,270
3142615,3,0,3,112,28,3,143,261,30,434
3142616,0,3,3,64,21,7,92,264,36,392
3142617,0,0,0,50,29,0,79,235,47,361
3142618,5,0,5,47,32,3,82,164,9,255
3142619,3,0,3,89,37,0,126,283,25,434
3142620,0,3,3,71,24,3,98,218,12,328
3142621,5,3,8,101,24,12,137,242,23,402
3142622,28,0,28,136,33,8,177,484,14,675
3142623,3,0,3,80,14,6,100,177,22,299
3142624,0,0,0,49,15,13,77,190,12,279
3142625,5,0,5,32,9,6,47,135,10,192
3142626,4,4,8,82,22,0,104,213,24,341
3142701,0,0,0,59,19,3,81,180,27,288
3142702,4,0,4,95,34,6,135,341,25,501
3142703,7,3,10,24,14,0,38,230,36,304
3142704,4,6,10,46,18,3,67,341,33,441
3142705,10,6,16,21,18,0,39,213,37,289
3142706,3,0,3,56,21,3,80,172,22,274
3142707,10,4,14,37,39,0,76,268,43,387
3142708,0,0,0,35,23,6,64,258,34,356
3142709,4,0,4,45,29,3,77,287,31,395
3142710,10,4,14,38,34,10,82,311,33,426
3142711,9,0,9,41,28,0,69,296,28,393
3142712,7,5,12,30,41,4,75,351,49,475
3142713,5,3,8,31,17,0,48,219,24,291
3142714,13,0,16,57,36,7,100,255,28,383
3142715,6,3,9,80,31,0,111,208,6,325
3142716,7,3,10,48,18,3,69,214,43,326
3142717,11,4,15,66,23,0,89,287,21,397
3142718,83,19,102,0,18,0,18,342,44,404
3142719,3,0,3,54,18,0,72,187,15,274
3142720,4,3,7,57,27,3,87,307,26,420
3142721,9,0,9,32,6,3,41,142,12,195
3142722,6,3,9,74,23,3,100,299,17,416
3142723,9,0,9,41,15,4,60,188,13,261
3142724,0,0,0,0,0,0,0,0,0,0
3142725,3,0,3,21,19,3,43,259,24,326
3142726,8,6,14,43,14,0,57,219,47,323
3142727,14,0,14,46,40,0,86,193,23,302
3142728,4,0,4,23,26,0,49,220,27,296
3142729,26,10,36,43,24,0,67,310,63,440
3142730,6,3,9,92,33,0,125,185,21,331
3142731,0,3,3,68,11,4,83,124,15,222
3142732,0,0,0,79,21,6,106,184,26,316
3142733,3,0,3,90,27,15,132,275,24,431
3142734,0,0,0,38,7,3,48,107,18,173
3142735,11,8,19,38,31,0,69,431,66,566
3142736,6,0,6,69,31,0,100,270,20,390
3142737,37,8,45,6,10,0,16,264,41,321
3142738,3,4,7,62,17,7,86,217,24,327
3142739,12,0,12,57,25,0,82,265,32,379
3142740,7,6,13,41,22,3,66,247,78,391
3142741,3,3,6,114,54,0,168,560,44,772
3142801,4,0,4,34,14,0,48,186,33,267
3142802,7,3,10,15,13,0,28,181,44,253
3142803,7,0,7,73,35,4,112,341,55,508
3142804,4,0,4,44,26,3,73,188,9,270
3142805,8,10,18,76,24,6,106,362,51,519
3142806,3,0,3,43,32,3,78,182,22,282
3142807,3,0,3,13,18,3,34,149,21,204
3142808,8,3,11,36,21,9,66,307,64,437
3142809,6,3,9,52,21,0,73,230,35,338
3142810,0,0,0,28,18,5,51,184,7,242
3142811,3,0,3,51,13,6,70,249,30,349
3142812,7,0,7,77,28,0,105,194,35,334
3142813,6,0,6,44,24,0,68,188,15,271
3142814,0,0,0,44,37,3,84,368,49,501
3142815,3,0,3,41,32,4,77,221,24,322
3142816,3,0,3,27,31,0,58,171,27,256
3142817,4,0,4,12,16,3,31,178,30,239
3142818,0,0,0,78,39,3,120,225,54,399
3142819,3,0,3,91,38,9,138,278,42,458
3142820,9,0,9,59,38,0,97,293,40,430
3142821,85,7,92,54,24,0,78,384,40,502
3142822,7,0,7,44,14,0,58,259,4,321
3142823,4,0,4,28,18,6,52,240,31,323
3142824,3,0,3,42,21,3,66,240,24,330
3142825,4,0,4,79,33,4,116,253,22,391
3142826,4,0,4,38,29,0,67,268,29,364
3142827,3,0,3,28,6,3,37,179,18,234
3142828,7,0,7,57,20,3,80,246,24,350
3142901,0,0,0,61,21,0,82,100,18,200
3142902,3,0,3,62,15,0,77,106,12,195
3142903,3,3,6,40,6,0,46,83,12,141
3142904,0,0,0,26,7,0,33,94,0,127
3142905,0,0,0,66,26,3,95,212,27,334
3142906,6,0,6,47,34,0,81,175,12,268
3142907,3,0,3,218,56,7,281,393,39,713
3142908,0,0,0,70,21,6,97,207,43,347
3142909,3,0,3,118,13,8,139,222,12,373
3142910,56,0,56,55,9,0,64,208,12,284
3142911,4,0,4,56,23,6,85,161,9,255
3142912,0,0,0,68,15,7,90,149,9,248
3142913,3,3,6,81,15,3,99,192,15,306
3142914,0,0,0,60,14,9,83,112,3,198
3142915,0,0,0,75,21,3,99,174,18,291
3142916,44,13,57,31,32,7,70,403,76,549
3142917,6,0,6,106,44,3,153,248,15,416
3142918,0,0,0,0,0,0,0,0,0,0
3142919,0,0,0,0,0,0,0,0,0,0
3143001,7,0,7,84,28,0,112,241,14,367
3143002,3,0,3,37,18,4,59,115,6,180
3143003,4,0,4,47,38,0,85,136,8,229
3143004,0,0,0,23,13,4,40,136,19,195
3143005,3,0,3,40,26,0,66,197,0,263
3143006,0,0,0,60,12,4,76,125,9,210
3143007,6,0,6,50,26,3,79,237,27,343
3143008,3,0,3,72,36,7,115,258,12,385
3143009,3,0,3,39,20,7,66,129,9,204
3143010,0,0,0,51,22,3,76,103,12,191
3143011,4,0,4,45,14,0,59,96,6,161
3143101,0,0,0,61,21,0,82,191,18,291
3143102,0,0,0,39,26,3,68,161,19,248
3143103,6,0,6,70,25,3,98,232,21,351
3143104,3,0,3,29,18,0,47,138,3,188
3143105,5,0,5,42,18,0,60,134,5,199
3143106,5,0,5,67,23,9,99,185,15,299
3143107,0,0,0,146,34,3,183,327,45,555
3143108,3,0,3,118,31,3,152,227,21,400
3143109,6,0,6,40,9,0,49,93,10,152
3143110,6,0,6,70,26,0,96,225,12,333
3143111,7,0,7,100,33,3,136,365,26,527
3143112,0,0,0,88,25,0,113,158,25,296
3143113,6,0,6,97,43,5,145,316,32,493
3143114,3,0,3,68,16,0,84,145,24,253
3143115,0,0,0,57,12,3,72,82,12,166
3143116,3,0,3,58,37,3,98,201,27,326
3143117,3,0,3,39,23,0,62,155,25,242
3143118,3,3,6,47,19,3,69,177,14,260
3143119,7,3,10,99,40,6,145,307,42,494
3143120,9,0,9,147,42,6,195,359,49,603
3143121,4,0,4,49,18,3,70,131,23,224
3143122,5,0,5,102,29,6,137,280,9,426
3143123,0,0,0,27,12,6,45,91,12,148
3143201,8,11,19,83,23,0,106,248,26,380
3143202,133,3,136,21,6,6,33,315,19,367
3143203,10,0,10,76,24,13,113,260,21,394
3143204,0,4,4,85,41,0,126,242,14,382
3143205,0,0,0,57,17,3,77,149,18,244
3143206,4,0,4,55,19,3,77,164,7,248
3143207,19,0,19,39,27,6,72,194,9,275
3143208,6,3,9,106,34,6,146,282,12,440
3143209,3,0,3,45,21,0,66,127,30,223
3143210,3,0,3,60,20,3,83,172,10,265
3143211,6,0,6,47,25,3,75,165,3,243
3143212,47,7,54,45,22,3,70,226,35,331
3143213,12,0,12,85,28,3,116,206,4,326
3143214,0,3,3,90,31,3,124,179,21,324
3143215,3,0,3,46,16,0,62,129,11,202
3143216,5,0,5,54,7,6,67,156,18,241
3143217,0,3,3,39,15,3,57,103,29,189
3143218,6,0,6,57,21,3,81,172,12,265
3143219,0,0,0,43,10,0,53,101,13,167
3143220,7,4,11,75,46,9,130,238,23,391
3143221,6,0,6,127,35,0,162,280,14,456
3143222,9,0,9,112,43,9,164,335,28,527
3143223,3,0,3,51,25,0,76,163,12,251
3143224,5,4,9,46,3,7,56,182,19,257
3143225,26,6,32,73,39,10,122,309,40,471
3143226,3,0,3,60,30,3,93,255,23,371
3143227,6,0,6,27,9,0,36,114,3,153
3143228,0,0,0,58,29,6,93,158,21,272
3143229,7,0,7,52,19,0,71,195,19,285
3143230,6,0,6,161,33,19,213,305,42,560
3143231,6,3,9,93,30,11,134,268,41,443
3143232,4,0,4,100,31,6,137,229,14,380
3143233,6,5,11,71,23,10,104,262,52,418
3143234,4,0,4,46,22,3,71,163,15,249
3143235,0,0,0,93,19,6,118,146,12,276
3143236,0,3,3,60,21,0,81,150,13,244
3143237,10,6,16,44,15,0,59,200,21,280
3143238,43,9,52,159,28,9,196,438,63,697
3143239,12,0,12,57,34,0,91,244,16,351
3143240,14,3,17,90,45,3,138,284,25,447
3143241,8,0,8,75,39,0,114,280,24,418
3143242,6,0,6,52,35,0,87,190,30,307
3143243,30,0,30,74,28,0,102,278,14,394
3143301,3,0,3,27,6,3,36,121,15,172
3143302,0,0,0,74,17,0,91,155,13,259
3143303,3,0,3,54,20,9,83,218,9,310
3143304,0,0,0,59,36,4,99,243,23,365
3143305,0,0,0,79,27,0,106,224,50,380
3143306,0,0,0,43,24,0,67,203,13,283
3143307,3,0,3,40,22,0,62,100,11,173
3143308,4,0,4,41,25,0,66,147,18,231
3143309,7,3,10,30,12,0,42,137,21,200
3143310,0,0,0,48,10,5,63,172,17,252
3143311,3,0,3,31,23,3,57,172,0,229
3143312,0,0,0,37,28,6,71,129,15,215
3143313,6,0,6,69,23,7,99,179,22,300
3143314,53,0,53,32,12,3,47,193,25,265
3143315,3,0,3,62,8,0,70,158,12,240
3143316,7,0,7,57,21,3,81,220,21,322
3143317,0,0,0,51,16,0,67,148,15,230
3143318,0,0,0,53,13,3,69,181,12,262
3143319,4,0,4,57,25,5,87,144,17,248
3143320,6,0,6,21,10,4,35,71,9,115
3143321,0,0,0,73,19,6,98,256,32,386
3143322,6,3,9,63,12,3,78,221,39,338
3143323,3,6,9,78,32,6,116,253,42,411
3143324,0,0,0,37,12,4,53,178,10,241
3143325,0,0,0,79,15,6,100,268,48,416
3143326,3,0,3,55,13,9,77,218,9,304
3143327,0,0,0,30,18,3,51,154,15,220
3143328,15,0,15,58,38,9,105,218,27,350
3143329,3,0,3,62,6,0,68,121,15,204
3143330,0,0,0,52,14,0,66,121,13,200
3143331,0,0,0,77,17,0,94,162,15,271
3143332,3,0,3,50,24,0,74,174,11,259
3143333,3,0,3,99,21,4,124,276,16,416
3143334,0,0,0,49,12,0,61,129,8,198
3143335,3,0,3,63,12,4,79,183,8,270
3143336,0,0,0,46,19,0,65,176,12,253
3143337,3,0,3,37,11,0,48,140,6,194
3143338,3,0,3,67,10,0,77,244,34,355
3143339,0,0,0,65,21,3,89,141,20,250
3143340,3,0,3,58,24,4,86,238,25,349
3143341,3,4,7,92,25,3,120,206,32,358
3143342,4,0,4,41,23,0,64,201,16,281
3143343,0,0,0,23,12,3,38,94,10,142
3143344,6,0,6,36,6,3,45,116,13,174
3143345,6,0,6,59,18,4,81,184,24,289
3143346,0,0,0,93,15,4,112,233,18,363
3143347,0,3,3,64,22,6,92,207,27,326
3143348,0,0,0,35,9,3,47,91,3,141
3143349,0,0,0,67,31,3,101,219,31,351
3143350,6,0,6,57,22,3,82,232,22,336
3143351,3,0,3,58,21,3,82,147,14,243
3143352,0,0,0,71,7,3,81,158,14,253
3143353,3,0,3,42,15,0,57,163,13,233
3143354,4,0,4,57,16,11,84,161,12,257
3143355,0,0,0,62,8,0,70,139,9,218
3143356,0,0,0,52,15,0,67,144,9,220
3143357,5,0,5,87,31,7,125,204,23,352
3143358,3,3,6,105,39,0,144,293,20,457
3143359,0,0,0,89,22,8,119,189,16,324
3143401,58,7,65,0,0,0,0,109,13,122
3143402,12,3,15,36,11,3,50,254,27,331
3143403,6,3,9,73,28,0,101,222,25,348
3143404,6,3,9,41,12,0,53,128,14,195
3143405,0,0,0,49,12,0,61,125,8,194
3143406,3,0,3,24,43,0,67,255,24,346
3143407,6,0,6,53,8,3,64,170,3,237
3143408,0,0,0,0,0,0,0,0,0,0
3143409,0,0,0,0,0,0,0,0,0,0
3143410,6,6,12,30,25,3,58,239,12,309
3143411,12,0,12,58,30,0,88,292,58,438
3143412,6,0,6,42,18,0,60,234,12,306
3143413,0,0,0,36,24,0,60,280,44,384
3143414,6,0,6,40,16,6,62,181,24,267
3143501,0,0,0,0,0,0,0,0,0,0
3143502,3,3,6,44,14,0,58,234,27,319
3143503,5,0,5,32,9,0,41,202,31,274
3143504,6,5,11,45,21,0,66,249,15,330
3143505,7,0,7,26,15,0,41,210,15,266
3143506,3,0,3,7,0,7,14,104,10,128
3143507,3,0,3,66,25,3,94,268,22,384
3143508,6,0,6,52,25,3,80,262,35,377
3143509,82,27,109,9,12,0,21,364,68,453
3143510,0,0,0,15,17,0,32,173,15,220
3143511,0,0,0,0,0,0,0,0,0,0
3143512,6,0,6,53,23,0,76,285,27,388
3143513,4,0,4,54,42,3,99,321,70,490
3143514,6,7,13,53,20,3,76,369,88,533
3143515,6,0,6,61,17,0,78,242,13,333
3143516,5,0,5,55,18,7,80,150,11,241
3143517,5,3,8,59,32,4,95,233,26,354
3143518,6,0,6,57,8,0,65,186,16,267
3143519,3,0,3,129,35,8,172,306,19,497
3143520,0,0,0,6,0,0,6,26,3,35
3143521,0,0,0,21,6,3,30,84,8,122
3143522,0,0,0,0,0,0,0,0,0,0
3143523,0,0,0,0,0,0,0,0,0,0
3143524,9,0,9,153,42,3,198,362,21,581
3143601,0,3,3,368,66,8,442,441,54,937
3143602,0,0,0,57,19,3,79,178,9,266
3143603,0,3,3,93,20,6,119,212,18,349
3143604,3,0,3,223,42,12,277,319,24,620
3143605,3,0,3,68,21,3,92,154,6,252
3143606,4,0,4,63,12,0,75,171,16,262
3143607,3,3,6,115,21,6,142,177,21,340
3143608,3,0,3,65,9,3,77,141,12,230
3143609,6,3,9,82,25,0,107,302,36,445
3143610,11,0,11,70,14,0,84,156,10,250
3143611,0,0,0,59,16,5,80,135,41,256
3143612,8,3,11,72,23,0,95,279,29,403
3143613,0,0,0,4,0,0,4,3,0,7
3143614,26,9,35,59,21,3,83,238,32,353
3143615,0,0,0,131,40,17,188,231,45,464
3143616,0,0,0,115,41,7,163,270,15,448
3143701,0,0,0,45,10,0,55,165,25,245
3143702,0,0,0,41,4,0,45,105,4,154
3143703,0,0,0,62,12,0,74,198,21,293
3143704,0,0,0,97,13,3,113,274,16,403
3143705,0,0,0,56,9,9,74,112,3,189
3143706,0,0,0,92,13,5,110,178,31,319
3143707,0,0,0,73,14,3,90,221,13,324
3143708,3,3,6,97,41,6,144,317,28,489
3143709,0,0,0,59,13,6,78,170,18,266
3143710,0,0,0,101,40,0,141,230,23,394
3143711,0,0,0,0,0,0,0,0,0,0
3143712,3,0,3,22,6,0,28,127,10,165
3143713,0,0,0,0,0,0,0,0,0,0
3143714,5,0,5,78,21,3,102,253,62,417
3143715,0,0,0,0,0,0,0,0,0,0
3143716,3,0,3,53,37,6,96,212,32,340
3143717,0,0,0,33,5,4,42,85,21,148
3143718,7,0,7,57,22,0,79,185,36,300
3143719,3,0,3,48,15,0,63,196,14,273
3143720,0,0,0,27,16,0,43,152,29,224
3143721,6,0,6,52,18,7,77,116,12,205
3143801,0,0,0,39,8,0,47,113,10,170
3143802,10,0,10,76,25,3,104,219,24,347
3143803,7,0,7,40,9,0,49,127,16,192
3143804,10,0,10,66,25,0,91,204,17,312
3143805,11,0,11,91,29,7,127,343,25,495
3143806,3,7,10,71,24,3,98,205,31,334
3143807,7,0,7,29,21,3,53,213,20,286
3143808,0,0,0,44,25,0,69,107,15,191
3143809,3,8,11,70,18,4,92,182,36,310
3143810,4,3,7,41,3,3,47,144,18,209
3143811,6,6,12,84,31,6,121,267,32,420
3143812,54,15,69,20,21,0,41,319,47,407
3143813,10,0,10,69,17,0,86,202,21,309
3143814,4,3,7,46,22,6,74,261,33,368
3143815,6,6,12,31,16,6,53,116,21,190
3143816,125,16,141,37,21,0,58,421,36,515
3143817,5,3,8,65,28,3,96,244,15,355
3143818,0,0,0,68,21,7,96,174,6,276
3143819,0,0,0,70,22,3,95,193,15,303
3143820,4,0,4,82,32,4,118,246,26,390
3143821,28,3,31,42,16,0,58,291,27,376
3143822,3,0,3,38,16,0,54,128,6,188
3143823,6,0,6,38,20,6,64,173,13,250
3143824,3,0,3,54,12,0,66,141,15,222
3143825,0,0,0,0,0,0,0,0,0,0
3143826,0,0,0,0,0,0,0,0,0,0
3143827,8,79,87,53,14,0,67,194,107,368
3143828,3,0,3,49,11,7,67,127,22,216
3143829,7,0,7,53,26,0,79,193,18,290
3143901,0,0,0,74,35,6,115,233,21,369
3143902,6,0,6,87,24,6,117,234,38,389
3143903,4,0,4,53,30,3,86,167,9,262
3143904,3,0,3,51,17,0,68,217,32,317
3143905,3,3,6,49,25,3,77,151,14,242
3143906,9,7,16,95,32,10,137,317,76,530
3143907,11,5,16,87,24,9,120,307,26,453
3143908,67,3,70,77,16,0,93,290,19,402
3143909,8,0,8,165,56,13,234,382,57,673
3143910,0,0,0,84,13,9,106,184,9,299
3143911,6,0,6,304,69,12,385,521,44,950
3143912,3,0,3,49,18,0,67,142,7,216
3143913,6,0,6,54,30,6,90,200,15,305
3143914,0,0,0,41,19,3,63,152,28,243
3144001,0,0,0,49,13,0,62,196,25,283
3144002,0,0,0,32,7,0,39,150,11,200
3144003,0,0,0,42,16,0,58,162,15,235
3144004,12,6,18,98,42,11,151,363,44,558
3144005,4,0,4,36,13,0,49,112,28,189
3144006,15,0,15,112,39,3,154,397,36,587
3144007,0,0,0,31,9,3,43,100,12,155
3144008,9,0,9,47,42,3,92,336,40,468
3144009,0,3,3,43,28,0,71,160,18,249
3144010,7,3,10,28,19,0,47,172,28,247
3144011,4,0,4,33,23,0,56,193,12,261
3144012,6,0,6,32,29,0,61,156,10,227
3144013,3,0,3,33,17,0,50,108,16,174
3144014,3,0,3,43,26,0,69,178,22,269
3144015,5,0,5,71,29,0,100,312,24,436
3144016,3,0,3,51,17,4,72,233,8,313
3144017,4,0,4,67,25,0,92,192,16,300
3144018,3,0,3,57,16,9,82,164,13,259
3144019,5,0,5,73,14,7,94,247,24,365
3144020,11,36,47,33,12,6,51,147,81,279
3144021,9,3,12,70,36,6,112,324,22,458
3144022,6,3,9,19,13,0,32,146,24,202
3144101,0,0,0,36,18,0,54,144,23,221
3144102,8,0,8,171,43,15,229,372,69,670
3144103,0,0,0,21,10,3,34,67,18,119
3144104,0,3,3,45,12,0,57,181,31,269
3144105,6,0,6,66,26,4,96,201,19,316
3144106,6,3,9,98,28,9,135,313,70,518
3144107,6,0,6,44,3,0,47,111,3,161
3144108,0,0,0,0,0,0,0,0,0,0
3144109,3,0,3,100,29,0,129,253,38,420
3144110,0,0,0,66,24,3,93,133,24,250
3144111,0,0,0,53,18,0,71,118,19,208
3144112,0,0,0,29,12,0,41,74,9,124
3144113,7,3,10,66,23,9,98,199,20,317
3144114,4,0,4,47,16,3,66,168,28,262
3144115,3,3,6,98,39,6,143,333,31,507
3144201,0,0,0,91,29,3,123,144,12,279
3144202,0,0,0,29,12,0,41,76,9,126
3144203,0,3,3,68,14,0,82,124,13,219
3144204,6,0,6,68,18,6,92,181,27,300
3144205,0,0,0,98,28,0,126,175,21,322
3144206,0,0,0,51,22,6,79,164,13,256
3144207,0,0,0,36,10,3,49,177,15,241
3144208,0,0,0,76,16,4,96,200,15,311
3144209,3,0,3,47,10,4,61,126,4,191
3144210,0,0,0,51,25,0,76,158,8,242
3144211,0,0,0,6,0,0,6,0,0,6
3144212,0,8,8,47,23,0,70,165,28,263
3144213,6,0,6,80,21,4,105,188,12,305
3144214,0,0,0,44,9,0,53,50,0,103
3144215,0,0,0,70,20,3,93,227,27,347
3144216,0,0,0,65,23,6,94,259,21,374
3144217,0,0,0,28,23,6,57,141,37,235
3144218,0,0,0,75,18,3,96,156,15,267
3144219,6,0,6,39,15,0,54,131,26,211
3144220,0,3,3,87,13,4,104,177,20,301
3144221,3,0,3,53,21,3,77,143,15,235
3144222,0,0,0,35,23,6,64,152,36,252
3144223,3,3,6,101,23,4,128,195,47,370
3144224,3,0,3,52,24,0,76,129,12,217
3144225,3,4,7,74,17,7,98,189,8,295
3144226,3,0,3,64,16,0,80,143,19,242
3144227,0,0,0,41,29,3,73,115,17,205
3144228,0,0,0,0,0,0,0,0,0,0
3144229,3,0,3,60,14,0,74,98,6,178
3144230,0,0,0,40,11,0,51,94,7,152
3144231,4,0,4,76,20,0,96,178,25,299
3144301,3,0,3,53,22,0,75,149,20,244
3144302,10,6,16,42,20,0,62,252,16,330
3144303,8,0,8,55,23,6,84,291,30,405
3144304,3,0,3,33,20,6,59,139,15,213
3144305,4,0,4,38,27,4,69,210,23,302
3144306,0,3,3,16,6,0,22,117,9,148
3144307,5,0,5,38,18,3,59,207,19,285
3144308,4,0,4,30,11,0,41,116,33,190
3144309,6,3,9,46,20,3,69,182,25,276
3144310,0,0,0,67,10,3,80,227,27,334
3144311,3,3,6,57,13,3,73,144,27,244
3144312,0,0,0,0,0,0,0,0,0,0
3144313,0,0,0,60,6,0,66,144,7,217
3144314,3,3,6,29,20,3,52,151,9,212
3144315,7,0,7,46,25,3,74,175,15,264
3144316,3,0,3,40,21,3,64,127,16,207
3144317,3,0,3,40,23,3,66,143,12,221
3144318,3,0,3,37,25,0,62,128,7,197
3144319,6,0,6,50,37,3,90,235,6,331
3144320,6,0,6,72,21,5,98,208,30,336
3144401,3,0,3,79,24,3,106,173,24,303
3144402,5,0,5,44,15,0,59,122,6,187
3144403,6,6,12,68,25,7,100,175,18,293
3144404,6,0,6,81,23,4,108,186,22,316
3144405,3,3,6,46,28,3,77,251,25,353
3144406,0,0,0,44,7,0,51,166,14,231
3144407,4,0,4,59,23,7,89,207,46,342
3144408,0,0,0,99,24,8,131,195,13,339
3144409,0,0,0,56,32,7,95,168,24,287
3144410,3,0,3,57,15,0,72,171,22,265
3144411,0,0,0,69,20,0,89,149,22,260
3144412,0,0,0,76,26,12,114,211,15,340
3144413,3,0,3,43,22,7,72,134,15,221
3144414,0,0,0,119,29,6,154,205,24,383
3144415,0,3,3,30,18,9,57,93,18,168
3144416,6,3,9,99,30,0,129,207,30,366
3144417,6,6,12,72,38,6,116,263,30,409
3144418,3,0,3,34,15,0,49,136,15,200
3144419,0,0,0,47,19,3,69,163,11,243
3144420,3,0,3,43,21,0,64,94,15,173
3144421,6,0,6,138,29,11,178,183,24,385
3144422,6,3,9,66,25,7,98,168,15,281
3144423,3,5,8,64,11,10,85,198,15,298
3144424,9,0,9,79,22,13,114,190,3,307
3144425,8,6,14,87,29,0,116,240,25,381
3144426,82,12,94,20,4,6,30,252,24,306
3144427,3,3,6,76,18,7,101,108,17,226
3144428,3,3,6,29,13,0,42,103,9,154
3144501,4,0,4,21,16,0,37,80,18,135
3144502,0,0,0,158,11,11,180,245,15,440
3144503,0,0,0,80,20,3,103,150,30,283
3144504,0,4,4,40,16,6,62,120,14,196
3144505,6,0,6,137,42,13,192,280,35,507
3144506,6,0,6,60,18,4,82,104,10,196
3144507,0,0,0,221,56,11,288,323,19,630
3144508,3,3,6,139,49,10,198,289,18,505
3144509,0,0,0,63,23,6,92,86,4,182
3144510,0,0,0,57,13,9,79,199,15,293
3144511,0,0,0,71,16,9,96,132,26,254
3144512,0,0,0,53,15,6,74,116,12,202
3144513,0,0,0,45,16,7,68,145,12,225
3144514,4,0,4,28,17,0,45,128,9,182
3144601,3,0,3,62,24,3,89,277,10,376
3144602,3,0,3,53,18,6,77,149,12,238
3144603,0,0,0,84,29,3,116,237,28,381
3144604,0,0,3,96,18,3,117,263,30,410
3144605,4,0,4,97,33,6,136,225,14,375
3144606,0,0,0,62,20,0,82,167,7,256
3144607,3,0,3,69,29,3,101,255,25,381
3144608,0,0,0,6,12,0,18,188,3,209
3144609,0,0,0,3,13,0,16,347,51,414
3144610,69,12,81,59,15,3,77,309,27,413
3144611,6,0,6,93,29,6,128,247,3,378
3144612,0,0,0,112,35,6,153,430,54,637
3144613,0,0,0,75,35,0,110,241,35,386
3144614,0,0,0,69,20,0,89,236,24,349
3144615,3,3,6,93,18,8,119,236,25,380
3144616,6,6,12,50,15,6,71,144,9,224
3144617,6,0,6,45,26,6,77,163,12,252
3144618,4,0,4,44,25,0,69,166,45,280
3144619,6,0,6,42,21,0,63,114,9,186
3144620,0,0,0,50,25,0,75,129,10,214
3144621,3,0,3,82,27,0,109,257,62,428
3144622,0,3,3,44,23,0,67,173,43,283
3144623,7,0,7,59,34,5,98,239,27,364
3144624,3,0,3,82,33,9,124,222,20,366
3144625,6,0,6,22,19,0,41,123,18,182
3144626,19,10,29,27,18,6,51,260,46,357
3144627,39,52,91,25,20,0,45,302,146,493
3144628,0,3,3,78,34,3,115,240,30,385
3144629,0,3,3,75,24,0,99,179,18,296
3144701,3,3,6,41,20,0,61,125,10,196
3144702,15,0,15,72,42,6,120,352,52,524
3144703,6,6,12,62,27,0,89,190,26,305
3144704,56,17,77,22,27,0,49,369,62,480
3144705,4,0,4,82,29,7,118,233,27,378
3144706,4,0,4,64,30,3,97,241,24,362
3144707,3,0,3,40,17,0,57,156,19,232
3144708,3,3,6,45,26,6,77,104,10,191
3144709,0,4,4,69,29,3,101,240,63,404
3144710,12,7,19,61,24,0,85,352,68,505
3144711,3,0,3,160,37,12,209,262,48,519
3144712,3,3,6,87,44,3,134,252,97,483
3144713,0,0,0,37,30,3,70,100,18,188
3144714,3,0,3,72,26,6,104,239,31,374
3144715,6,3,12,67,40,6,113,215,27,355
3144716,9,3,12,47,41,9,97,215,34,346
3144717,0,0,0,50,19,9,78,131,15,224
3144718,9,3,12,86,46,6,138,245,46,429
3144719,4,0,4,47,23,0,70,224,24,318
3144720,7,0,7,85,42,6,133,323,81,537
3144721,50,73,123,36,26,0,62,213,149,424
3144722,35,15,50,34,25,3,62,269,52,383
3144801,4,3,7,63,21,0,84,171,37,292
3144802,3,3,6,85,27,6,118,174,9,301
3144803,3,3,6,46,12,4,62,147,21,230
3144804,0,0,0,0,8,3,11,261,29,301
3144805,9,0,9,62,18,8,88,314,30,432
3144806,5,0,5,36,7,0,43,119,14,176
3144807,13,0,13,72,33,4,109,276,44,429
3144808,7,0,7,44,15,0,59,147,12,218
3144809,3,6,9,52,42,0,94,257,25,376
3144810,44,5,49,72,29,3,104,279,24,407
3144811,4,0,4,33,21,4,58,121,7,186
3144812,0,0,0,39,28,0,67,200,12,279
3144813,11,3,14,30,9,0,39,143,26,208
3144814,6,0,6,58,13,0,71,209,39,319
3144815,0,0,0,34,15,0,49,146,22,217
3144816,0,0,0,73,21,8,102,250,21,373
3144817,13,0,13,162,35,9,206,405,46,657
3144818,19,4,23,56,32,0,88,223,51,362
3144901,0,0,0,60,3,3,66,135,7,208
3144902,0,0,0,53,25,0,78,130,9,217
3144903,0,0,0,121,18,12,151,183,15,349
3144904,0,0,0,94,16,7,117,161,10,288
3144905,0,0,0,73,25,4,102,200,16,318
3144906,0,3,3,51,15,6,72,98,12,182
3144907,0,0,0,60,15,0,75,203,18,296
3144908,0,0,0,93,23,10,126,115,8,249
3144909,3,0,3,100,37,3,140,264,21,425
3144910,0,0,0,62,9,6,77,174,36,287
3144911,0,0,0,60,3,6,69,87,0,156
3144912,0,0,0,81,20,6,107,205,24,336
3144913,3,0,3,59,6,4,69,107,0,176
3144914,0,0,0,186,38,10,234,346,19,599
3145001,0,0,0,67,23,4,94,117,4,215
3145002,3,0,3,56,14,0,70,140,7,217
3145003,3,0,3,185,35,6,226,342,15,583
3145004,3,0,3,100,34,5,139,248,16,403
3145005,8,0,8,135,39,6,180,285,16,481
3145006,0,0,0,46,22,0,68,135,6,209
3145007,3,0,3,232,48,11,291,301,25,617
3145008,9,5,14,78,12,4,94,164,22,280
3145009,3,0,3,52,12,6,70,111,11,192
3145010,0,0,0,59,26,0,85,194,18,297
3145011,6,0,6,71,31,11,113,261,5,379
3145012,0,0,0,33,6,5,44,100,7,151
3145013,3,0,3,54,36,0,90,274,13,377
3145014,4,0,4,44,32,8,84,189,18,291
3145015,0,0,0,66,22,0,88,133,17,238
3145016,4,0,4,121,26,5,152,219,12,383
3145017,0,3,3,87,14,4,105,135,24,264
3145018,4,0,4,47,26,0,73,125,19,217
3145019,6,0,6,60,39,0,99,196,10,305
3145020,4,0,4,40,12,8,60,129,4,193
3145021,0,0,0,95,18,6,119,135,15,269
3145022,3,0,3,92,18,0,110,159,9,278
3145023,0,0,0,56,14,0,70,174,8,252
3145024,4,0,4,73,14,7,94,175,9,278
3145025,4,0,4,85,21,3,109,214,25,348
3145026,3,0,3,64,19,3,86,139,15,240
3145027,3,0,3,123,41,7,171,288,22,481
3145101,7,3,10,33,19,3,55,116,21,192
3145102,0,0,0,28,11,0,39,105,21,165
3145103,4,0,4,47,22,0,69,172,34,275
3145104,3,0,3,68,3,8,79,91,10,180
3145105,0,0,0,45,11,6,62,113,15,190
3145106,3,0,3,59,39,9,107,203,15,325
3145107,0,3,3,30,13,4,47,84,16,147
3145108,0,0,0,73,15,6,94,158,18,270
3145109,0,0,0,81,27,9,117,220,17,354
3145110,0,0,0,22,13,3,38,83,26,147
3145111,3,0,3,50,31,0,81,208,25,314
3145112,0,0,0,33,12,3,48,93,18,159
3145113,3,0,3,48,19,0,67,132,13,212
3145114,4,0,4,73,22,7,102,260,22,384
3145115,0,0,0,86,8,5,99,137,0,236
3145116,3,0,3,54,28,4,86,166,7,259
3145117,0,0,0,44,19,3,66,151,39,256
3145118,3,0,3,21,13,6,40,121,11,172
3145119,3,3,6,30,6,0,36,85,20,141
3145120,4,0,4,62,17,3,82,219,15,316
3145121,3,0,3,40,17,0,57,162,37,256
3145122,3,0,3,59,28,4,91,226,35,352
3145123,0,0,0,36,6,0,42,133,9,184
3145124,0,0,0,56,28,3,87,185,10,282
3145125,4,0,4,50,26,3,79,165,11,255
3145126,0,3,3,33,18,3,54,113,25,192
3145127,0,5,5,107,28,6,141,218,20,379
3145128,3,3,6,25,13,0,38,128,16,182
3145129,0,0,3,47,3,0,50,92,18,160
3145130,0,3,3,34,9,0,43,134,16,193
3145131,0,0,0,26,15,0,41,103,7,151
3145132,8,0,8,94,26,4,124,232,122,478
3145133,0,0,0,52,29,0,81,145,16,242
3145201,4,86,90,46,29,3,78,146,195,419
3145202,22,7,29,202,64,10,276,438,36,750
3145203,7,0,7,67,19,6,92,179,15,286
3145204,0,0,0,62,25,0,87,120,7,214
3145205,0,3,3,58,25,10,93,171,6,270
3145206,0,0,0,97,26,5,128,201,19,348
3145207,0,0,0,81,31,9,121,233,12,366
3145208,6,0,6,46,18,6,70,168,24,262
3145209,6,0,6,54,36,4,94,172,18,284
3145210,4,3,7,42,18,0,60,119,9,188
3145211,4,0,4,68,18,6,92,143,4,239
3145212,6,3,9,62,12,6,80,175,27,282
3145213,0,0,0,88,30,9,127,136,4,267
3145214,0,0,0,72,23,6,101,191,22,314
3145215,3,0,3,55,21,8,84,173,16,273
3145216,7,85,92,29,19,6,54,136,168,358
3145301,0,0,0,51,20,0,71,166,6,243
3145302,3,3,6,49,9,3,61,192,29,282
3145303,9,0,9,71,45,6,122,280,16,418
3145304,5,0,5,56,18,6,80,175,16,271
3145305,5,3,8,48,28,0,76,175,21,272
3145306,8,5,13,62,22,0,84,274,37,395
3145307,4,0,4,52,10,0,62,139,9,210
3145308,8,3,11,58,25,3,86,205,15,306
3145309,5,3,8,54,40,0,94,316,38,448
3145310,7,0,7,66,24,3,93,216,20,329
3145311,6,3,9,34,22,0,56,182,19,257
3145312,0,0,0,53,27,6,86,167,9,262
3145313,5,0,5,75,16,3,94,166,21,281
3145314,4,0,4,45,16,3,64,127,17,208
3145315,4,0,4,65,15,0,80,200,33,313
3145316,7,6,13,79,46,4,129,255,47,431
3145317,3,0,3,80,29,0,109,283,33,425
3145318,4,6,10,48,12,3,63,198,36,297
3145319,5,0,5,28,25,0,53,146,30,229
3145320,7,0,7,86,42,6,134,269,21,424
3145321,0,0,0,28,17,0,45,219,22,286
3145322,3,0,3,38,24,3,65,164,17,246
3145323,11,0,11,78,34,6,118,216,14,348
3145324,6,0,6,59,27,3,89,184,28,301
3145325,3,0,3,53,28,0,81,129,13,223
3145401,9,0,9,50,24,4,78,116,6,200
3145402,0,0,0,32,24,3,59,103,7,169
3145403,3,0,3,31,18,0,49,96,29,174
3145404,3,3,6,69,24,4,97,194,34,325
3145405,6,3,9,95,40,0,135,296,29,460
3145406,4,0,4,65,23,3,91,230,24,345
3145407,5,3,8,74,40,0,114,266,33,413
3145408,0,0,0,73,36,19,128,259,34,421
3145409,0,0,0,66,36,3,105,276,18,399
3145410,8,0,8,82,24,0,106,218,13,337
3145411,3,0,3,51,10,6,67,235,27,329
3145412,3,0,3,52,27,6,85,194,23,302
3145413,3,0,3,55,28,0,83,202,22,307
3145414,6,0,6,38,19,0,57,257,14,328
3145415,0,0,0,31,7,6,44,62,3,109
3145501,8,3,11,62,30,6,98,273,24,395
3145502,3,0,3,140,26,9,175,249,16,440
3145503,34,0,34,53,17,0,70,137,6,213
3145504,8,0,8,65,27,0,92,120,9,221
3145505,7,0,7,45,42,0,87,177,6,270
3145506,5,3,8,35,31,0,66,176,13,255
3145507,9,5,14,84,27,10,121,246,17,384
3145508,3,0,3,40,16,9,65,134,13,212
3145509,6,4,10,74,23,3,100,228,22,350
3145510,15,5,20,71,35,7,113,271,37,421
3145511,6,0,6,37,24,0,61,140,10,211
3145512,9,0,9,87,27,10,124,236,27,387
3145513,4,6,10,71,16,0,87,185,14,286
3145514,5,0,5,51,18,6,75,151,3,229
3145515,10,3,13,47,20,3,70,142,10,222
3145516,4,0,4,55,23,0,78,207,9,294
3145517,4,0,4,57,29,0,86,130,16,232
3145518,3,0,3,71,31,3,105,188,21,314
3145519,3,0,3,65,21,3,89,179,16,284
3145520,0,3,3,78,52,3,133,233,12,378
3145521,0,0,0,3,3,0,6,6,0,12
3145522,3,0,3,52,15,6,73,154,11,238
3145523,6,0,6,53,18,4,75,143,12,230
3145601,6,3,9,63,20,4,87,214,46,347
3145602,4,0,4,42,29,7,78,233,32,343
3145603,8,0,8,28,27,0,55,247,25,327
3145604,0,3,3,64,21,7,92,227,48,367
3145605,6,0,6,15,12,0,27,107,38,172
3145606,75,0,75,30,24,3,57,235,23,315
3145607,3,0,3,85,34,7,126,249,28,403
3145608,0,0,0,45,25,6,76,177,0,253
3145609,5,0,5,64,30,0,94,228,9,331
3145610,10,0,10,60,26,0,86,183,3,272
3145611,4,0,4,74,35,6,115,241,23,379
3145612,8,0,8,53,20,0,73,130,21,224
3145613,0,6,6,57,33,0,90,129,11,230
3145614,6,3,9,51,22,3,76,181,18,275
3145615,6,0,6,36,25,3,64,188,3,255
3145616,9,6,15,30,26,3,59,143,21,223
3145617,7,0,7,61,17,0,78,148,13,239
3145618,7,0,7,64,41,9,114,273,25,412
3145619,4,0,4,60,24,0,84,181,16,281
3145620,3,5,8,51,19,3,73,200,18,291
3145621,0,0,0,40,21,0,61,166,9,236
3145622,13,3,16,66,40,6,112,312,32,456
3145623,7,3,10,67,12,3,82,217,25,324
3145624,9,0,9,78,31,4,113,238,18,369
3145625,5,0,5,71,20,0,91,240,23,354
3145626,4,0,4,54,19,0,73,188,29,290
3145627,7,0,7,53,17,0,70,142,27,239
3145628,3,3,6,61,25,0,86,211,24,321
3145629,56,3,59,61,19,0,80,261,28,369
3145630,7,0,7,58,30,0,88,169,15,272
3145631,12,0,12,53,3,3,59,112,12,183
3145632,7,0,7,68,19,0,87,161,9,257
3145633,3,3,6,49,32,4,85,170,42,297
3145634,6,3,9,70,29,10,109,232,24,365
3145635,0,0,0,46,13,0,59,202,13,274
3145636,0,0,0,25,10,0,35,89,28,152
3145637,3,0,3,18,3,3,24,131,20,175
3145701,11,0,11,104,30,4,138,270,23,431
3145702,0,3,3,73,39,12,124,227,24,375
3145703,22,3,25,40,11,6,57,212,25,294
3145704,3,0,3,39,13,3,55,149,4,208
3145705,6,3,9,66,21,7,94,172,24,290
3145706,11,0,11,87,20,0,107,195,17,319
3145707,6,0,6,33,6,3,42,118,6,166
3145708,6,5,11,63,27,0,90,170,19,279
3145709,9,0,9,71,11,6,88,123,7,218
3145710,3,0,3,53,12,0,65,220,45,330
3145711,5,0,5,25,12,0,37,123,21,181
3145712,7,0,7,56,21,0,77,246,29,352
3145713,28,8,36,39,26,0,65,293,23,381
3145714,4,0,4,38,30,0,68,140,24,232
3145715,9,0,9,26,10,0,36,250,13,299
3145716,6,0,6,53,11,3,67,171,19,257
3145717,9,0,9,67,18,0,85,211,24,320
3145718,4,0,4,86,30,6,122,190,13,325
3145719,6,3,9,72,15,6,93,163,19,275
3145720,3,3,6,63,11,11,85,166,18,269
3145721,5,44,49,41,17,10,68,102,85,255
3145722,14,0,14,86,36,0,122,236,29,387
3145723,4,0,4,82,32,9,123,229,24,376
3145724,0,0,0,37,15,7,59,125,6,190
3145725,0,3,3,78,31,6,115,277,22,414
3145726,3,0,3,3,3,0,6,11,0,17
3145727,12,3,15,72,34,3,109,198,23,330
3145728,0,4,4,20,10,0,30,99,4,133
3145801,3,0,3,63,25,3,91,158,14,263
3145802,55,37,92,112,36,13,161,317,102,580
3145803,3,0,3,48,12,3,63,82,5,150
3145804,0,0,0,83,11,9,103,115,9,227
3145805,27,8,35,31,27,0,58,216,35,309
3145806,0,0,0,74,25,8,107,144,7,258
3145807,3,0,3,177,52,9,238,328,36,602
3145808,0,0,0,100,23,0,123,201,6,330
3145809,3,0,3,40,35,4,79,206,13,298
3145810,3,5,8,74,36,0,110,207,19,336
3145811,0,0,0,74,38,4,116,206,24,346
3145812,3,0,3,167,26,4,197,264,20,481
3145813,3,0,3,56,27,4,87,99,3,189
3145814,3,0,3,169,37,10,216,280,27,523
3145815,6,0,6,272,31,15,318,306,24,648
3145816,5,0,5,90,33,15,138,270,114,522
3145817,4,0,4,58,19,3,80,149,9,238
3145818,3,0,3,42,28,0,70,153,27,250
3145819,4,0,4,64,33,3,100,212,12,324
3145820,0,0,0,68,19,3,90,130,6,226
3145821,0,0,0,20,20,3,43,101,0,144
3145822,0,0,0,48,29,3,80,139,18,237
3145823,0,0,0,41,21,0,62,144,10,216
3145824,0,0,0,110,31,3,144,315,39,498
3145825,3,0,3,55,27,3,85,106,11,202
3145826,0,0,0,71,31,0,102,108,7,217
3145827,0,0,0,0,0,0,0,3,0,3
3145901,4,0,4,31,26,0,57,166,18,241
3145902,0,0,0,52,13,0,65,130,17,212
3145903,0,3,3,36,12,3,51,134,18,203
3145904,3,0,3,57,20,4,81,144,27,252
3145905,4,3,7,59,21,0,80,157,24,261
3145906,7,3,10,66,18,3,87,183,24,294
3145907,5,0,5,42,14,6,62,192,15,269
3145908,36,0,36,62,21,4,87,206,16,309
3145909,3,0,3,36,10,9,55,201,11,267
3145910,0,6,6,55,17,3,75,139,18,232
3145911,0,0,0,25,4,6,35,159,26,220
3145912,7,0,7,45,21,8,74,262,45,381
3145913,6,0,6,49,17,4,70,146,14,230
3145914,0,0,0,76,21,0,97,151,9,257
3145915,0,0,0,41,11,0,52,122,6,180
3145916,9,0,9,63,41,3,107,270,26,403
3145917,9,0,9,37,21,3,61,177,21,259
3145918,5,7,12,84,43,8,135,255,31,421
3145919,18,3,21,3,6,0,9,173,23,205
3145920,0,0,0,59,23,5,87,149,25,261
3145921,0,0,0,38,9,3,50,100,0,150
3145922,0,0,0,3,0,0,3,166,3,172
3145923,3,3,6,101,18,0,119,265,37,421
3145924,6,3,9,81,26,3,110,241,27,378
3145925,0,0,0,75,28,0,103,254,39,396
3145926,3,5,11,55,34,0,89,213,27,329
3145927,0,3,3,53,24,7,84,149,6,239
3145928,0,0,0,0,0,0,0,0,0,0
3145929,4,0,4,31,10,3,44,135,12,191
3145930,3,0,3,74,13,3,90,138,19,247
3145931,3,6,9,90,45,13,148,265,27,440
3145932,3,3,6,50,24,0,74,162,23,259
3145933,5,0,5,39,19,3,61,144,26,231
3145934,3,3,6,69,28,6,103,207,40,350
3145935,6,6,12,75,32,4,111,266,28,405
3145936,14,3,17,40,26,7,73,228,26,327
3145937,12,0,12,56,36,0,92,224,14,330
3146001,8,0,8,59,20,4,83,190,31,304
3146002,7,3,10,49,22,3,74,159,21,254
3146003,6,3,9,68,23,9,100,243,49,392
3146004,16,0,16,76,24,0,100,291,42,433
3146005,8,0,12,76,45,3,124,325,32,481
3146006,18,8,26,59,36,6,101,359,57,517
3146007,0,0,0,37,20,0,57,152,21,230
3146008,5,3,8,24,14,0,38,149,19,206
3146009,74,4,78,73,40,6,119,330,38,487
3146010,7,0,7,33,14,0,47,189,15,251
3146011,16,0,16,62,23,0,85,259,36,380
3146012,0,0,0,86,24,0,110,200,26,336
3146013,0,3,3,43,13,3,59,180,42,281
3146014,6,0,6,58,21,6,85,156,10,251
3146015,6,3,9,51,25,0,76,231,36,343
3146016,10,0,10,78,54,3,135,288,22,445
3146017,6,3,9,96,34,0,130,315,31,476
3146018,0,0,0,69,7,3,79,136,12,227
3146019,0,0,0,41,11,0,52,103,0,155
3146020,4,0,4,49,25,3,77,138,22,237
3146021,0,0,0,51,19,7,77,155,20,252
3146022,0,0,0,43,20,0,63,124,15,202
3146023,0,0,0,46,9,3,58,71,9,138
3146101,6,3,9,51,17,6,74,214,42,330
3146102,4,6,10,74,28,0,102,208,33,343
3146103,11,0,11,39,25,0,64,128,25,217
3146104,6,0,6,90,37,0,127,251,21,399
3146105,0,0,0,38,21,3,62,100,18,180
3146106,0,0,0,84,32,6,122,192,21,335
3146107,3,3,6,52,16,3,71,211,17,299
3146108,0,0,0,46,12,3,61,157,18,236
3146109,0,0,0,61,23,3,87,161,7,255
3146110,3,0,3,41,18,3,62,151,16,229
3146111,3,0,3,32,18,0,50,141,15,206
3146112,0,3,3,50,11,0,61,165,12,238
3146113,0,0,0,78,15,6,99,180,21,300
3146114,0,3,3,31,16,0,47,83,31,161
3146115,0,0,0,67,15,0,82,130,15,227
3146116,0,0,0,26,9,9,44,110,9,163
3146117,5,0,5,55,24,0,79,134,10,223
3146118,0,0,0,45,13,3,61,168,9,238
3146119,0,0,0,60,32,6,98,150,10,258
3146120,0,0,0,55,9,3,67,146,14,227
3146121,9,0,9,51,14,3,68,128,11,207
3146122,0,3,3,34,9,0,43,154,22,219
3146123,6,3,9,55,20,0,75,171,23,269
3146124,53,3,56,49,8,0,57,197,12,266
3146125,7,0,7,91,26,3,120,245,33,398
3146201,3,3,6,42,18,6,66,168,32,266
3146202,0,0,0,24,22,3,49,112,29,190
3146203,3,0,3,62,27,3,92,200,41,333
3146204,0,0,0,45,12,0,57,127,11,195
3146205,22,0,22,66,20,3,89,196,30,315
3146206,0,0,0,11,13,0,24,50,15,89
3146207,39,0,39,69,26,6,101,335,26,462
3146208,0,0,0,88,20,5,113,178,10,301
3146209,3,3,6,79,17,10,106,229,27,362
3146210,3,6,9,21,21,6,48,139,27,214
3146211,0,0,0,16,7,0,23,101,9,133
3146212,6,3,9,34,12,3,49,136,30,215
3146213,3,0,3,45,15,4,64,143,23,230
3146214,0,0,0,34,4,0,38,91,23,152
3146215,8,0,8,39,37,0,76,184,63,323
3146216,6,0,6,55,22,6,83,138,18,239
3146217,6,3,9,35,15,6,56,226,22,304
3146218,11,3,14,68,21,0,89,261,63,413
3146219,6,0,6,56,35,0,91,163,23,277
3146220,0,0,0,47,27,0,74,145,20,239
3146221,21,0,21,80,30,0,110,243,33,386
3146222,0,0,0,77,15,6,98,119,21,238
3146223,4,0,4,27,20,0,47,64,6,117
3146224,0,0,0,74,21,0,95,198,75,368
3146301,6,3,9,50,6,0,56,208,25,289
3146302,3,0,3,37,7,0,44,115,21,180
3146303,3,0,3,97,26,0,123,182,24,329
3146304,6,0,6,36,7,0,43,150,37,230
3146305,0,3,3,127,33,6,166,253,43,462
3146306,3,0,3,72,23,4,99,159,29,287
3146307,0,0,0,28,8,3,39,62,15,116
3146308,0,0,0,64,14,0,78,240,30,348
3146309,0,0,0,33,15,0,48,109,29,186
3146310,3,0,3,36,18,0,54,161,21,236
3146311,0,0,0,101,32,0,133,212,30,375
3146401,6,0,6,44,17,0,61,197,25,283
3146402,5,0,5,47,22,3,72,279,29,380
3146403,8,0,8,65,23,0,88,209,36,333
3146404,17,6,23,42,17,3,62,227,18,307
3146405,35,4,39,73,32,0,105,344,42,491
3146406,0,0,0,33,17,0,50,122,18,190
3146407,15,8,27,59,22,0,81,237,30,348
3146408,15,6,21,38,24,0,62,187,31,280
3146409,11,3,14,83,34,7,124,276,26,426
3146410,7,0,7,29,15,3,47,141,31,219
3146411,10,3,13,45,27,3,75,177,33,285
3146412,0,0,0,21,3,3,27,53,0,80
3146413,3,0,3,11,0,0,11,41,6,58
3146414,28,0,28,26,24,0,50,188,25,263
3146501,44,0,44,39,21,3,63,202,6,271
3146502,4,0,4,45,14,4,63,171,28,262
3146503,3,0,3,54,14,0,68,145,21,234
3146504,4,0,4,62,25,0,87,236,39,362
3146505,8,0,8,51,28,0,79,292,36,407
3146506,9,0,9,27,14,0,41,251,28,320
3146507,3,0,3,24,11,0,35,65,0,100
3146508,3,3,6,43,21,4,68,141,12,221
3146509,4,3,7,32,9,3,44,120,27,191
3146510,4,0,4,79,14,6,99,240,24,363
3146511,0,0,0,3,6,0,9,27,6,42
3146512,6,0,6,53,21,3,77,140,6,223
3146513,0,0,0,58,14,3,75,173,12,260
3146514,3,0,3,92,40,0,132,253,18,403
3146515,3,0,3,74,17,6,97,233,11,341
3146516,0,0,0,72,21,0,93,221,38,352
3146517,0,0,0,48,31,6,85,215,24,324
3146518,3,0,6,60,18,0,78,158,12,248
3146519,8,3,11,46,30,0,76,193,17,286
3146520,3,0,3,61,20,0,81,250,26,357
3146601,3,0,3,365,229,36,630,929,42,1601
3146602,0,0,0,0,0,0,0,0,0,0
3146701,8,0,8,64,31,6,101,248,40,389
3146702,10,0,10,41,22,0,63,182,25,270
3146703,11,4,15,74,21,3,98,346,73,517
3146704,3,0,3,50,13,0,63,180,39,282
3146705,6,6,12,74,30,3,107,239,25,371
3146706,11,3,14,63,25,3,91,206,36,333
3146707,4,0,4,80,22,0,102,196,17,315
3146708,0,0,0,78,25,3,106,258,22,386
3146709,3,0,3,31,14,0,45,106,6,157
3146710,0,0,0,60,33,0,93,167,11,271
3146711,0,0,0,39,20,6,65,122,54,241
3146712,3,4,7,40,8,0,48,121,31,200
3146713,8,0,8,33,26,3,62,184,57,303
3146801,4,0,4,68,32,9,109,216,21,346
3146802,3,0,3,25,21,3,49,132,12,193
3146803,98,0,98,0,0,0,0,228,0,228
3146804,0,0,0,40,26,0,66,162,16,244
3146805,0,0,0,37,24,3,64,128,18,210
3146806,0,0,0,60,15,3,78,128,0,206
3146807,0,0,0,47,27,0,74,139,6,219
3146808,3,0,3,52,34,0,86,215,12,313
3146809,0,6,6,97,27,3,127,293,16,436
3146810,0,0,0,93,10,6,109,122,6,237
3146811,0,0,0,7,8,0,15,453,24,492
3146812,0,0,0,99,18,10,127,176,27,330
3146813,0,0,0,39,16,9,64,122,6,192
3146814,0,0,0,0,0,0,0,0,0,0
3146815,0,0,0,106,19,7,132,167,25,324
3146816,0,0,0,65,13,6,84,113,9,206
3146817,0,0,0,88,15,3,106,147,10,263
3146818,3,0,3,74,10,3,87,151,19,257
3146819,3,0,3,55,13,6,74,161,9,244
3146820,0,0,0,87,31,5,123,245,15,383
3146821,0,0,0,66,7,0,73,98,6,177
3146822,0,0,0,113,37,3,153,162,15,330
3146823,0,0,0,50,20,6,76,117,9,202
3146824,0,0,0,77,27,0,104,218,34,356
3146825,3,0,3,53,18,6,77,145,7,229
3146826,0,0,0,43,9,4,56,119,4,179
3146827,5,0,5,86,19,3,108,186,8,302
3146828,6,0,6,74,21,12,107,203,15,325
3146901,4,3,7,62,23,0,85,167,22,274
3146902,0,0,0,68,13,6,87,188,32,307
3146903,4,0,4,72,19,5,96,192,18,306
3146904,8,0,8,50,11,6,67,305,50,422
3146905,115,25,140,48,18,0,66,354,63,483
3146906,3,0,3,64,28,3,95,187,29,311
3146907,3,3,6,67,23,0,90,240,28,358
3146908,58,4,62,4,0,0,4,149,4,157
3146909,0,0,0,53,18,3,74,173,12,259
3147001,0,0,0,54,19,3,76,157,13,246
3147002,0,0,0,86,22,0,108,165,15,288
3147003,3,0,3,117,35,0,152,320,22,494
3147004,3,0,3,77,24,0,101,248,14,363
3147005,0,0,0,6,0,0,6,83,16,105
3147006,4,0,4,150,35,12,197,281,50,528
3147007,0,0,0,60,16,4,80,92,10,182
3147008,0,0,0,70,31,3,104,216,31,351
3147009,0,0,0,186,33,11,230,228,25,483
3147010,0,0,0,167,28,6,201,267,36,504
3147011,0,0,0,181,29,10,220,243,16,479
3147101,0,0,0,89,29,0,118,187,44,349
3147102,3,0,3,58,19,0,77,136,26,239
3147103,0,0,0,111,27,6,144,175,49,368
3147104,4,0,4,40,24,5,69,185,25,279
3147105,0,0,0,41,19,0,60,111,15,186
3147106,0,0,0,100,31,9,140,132,0,272
3147107,0,0,0,67,36,0,103,149,15,267
3147108,0,0,0,39,11,3,53,133,6,192
3147109,0,0,0,68,32,4,104,158,9,271
3147110,0,0,0,51,17,6,74,152,14,240
3147111,0,0,0,101,29,4,134,185,6,325
3147112,0,0,0,113,29,0,142,204,34,380
3147113,0,0,0,86,34,4,124,174,21,319
3147114,15,3,18,73,31,7,111,237,33,381
3147115,0,0,0,64,14,0,78,103,21,202
3147116,58,4,62,14,41,0,55,610,72,737
3147117,0,0,0,73,20,3,96,121,16,233
3147118,0,0,0,61,25,3,89,199,21,309
3147119,0,0,0,7,6,0,13,41,10,64
3147120,3,0,3,65,23,4,92,187,13,292
3147121,0,0,0,84,20,0,104,195,37,336
3147122,0,0,0,35,8,6,49,53,6,108
3147123,3,0,3,84,47,5,136,242,18,396
3147124,0,0,0,0,0,0,0,0,0,0
3147125,0,0,0,70,33,4,107,130,15,252
3147126,0,0,0,48,21,0,69,100,21,190
3147127,3,0,3,53,15,6,74,154,15,243
3147128,0,0,0,36,21,3,60,80,12,152
3147129,3,0,3,67,13,4,84,144,3,231
3147201,3,0,3,73,38,3,114,242,21,377
3147202,22,3,25,36,22,6,64,232,37,333
3147203,5,0,5,69,30,4,103,232,54,389
3147204,3,0,3,34,22,3,59,154,24,237
3147205,3,0,3,39,18,5,62,139,12,213
3147206,3,0,3,38,22,0,60,153,10,223
3147207,5,0,5,81,33,10,124,238,16,378
3147208,0,0,0,46,29,0,75,189,9,273
3147209,6,0,6,53,27,3,83,219,21,323
3147210,0,0,0,68,17,12,97,189,30,316
3147211,0,3,3,39,26,3,68,145,26,239
3147212,3,0,3,24,21,0,45,98,41,184
3147213,6,0,6,63,20,0,83,223,40,346
3147214,26,6,32,48,31,6,85,317,102,504
3147215,6,0,6,52,33,3,88,175,9,272
3147216,9,0,12,55,43,0,98,231,11,340
3147301,0,0,0,99,17,6,122,123,27,272
3147302,0,0,0,113,15,6,134,146,22,302
3147303,0,0,0,185,31,6,222,308,88,618
3147304,3,0,3,87,28,11,126,245,27,398
3147305,0,0,0,93,29,3,125,181,27,333
3147306,6,0,6,102,28,7,137,266,29,432
3147307,0,0,0,197,28,4,229,339,35,603
3147308,0,0,0,103,25,3,131,187,18,336
3147309,3,0,3,93,34,10,137,182,47,366
3147310,0,0,0,57,9,3,69,100,20,189
3147311,3,0,3,95,24,0,119,186,43,348
3147312,0,0,0,154,33,6,193,179,74,446
3147313,3,0,3,74,43,0,117,222,47,386
3147314,3,0,3,117,22,0,139,177,45,361
3147315,0,0,0,121,49,0,170,274,35,479
3147316,0,0,0,70,29,3,102,198,28,328
3147317,0,0,0,0,3,0,3,17,0,20
3147318,0,0,0,82,35,9,126,196,39,361
3147319,0,0,0,80,17,0,97,153,21,271
3147320,0,0,0,214,39,12,265,390,55,710
3147321,0,0,0,82,17,4,103,115,15,233
3147322,0,0,0,96,20,0,116,167,23,306
3147323,0,0,0,103,35,6,144,201,28,373
3147324,0,3,3,53,23,0,76,121,23,220
3147325,0,0,0,126,23,9,158,142,18,318
3147326,0,0,0,82,20,6,108,233,17,358
3147327,0,0,0,40,16,9,65,118,22,205
3147328,4,0,4,64,31,0,95,205,30,330
3147329,0,0,0,52,43,9,104,153,24,281
3147330,3,0,3,201,34,6,241,292,34,567
3147331,0,0,0,104,26,9,139,168,30,337
3147401,3,0,3,41,11,5,57,123,11,191
3147402,0,0,0,95,28,3,126,260,47,433
3147403,0,0,0,82,32,0,114,191,29,334
3147404,0,0,0,68,9,0,77,122,14,213
3147405,0,0,0,81,31,8,120,227,18,365
3147406,0,0,0,107,33,7,147,354,31,532
3147407,0,0,0,41,12,12,65,181,35,281
3147408,3,0,3,162,27,4,193,300,33,526
3147409,0,0,0,98,16,3,117,401,53,571
3147410,0,0,0,71,14,0,85,161,15,261
3147411,0,0,0,3,21,0,24,772,36,832
3147412,0,0,0,86,28,0,114,252,29,395
3147413,0,8,8,7,0,0,7,80,44,131
3147414,3,0,3,65,47,4,116,330,19,465
3147415,0,0,0,24,0,0,24,51,10,85
3147416,0,0,0,70,20,6,96,199,6,301
3147417,0,0,0,0,0,0,0,6,0,6
3147501,6,3,9,51,34,0,85,219,38,342
3147502,0,0,0,42,16,4,62,158,37,257
3147503,3,0,3,59,23,0,82,338,60,480
3147504,3,0,3,57,27,9,93,198,18,309
3147505,4,3,7,47,24,3,74,287,34,395
3147506,0,3,3,65,24,5,94,271,84,449
3147507,0,0,0,39,7,6,52,184,55,291
3147508,0,0,0,35,20,0,55,146,13,214
3147509,0,0,0,40,18,0,58,165,31,254
3147510,0,0,0,0,3,0,3,34,25,62
3147511,6,0,6,38,30,3,71,208,19,298
3147512,12,0,12,70,23,0,93,251,38,382
3147513,3,6,9,69,29,0,98,266,81,445
3147514,0,0,0,6,9,0,15,60,0,75
3147515,12,0,12,43,27,3,73,244,82,399
3147516,0,3,6,80,33,0,113,340,57,510
3147517,6,0,6,64,23,0,87,322,52,461
3147601,8,3,11,52,20,6,78,158,22,258
3147602,3,0,3,36,12,3,51,219,36,306
3147603,6,6,12,48,21,6,75,184,56,315
3147604,11,3,14,68,26,6,100,323,52,475
3147605,3,0,3,63,27,3,93,179,29,301
3147606,9,4,13,56,22,0,78,178,23,279
3147607,0,0,0,75,31,3,109,293,36,438
3147608,3,3,6,32,26,0,58,161,32,251
3147609,4,0,4,42,20,9,71,178,20,269
3147610,13,0,13,41,30,3,74,171,15,260
3147611,0,0,0,45,19,4,68,126,20,214
3147612,0,0,0,67,27,7,101,175,41,317
3147613,0,0,0,85,20,10,115,179,27,321
3147614,0,0,0,92,26,4,122,169,40,331
3147615,0,0,0,29,15,0,44,99,21,164
3147616,0,0,0,61,31,3,95,174,28,297
3147617,9,0,9,57,17,0,74,123,17,214
3147618,12,3,15,75,32,0,107,287,30,424
3147619,0,0,0,65,38,0,103,263,44,410
3147620,5,0,5,31,23,0,54,199,37,290
3147621,0,0,0,69,21,7,97,196,20,313
3147701,7,0,7,78,38,0,116,195,7,318
3147702,0,4,4,43,22,3,68,159,23,250
3147703,5,0,5,77,46,6,129,248,26,403
3147704,0,0,0,69,19,3,91,171,19,281
3147705,0,0,0,71,38,3,112,182,22,316
3147706,0,4,4,54,28,7,89,265,38,392
3147707,3,0,6,37,26,6,69,194,12,275
3147708,16,24,40,42,21,0,63,200,83,346
3147709,0,0,0,61,27,9,97,147,18,262
3147710,0,0,0,55,16,3,74,106,30,210
3147711,0,0,0,68,18,3,89,131,17,237
3147801,3,3,6,35,19,3,57,158,24,239
3147802,3,0,3,34,14,3,51,122,30,203
3147803,7,3,10,31,17,0,48,174,29,251
3147804,4,0,4,36,15,0,51,278,27,356
3147805,0,3,3,62,22,3,87,262,32,381
3147806,3,0,3,24,12,0,36,129,13,178
3147807,0,0,0,0,0,0,0,0,0,0
3147808,0,0,0,35,26,3,64,248,28,340
3147809,0,0,0,48,18,0,66,159,24,249
3147810,6,0,6,55,22,0,77,146,11,234
3147811,4,0,4,44,21,6,71,209,37,317
3147812,0,4,4,102,28,8,138,330,47,515
3147813,6,0,6,67,24,4,95,249,32,376
3147814,4,0,4,62,21,9,92,210,9,311
3147815,4,0,4,55,20,0,75,242,69,386
3147901,30,0,33,51,20,3,74,265,39,378
3147902,0,0,0,33,15,0,48,173,23,244
3147903,9,4,13,67,20,10,97,274,37,408
3147904,8,0,8,54,21,0,75,239,27,341
3147905,6,3,9,82,23,3,108,285,41,434
3147906,3,0,3,79,37,9,125,233,31,389
3147907,9,0,12,54,18,3,75,197,16,288
3147908,3,0,6,39,23,10,72,131,10,213
3147909,7,0,7,97,25,9,131,323,30,484
3147910,3,0,3,50,38,3,91,230,26,347
3147911,9,0,9,96,19,12,127,315,49,491
3148001,0,0,0,64,17,0,81,148,33,262
3148002,0,0,0,89,31,4,124,139,16,279
3148003,0,0,0,111,26,10,147,297,29,473
3148004,3,3,6,114,33,9,156,233,27,416
3148005,0,0,0,62,22,3,87,101,15,203
3148006,0,0,0,10,0,0,10,26,0,36
3148007,3,0,3,45,10,4,59,119,4,182
3148008,0,0,0,65,19,0,84,140,30,254
3148009,0,0,0,65,13,10,88,119,15,222
3148010,0,0,3,127,28,7,162,323,44,529
3148011,3,0,3,95,37,9,141,322,47,510
3148012,0,0,0,144,35,5,184,177,14,375
3148013,0,0,0,71,28,7,106,206,26,338
3148014,0,0,0,108,18,6,132,190,24,346
3148015,0,0,0,86,21,6,113,219,15,347
3148016,0,0,0,93,33,0,126,197,23,346
3148017,0,0,0,90,26,0,116,236,27,379
3148018,3,0,3,95,41,3,139,215,24,378
3148019,0,0,0,61,20,3,84,121,13,218
3148020,3,0,3,145,41,0,186,274,65,525
3148021,3,0,3,103,21,0,124,137,16,277
3148022,0,0,0,68,35,0,103,184,22,309
3148023,3,0,3,66,21,0,87,124,27,238
3148101,0,3,3,47,41,0,88,187,35,310
3148102,0,0,0,84,33,3,120,196,33,349
3148103,0,3,3,59,34,0,93,260,24,377
3148104,11,3,14,60,35,0,95,210,26,331
3148105,0,0,0,83,35,0,118,231,23,372
3148106,4,0,4,74,25,4,103,157,13,273
3148107,6,0,6,40,23,4,67,124,25,216
3148108,6,0,6,91,31,0,122,229,17,368
3148109,0,0,0,52,22,5,79,153,23,255
3148110,0,0,0,47,18,0,65,134,15,214
3148111,0,0,0,34,24,3,61,160,15,236
3148112,3,0,3,63,29,3,95,183,21,299
3148113,0,0,0,45,30,0,75,146,24,245
3148114,0,0,0,62,21,6,89,136,15,240
3148115,3,0,3,29,28,0,57,101,26,184
3148116,6,0,6,38,18,4,60,149,24,233
3148117,3,0,3,44,28,4,76,154,17,247
3148118,3,0,3,55,21,3,79,185,18,282
3148119,0,0,0,51,24,0,75,190,3,268
3148120,81,4,85,11,9,0,20,205,10,235
3148121,0,0,0,34,12,0,46,131,9,186
3148122,0,0,0,43,9,3,55,104,24,183
3148123,0,0,0,26,15,0,41,76,23,140
3148124,0,0,0,74,42,3,119,240,54,413
3148201,0,0,0,58,23,4,85,128,23,236
3148202,0,0,0,61,15,9,85,144,10,239
3148203,0,0,0,125,28,3,156,226,15,397
3148204,0,0,0,60,16,0,76,115,3,194
3148205,4,0,4,50,22,6,78,149,7,234
3148206,0,0,0,61,25,6,92,183,10,285
3148207,0,0,0,111,45,9,165,275,16,456
3148208,3,0,3,86,23,9,118,200,30,348
3148209,0,0,0,51,13,3,67,116,11,194
3148210,0,3,3,154,31,8,193,259,48,500
3148211,0,0,0,77,16,3,96,110,7,213
3148212,13,0,13,36,4,4,44,197,15,256
3148213,3,0,3,44,13,3,60,92,14,166
3148214,4,0,4,96,33,3,132,252,21,405
3148215,4,0,4,49,16,0,65,177,12,254
3148216,0,0,0,51,19,6,76,116,6,198
3148217,0,0,0,62,18,3,83,177,6,266
3148218,0,0,0,57,31,0,88,142,20,250
3148219,0,0,0,50,22,6,78,122,21,221
3148220,0,0,0,61,24,0,85,108,9,202
3148221,0,0,0,42,21,3,66,149,4,219
3148222,5,0,5,55,30,0,85,210,16,311
3148223,3,3,6,76,44,6,126,237,33,396
3148224,0,0,0,46,15,3,64,166,10,240
3148225,4,0,4,89,37,3,129,199,18,346
3148226,0,0,0,64,25,6,95,227,18,340
3148227,0,0,0,53,27,3,83,95,3,181
3148228,0,0,0,41,29,6,76,147,4,227
3148229,0,0,0,32,3,0,35,53,3,91
3148230,0,0,0,0,0,0,0,0,0,0
3148231,4,0,4,79,6,6,91,108,10,209
3148232,0,0,0,112,34,11,157,317,29,503
3148233,0,0,0,67,31,3,101,152,19,272
3148234,0,0,0,40,22,3,65,102,21,188
3148235,0,0,0,93,23,3,119,207,12,338
3148236,0,0,0,73,23,6,102,164,15,281
3148237,0,0,0,77,17,9,103,137,13,253
3148238,0,0,0,75,13,4,92,131,18,241
3148239,0,0,0,75,29,9,113,187,18,318
3148240,0,0,0,51,3,0,54,112,9,175
3148241,3,0,3,99,19,0,118,169,25,312
3148242,3,0,3,166,23,0,189,165,23,377
3148243,0,0,0,82,15,3,100,207,21,328
3148244,0,0,0,69,22,0,91,177,11,279
3148301,6,0,6,45,6,6,57,201,12,270
3148302,3,3,6,52,27,8,87,217,24,328
3148303,0,0,0,31,23,10,64,197,28,289
3148304,3,3,6,37,24,0,61,178,50,289
3148305,0,0,0,0,6,0,6,28,0,34
3148306,3,0,3,73,3,14,90,242,22,354
3148307,0,0,0,13,5,6,24,66,6,96
3148308,4,0,4,19,18,3,40,150,22,212
3148401,6,0,6,93,38,6,137,225,17,379
3148402,4,0,4,97,43,0,140,312,29,481
3148403,0,0,0,62,28,6,96,219,14,329
3148404,0,0,0,57,33,10,100,185,10,295
3148405,0,0,0,58,25,0,83,178,9,270
3148406,0,0,0,128,42,12,182,374,32,588
3148407,0,0,0,0,0,0,0,0,0,0
3148408,0,0,0,75,37,0,112,207,44,363
3148409,0,0,0,91,21,0,112,156,15,283
3148410,0,0,0,124,27,3,154,238,32,424
3148411,0,0,0,108,26,8,142,170,19,331
3148412,0,0,0,84,10,0,94,116,13,223
3148413,6,0,6,112,21,10,143,197,20,360
3148414,3,0,3,176,34,3,213,401,37,651
3148415,0,0,0,70,7,0,77,108,9,194
3148416,0,0,0,13,13,0,26,92,24,142
3148417,4,0,4,209,50,3,262,391,29,682
3148501,0,6,6,38,17,0,55,132,18,205
3148502,3,0,3,42,17,6,65,209,22,296
3148503,7,0,7,73,18,0,91,195,25,311
3148504,97,57,154,41,27,6,74,336,120,530
3148505,10,4,14,56,35,0,91,222,35,348
3148506,6,3,9,43,12,0,55,125,17,197
3148507,8,0,8,68,34,0,102,246,24,372
3148508,8,0,8,44,15,6,65,177,16,258
3148509,5,0,5,26,18,0,44,148,36,228
3148510,0,0,0,76,37,7,120,299,55,474
3148601,3,0,3,57,34,4,95,288,26,409
3148602,0,4,4,46,31,0,77,192,50,319
3148603,3,0,3,54,30,6,90,212,34,336
3148604,0,0,0,66,45,0,111,221,41,373
3148605,0,0,0,39,12,0,51,109,6,166
3148606,3,4,7,32,23,0,55,226,46,327
3148607,0,3,3,29,26,0,55,176,18,249
3148608,0,0,0,85,33,12,130,294,25,449
3148609,3,0,3,69,21,0,90,239,32,361
3148610,0,0,0,27,15,3,45,183,24,252
3148611,0,0,0,41,22,3,66,210,56,332
3148612,3,0,3,167,31,16,214,396,82,692
3148613,0,0,0,15,0,0,15,73,10,98
3148614,0,0,0,34,21,6,61,161,16,238
3148615,0,3,3,91,22,3,116,197,41,354
3148701,0,0,0,66,35,0,101,262,47,410
3148702,4,4,8,26,23,3,52,145,30,227
3148703,0,3,3,51,27,3,81,115,23,219
3148704,3,0,3,35,16,0,51,133,38,222
3148705,0,0,0,129,16,3,148,213,16,377
3148706,0,0,0,97,24,9,130,186,39,355
3148707,0,0,0,70,19,0,89,169,9,267
3148708,0,3,3,159,37,10,206,424,52,682
3148709,0,0,0,238,51,11,300,339,27,666
3148710,0,0,0,81,19,3,103,155,11,269
3148711,0,0,0,0,0,0,0,0,0,0
3148712,0,0,0,40,22,0,62,166,49,277
3148801,9,0,9,77,19,3,99,321,40,460
3148802,3,3,6,44,20,6,70,202,24,296
3148803,4,0,4,50,18,3,71,231,33,335
3148804,0,0,0,0,0,0,0,0,0,0
3148805,0,0,0,0,0,0,0,3,17,20
3148806,0,0,0,0,0,0,0,0,0,0
3148807,0,4,4,56,36,0,92,232,37,361
3148808,3,0,3,63,19,0,82,247,24,353
3148809,4,0,4,48,17,0,65,200,17,282
3148810,3,0,3,53,21,7,81,224,28,333
3148811,3,0,3,70,20,0,90,240,12,342
3148812,6,0,6,39,18,6,63,122,6,191
3148813,6,0,6,74,28,0,102,190,24,316
3148814,6,3,9,46,14,4,64,131,21,216
3148815,3,0,3,12,18,7,37,232,47,316
3148816,3,3,6,28,20,3,51,367,77,495
3148901,0,0,0,76,26,0,102,177,44,323
3148902,0,0,0,81,20,6,107,236,24,367
3148903,0,0,0,51,4,0,55,174,24,253
3148904,0,0,0,0,0,0,0,0,0,0
3148905,0,0,0,60,23,6,89,210,12,311
3148906,0,0,0,55,15,7,77,198,12,287
3148907,0,0,0,42,9,3,54,118,18,190
3148908,0,0,0,39,15,3,57,201,16,274
3148909,0,0,0,74,17,4,95,209,12,316
3148910,0,0,0,52,21,3,76,118,24,218
3148911,3,0,3,27,26,3,56,156,14,226
3148912,0,0,0,23,9,3,35,51,9,95
3148913,4,0,4,55,23,0,78,275,32,385
3149001,0,0,0,93,35,0,128,331,28,487
3149002,3,0,3,67,27,0,94,241,24,359
3149003,0,0,0,44,22,0,66,332,54,452
3149004,9,0,9,74,37,6,117,418,98,633
3149005,3,0,3,35,19,0,54,302,53,409
3149006,8,0,8,96,45,0,141,401,68,610
3149007,3,3,6,48,23,0,71,217,51,339
3149008,3,0,3,23,21,0,44,222,59,325
3149009,0,0,0,36,24,0,60,255,53,368
3149010,3,3,6,24,16,4,44,191,101,336
3149011,6,3,9,73,35,0,108,503,110,721
3149012,0,0,0,19,9,3,31,253,23,307
3149013,0,0,0,24,3,3,30,133,30,193
3149014,0,0,0,20,9,0,29,239,65,333
3149015,0,0,0,0,0,0,0,0,0,0
3149016,6,0,6,69,16,3,88,243,35,366
3149017,6,3,9,61,28,0,89,297,40,426
3149018,4,0,4,52,39,3,94,286,66,446
3149019,6,0,6,57,25,0,82,258,49,389
3149101,0,0,0,3,0,3,6,0,565,571
3149102,3,0,3,73,24,4,101,177,15,293
3149103,3,0,3,42,22,3,67,216,17,300
3149104,9,3,12,23,27,0,50,165,23,238
3149105,3,0,3,46,11,4,61,124,13,198
3149106,6,3,9,44,24,3,71,157,31,259
3149107,0,5,5,69,22,8,99,171,27,297
3149108,0,0,0,71,30,9,110,198,26,334
3149109,3,0,3,82,38,6,126,275,59,460
3149110,3,0,3,72,25,0,97,304,29,430
3149111,0,0,0,74,25,4,103,220,19,342
3149112,0,0,0,46,23,0,69,207,13,289
3149113,0,0,0,38,18,3,59,137,24,220
3149114,0,0,0,20,6,3,29,88,66,183
3149115,0,0,0,35,21,0,56,92,20,168
3149116,0,0,0,0,3,0,3,4,0,7
3149117,5,0,5,33,19,0,52,136,9,197
3149118,4,0,4,34,24,0,58,131,13,202
3149201,7,3,10,66,28,9,103,276,25,404
3149202,11,0,11,52,28,12,92,251,38,381
3149203,6,3,9,36,24,6,66,147,18,231
3149204,6,0,6,56,18,0,74,239,26,339
3149205,45,50,95,72,27,3,102,285,120,507
3149206,6,0,6,45,21,4,70,210,13,293
3149207,6,0,6,83,29,9,121,230,17,368
3149208,6,0,6,83,25,0,108,219,24,351
3149209,4,0,4,44,19,4,67,170,10,247
3149210,6,6,12,43,30,6,79,206,20,305
3149211,9,0,9,34,9,7,50,126,11,187
3149212,6,0,6,84,19,12,115,193,16,324
3149301,6,0,6,111,30,14,155,317,26,498
3149302,3,0,3,50,30,0,80,237,30,347
3149303,3,0,3,36,4,0,40,107,10,157
3149304,0,3,3,38,29,0,67,125,27,219
3149305,0,0,0,30,8,0,38,142,14,194
3149306,6,3,9,121,36,6,163,330,39,532
3149307,6,0,6,56,29,3,88,162,15,265
3149308,0,0,0,83,25,3,111,197,5,313
3149309,3,0,3,145,27,7,179,298,15,492
3149310,3,0,3,79,22,3,104,246,30,380
3149311,6,0,6,50,5,0,55,154,8,217
3149312,6,0,6,32,14,3,49,167,22,238
3149313,3,0,3,16,3,0,19,148,13,180
3149314,0,0,0,96,31,0,127,297,21,445
3149315,4,0,4,72,25,0,97,229,20,346
3149316,3,0,3,74,31,3,108,275,37,420
3149317,6,0,6,33,19,9,61,195,3,259
3149318,5,0,5,45,21,0,66,237,30,333
3149319,0,3,3,40,26,0,66,277,37,380
3149320,6,0,6,71,19,6,96,303,37,436
3149321,7,0,7,69,28,3,100,210,41,351
3149322,10,0,10,168,64,10,242,426,27,695
3149323,7,0,7,60,28,0,88,195,26,309
3149324,5,0,5,61,30,12,103,391,87,581
3149325,8,3,11,82,31,6,119,363,43,525
3149326,3,0,3,93,30,6,129,296,31,456
3149327,0,0,0,81,11,12,104,238,20,362
3149328,4,0,4,124,30,0,154,214,25,393
3149329,0,0,0,60,23,0,83,120,9,212
3149330,0,0,0,84,21,7,112,189,15,316
3149331,3,0,3,95,25,9,129,286,15,430
3149332,3,0,3,64,3,0,67,96,8,171
3149333,0,0,0,109,18,0,127,218,27,372
3149334,46,10,56,28,16,0,44,411,31,486
3149401,8,0,8,129,34,0,163,296,34,493
3149402,5,0,5,84,27,0,111,286,29,426
3149403,3,0,3,63,21,6,90,206,25,321
3149404,3,0,3,79,48,6,133,262,16,411
3149405,4,0,4,42,18,3,63,148,15,226
3149406,0,0,0,85,28,6,119,198,18,335
3149407,0,0,0,106,31,9,146,262,20,428
3149408,0,0,0,34,15,3,52,120,3,175
3149409,4,0,4,36,13,0,49,206,31,286
3149501,7,5,12,43,26,9,78,222,29,329
3149502,4,0,4,58,16,0,74,209,32,315
3149503,0,3,3,41,24,0,65,122,54,241
3149504,6,0,6,12,6,0,18,175,18,211
3149505,3,0,3,16,13,0,29,139,30,198
3149506,0,4,4,55,15,0,70,169,21,260
3149507,6,14,20,42,22,0,64,205,56,325
3149508,12,6,18,48,14,0,62,228,24,314
3149509,9,3,12,62,36,4,102,261,21,384
3149510,9,0,9,59,20,3,82,286,25,393
3149511,4,0,4,45,22,3,70,140,14,224
3149512,7,0,7,57,23,6,86,176,32,294
3149513,0,3,3,59,18,0,77,214,38,329
3149514,5,3,8,92,34,6,132,267,67,466
3149515,14,6,20,45,25,3,73,277,53,403
3149516,0,0,0,33,6,0,39,153,13,205
3149517,6,3,9,22,15,0,37,164,26,227
3149601,4,5,9,16,7,0,23,119,11,153
3149602,3,0,7,99,31,7,137,244,16,397
3149603,4,0,4,52,21,3,76,187,27,290
3149604,0,0,0,76,19,9,104,201,20,325
3149605,0,0,0,47,11,0,58,110,9,177
3149606,18,25,43,123,41,8,172,265,65,502
3149607,0,0,0,50,10,0,60,181,22,263
3149608,4,0,4,107,23,3,133,211,28,372
3149609,3,0,3,89,28,9,126,233,19,378
3149610,3,0,3,27,9,0,36,113,27,176
3149611,0,4,4,59,35,9,103,201,19,323
3149612,29,14,43,72,36,3,111,324,76,511
3149613,0,3,3,28,9,0,37,87,31,155
3149701,0,0,0,46,23,0,69,144,12,225
3149702,0,0,0,33,18,0,51,132,9,192
3149703,89,9,98,46,21,6,73,371,53,497
3149704,3,7,10,54,31,0,85,153,17,255
3149705,28,6,34,3,17,0,20,407,31,458
3149706,0,3,3,63,33,0,96,140,18,254
3149707,0,0,0,46,34,3,83,196,20,299
3149708,6,3,9,27,11,0,38,133,35,206
3149709,5,3,8,78,32,3,113,303,57,473
3149710,3,0,3,28,16,0,44,127,15,186
3149711,6,3,9,63,16,0,79,178,48,305
3149712,0,0,0,40,11,3,54,156,34,244
3149713,4,0,4,39,9,3,51,135,39,225
3149714,0,0,0,58,22,4,84,184,43,311
3149715,3,4,7,27,23,0,50,236,19,305
3149716,0,0,0,38,7,0,45,101,18,164
3149717,0,0,0,65,17,6,88,190,3,281
3149718,4,0,4,29,15,0,44,98,12,154
3149719,3,0,3,41,12,3,56,103,3,162
3149720,3,0,3,46,10,0,56,147,28,231
3149721,10,6,16,45,15,3,63,173,35,271
3149722,3,3,6,63,15,3,81,173,24,278
3149801,4,0,4,79,16,0,95,214,18,327
3149802,5,0,5,103,27,3,133,357,27,517
3149803,0,0,0,36,6,3,45,188,15,248
3149804,0,0,0,38,15,3,56,192,48,296
3149805,6,0,6,47,22,0,69,180,27,276
3149806,0,0,0,53,5,0,58,156,12,226
3149807,3,0,3,24,10,0,34,94,9,137
3149808,0,0,0,72,17,0,89,207,21,317
3149809,3,0,3,68,30,0,98,247,23,368
3149810,0,0,0,48,13,0,61,156,23,240
3149811,3,0,3,59,18,0,77,129,9,215
3149812,0,0,0,21,3,3,27,81,16,124
3149813,3,0,3,72,27,4,103,244,39,386
3149814,5,0,5,68,28,6,102,285,40,427
3149815,3,0,3,55,9,3,67,225,21,313
3149816,0,0,0,24,6,6,36,146,24,206
3149817,0,0,0,42,19,3,64,258,36,358
3149818,6,3,9,70,15,7,92,282,23,397
3149819,3,0,3,63,17,0,80,233,35,348
3149820,0,0,0,64,15,3,82,200,17,299
3149821,0,0,0,47,18,0,65,130,6,201
3149822,0,0,0,59,17,3,79,156,31,266
3149901,3,0,3,37,9,0,46,149,18,213
3149902,0,0,0,75,17,0,92,196,17,305
3149903,0,0,0,55,19,0,74,157,16,247
3149904,0,0,0,41,20,9,70,198,28,296
3149905,5,4,9,61,22,0,83,295,36,414
3149906,0,0,0,69,18,3,90,183,26,299
3149907,0,0,0,75,9,4,88,378,41,507
3149908,3,3,6,38,15,3,56,115,22,193
3149909,0,0,0,39,9,6,54,153,24,231
3149910,4,0,4,71,24,0,95,284,36,415
3149911,0,0,0,49,5,3,57,182,22,261
3149912,0,0,0,40,10,3,53,198,15,266
3149913,6,0,6,32,10,0,42,256,13,311
3149914,0,0,0,23,11,0,34,241,15,290
3149915,4,0,4,15,22,0,37,222,9,268
3149916,0,0,0,26,22,3,51,89,12,152
3149917,3,0,3,27,18,0,45,274,49,368
3149918,0,0,0,0,0,0,0,0,0,0
3149919,3,0,3,70,30,6,106,190,8,304
3149920,3,0,3,43,12,3,58,181,19,258
3149921,0,0,0,25,11,0,36,146,15,197
3149922,3,0,3,48,13,6,67,232,27,326
3149923,0,0,0,52,14,0,66,144,21,231
3149924,6,3,9,32,12,0,44,123,24,191
3149925,0,8,8,26,15,0,41,141,46,228
3149926,11,25,36,20,21,3,44,188,68,300
3149927,6,0,6,49,12,4,65,172,24,261
3149928,0,0,0,35,20,0,55,100,15,170
3149929,0,0,0,25,3,0,28,57,6,91
3149930,3,0,3,25,18,0,43,120,24,187
3150001,7,3,10,38,10,5,53,142,20,215
3150002,61,42,103,20,6,6,32,200,93,325
3150003,30,13,43,3,0,0,3,106,39,148
3150004,6,0,6,69,36,0,105,246,9,360
3150005,0,0,0,73,26,5,104,152,7,263
3150006,3,0,3,97,30,6,133,240,27,400
3150007,10,6,16,80,20,0,100,250,29,379
3150008,0,0,0,54,18,3,75,122,9,206
3150009,3,0,3,62,22,0,84,216,22,322
3150010,0,0,0,70,16,0,86,154,22,262
3150011,3,0,3,39,18,0,57,127,28,212
3150012,6,0,6,65,24,4,93,304,35,432
3150013,3,0,3,28,4,5,37,106,18,161
3150014,6,3,9,44,29,3,76,232,22,330
3150015,5,0,5,47,29,0,76,199,24,299
3150016,0,0,0,0,0,0,0,0,0,0
3150017,0,0,0,110,24,7,141,333,28,502
3150018,0,0,0,73,35,6,114,204,31,349
3150019,0,0,0,85,14,0,99,184,19,302
3150020,0,0,0,4,0,0,4,9,3,16
3150021,0,0,0,45,18,3,66,120,8,194
3150022,109,25,134,6,10,0,16,406,84,506
3150101,12,7,19,74,29,4,107,240,47,394
3150102,6,0,6,41,25,6,72,216,27,315
3150103,11,0,11,52,41,6,99,233,32,364
3150104,3,6,9,32,15,3,50,142,28,220
3150105,4,3,7,55,27,0,82,200,18,300
3150106,8,0,8,65,18,0,83,276,15,374
3150107,7,0,7,59,27,0,86,259,14,359
3150108,7,6,13,62,14,3,79,163,18,260
3150109,10,0,10,75,25,0,100,285,21,406
3150110,11,0,11,53,24,3,80,191,17,288
3150111,7,0,7,61,21,0,82,218,27,327
3150112,6,0,6,42,12,0,54,152,24,230
3150113,4,0,4,39,22,6,67,200,31,298
3150114,71,9,80,65,20,0,85,372,43,500
3150115,0,0,0,15,3,0,18,33,0,51
3150201,5,0,5,69,29,3,101,185,20,306
3150202,9,3,12,79,41,9,129,326,27,482
3150203,8,0,8,60,14,6,80,226,27,333
3150204,8,0,12,92,37,6,135,379,48,562
3150205,7,3,10,50,16,3,69,132,30,231
3150206,0,0,0,66,16,6,88,165,34,287
3150207,3,0,3,109,30,4,143,196,42,381
3150208,0,0,0,69,15,9,93,144,30,267
3150209,6,0,6,59,17,3,79,186,33,298
3150210,8,0,8,69,20,3,92,167,23,282
3150211,16,0,16,28,9,6,43,222,23,288
3150212,8,3,11,48,23,3,74,157,22,253
3150213,7,0,7,54,30,6,90,195,34,319
3150214,3,0,3,64,15,8,87,157,17,261
3150215,3,3,6,108,48,7,163,296,30,489
3150216,6,3,9,47,21,0,68,186,20,274
3150217,12,0,12,56,31,0,87,196,19,302
3150218,3,3,6,116,32,0,148,238,18,404
3150219,3,0,3,63,24,8,95,230,22,347
3150220,5,0,5,47,19,4,70,294,47,411
3150221,34,7,41,36,16,3,55,312,60,427
3150222,25,0,25,30,15,0,45,159,19,223
3150223,3,0,3,36,15,0,51,133,14,198
3150224,5,0,5,39,29,0,68,150,21,239
3150225,0,7,7,76,38,3,117,206,40,363
3150226,4,3,7,48,11,3,62,127,15,204
3150227,3,3,6,47,27,3,77,167,41,285
3150301,3,0,3,42,15,0,57,197,47,301
3150302,11,0,11,40,15,3,58,166,31,255
3150303,16,4,20,57,6,9,72,211,23,306
3150304,4,0,4,88,28,0,116,287,41,444
3150305,0,0,0,27,6,0,33,71,12,116
3150306,4,0,4,59,9,0,68,201,41,310
3150307,0,7,7,29,15,3,47,123,17,187
3150308,8,0,8,51,20,3,74,174,48,296
3150309,7,31,38,43,22,5,70,161,76,307
3150310,6,0,6,30,16,4,50,131,32,213
3150311,15,4,19,51,13,3,67,223,41,331
3150312,6,4,10,29,9,0,38,170,39,247
3150313,0,0,0,27,9,0,36,118,9,163
3150314,4,0,4,55,19,0,74,151,32,257
3150315,0,0,0,45,15,0,60,188,25,273
3150316,0,0,4,40,15,0,55,151,20,226
3150317,3,0,3,35,17,8,60,207,17,284
3150318,8,0,8,75,21,7,103,188,22,313
3150319,0,0,0,37,7,0,44,119,19,182
3150320,0,0,0,40,12,3,55,102,23,180
3150401,0,0,0,40,17,0,57,157,6,220
3150402,3,0,3,51,12,0,63,161,9,233
3150403,4,3,7,62,13,0,75,300,31,406
3150404,0,0,0,54,21,0,75,157,18,250
3150405,0,0,0,30,3,3,36,133,14,183
3150406,7,0,7,31,16,0,47,167,22,236
3150407,19,3,22,48,24,6,78,225,25,328
3150408,6,4,10,61,30,6,97,282,31,410
3150409,3,0,3,42,11,3,56,164,15,235
3150410,3,0,3,58,21,0,79,189,34,302
3150411,6,0,6,30,12,3,45,135,12,192
3150412,0,0,0,83,9,3,95,258,25,378
3150413,0,4,4,74,15,6,95,321,30,446
3150414,0,0,0,48,16,0,64,195,20,279
3150501,9,0,9,72,18,7,97,182,26,305
3150502,11,3,14,69,17,12,98,253,39,390
3150503,4,0,4,37,18,6,61,111,24,196
3150504,5,0,5,47,23,6,76,211,24,311
3150505,4,3,7,29,12,0,41,91,10,142
3150506,60,6,66,23,15,0,38,157,19,214
3150507,12,6,18,54,20,3,77,167,35,279
3150508,7,0,7,40,14,4,58,168,6,232
3150509,4,0,4,35,18,3,56,102,15,173
3150510,8,0,8,162,43,17,222,360,32,614
3150511,4,0,4,99,24,4,127,242,20,389
3150512,3,0,3,94,24,3,121,241,35,397
3150513,6,0,6,57,25,4,86,152,18,256
3150514,3,0,3,78,16,0,94,158,22,274
3150515,0,3,3,46,14,0,60,102,18,180
3150516,0,0,0,71,24,0,95,204,19,318
3150517,0,0,0,47,17,4,68,126,6,200
3150518,0,0,0,49,13,4,66,108,7,181
3150519,0,0,0,110,17,11,138,191,18,347
3150520,9,6,15,63,25,6,94,240,38,372
3150521,8,0,8,59,13,3,75,149,24,248
3150522,29,3,32,97,37,8,142,315,18,475
3150523,8,0,8,84,18,3,105,128,12,245
3150524,7,3,10,74,27,6,107,184,18,309
3150525,7,0,7,86,37,9,132,293,25,450
3150601,6,3,9,51,14,6,71,179,24,274
3150602,10,0,10,32,12,0,44,131,15,190
3150603,3,0,3,48,18,3,69,181,18,268
3150604,6,0,6,66,18,3,87,205,18,310
3150605,3,0,3,61,26,0,87,207,26,320
3150606,3,0,3,25,25,0,50,124,3,177
3150607,0,0,0,28,21,3,52,118,12,182
3150608,0,4,4,49,9,0,58,91,13,162
3150609,3,0,3,54,14,0,68,108,6,182
3150610,0,0,0,47,26,6,79,127,20,226
3150611,0,0,0,42,7,3,52,121,13,186
3150612,3,0,3,66,17,0,83,230,18,331
3150613,0,0,0,203,134,48,385,382,14,781
3150614,8,24,32,59,21,3,83,313,68,464
3150615,13,8,21,41,17,0,58,144,20,222
3150616,3,0,3,58,17,0,75,221,50,346
3150617,0,0,0,48,21,0,69,179,29,277
3150618,5,0,5,24,15,0,39,158,27,224
3150619,8,0,8,41,9,0,50,126,28,204
3150620,0,0,0,52,25,0,77,210,20,307
3150621,0,0,0,38,21,0,59,136,6,201
3150622,3,0,3,34,21,6,61,166,25,252
3150623,8,0,8,38,14,3,55,137,19,211
3150624,3,0,3,59,29,3,91,258,38,387
3150625,36,6,42,72,39,0,111,306,74,491
3150701,0,0,0,36,4,4,44,74,33,151
3150702,0,0,0,49,20,0,69,170,10,249
3150703,3,0,3,52,10,3,65,139,15,219
3150704,0,0,0,46,20,6,72,163,16,251
3150705,3,0,6,58,15,3,76,130,13,219
3150706,3,3,6,30,0,3,33,99,24,156
3150707,3,3,6,48,6,3,57,102,13,172
3150708,0,0,0,39,16,6,61,155,11,227
3150709,7,3,10,41,10,3,54,162,9,225
3150710,0,0,0,18,6,0,24,94,27,145
3150711,3,0,3,49,14,3,66,69,10,145
3150712,5,0,5,58,20,6,84,183,12,279
3150713,0,0,0,42,4,0,46,159,13,218
3150714,0,0,0,64,21,3,88,166,23,277
3150801,6,0,6,25,22,0,47,149,18,214
3150802,0,0,0,18,15,3,36,93,15,144
3150803,9,0,9,58,17,3,78,158,23,259
3150804,11,0,11,42,17,4,63,188,32,283
3150805,0,0,0,33,7,0,40,101,20,161
3150806,0,22,22,32,16,0,48,107,50,205
3150807,0,0,0,0,0,0,0,0,0,0
3150808,4,0,4,29,12,3,44,106,8,158
3150809,0,0,0,55,22,0,77,136,15,228
3150810,0,0,0,44,13,0,57,126,32,215
3150811,0,0,0,6,0,0,6,15,0,21
3150812,0,3,3,39,22,0,61,134,9,204
3150813,0,0,0,48,10,0,58,150,17,225
3150814,5,0,5,25,16,0,41,85,8,134
3150815,4,0,4,43,5,0,48,105,6,159
3150816,6,0,6,40,18,0,58,105,18,181
3150817,0,0,0,20,9,0,29,115,32,176
3150901,3,0,3,33,5,6,44,103,20,167
3150902,3,3,6,50,20,0,70,202,18,290
3150903,12,0,12,41,27,6,74,201,30,305
3150904,6,0,6,42,14,0,56,162,9,227
3150905,7,3,10,60,25,9,94,229,24,347
3150906,28,0,28,44,19,3,66,244,13,323
3150907,0,0,0,38,15,4,57,96,10,163
3150908,0,0,0,61,11,3,75,230,30,335
3150909,0,0,0,47,22,9,78,199,21,298
3150910,4,0,4,25,10,0,35,132,5,172
3150911,8,0,8,65,19,0,84,232,29,345
3150912,0,0,0,37,18,0,55,159,5,219
3150913,0,0,0,42,21,0,63,165,22,250
3150914,0,0,0,48,5,3,56,156,22,234
3150915,4,0,4,46,15,0,61,208,17,286
3150916,0,0,0,33,20,0,53,239,32,324
3150917,7,0,7,26,14,0,40,170,21,231
3150918,8,0,8,27,0,0,27,125,30,182
3150919,3,6,9,44,19,3,66,238,32,336
3150920,7,0,7,49,18,3,70,268,25,363
3150921,3,0,3,69,18,6,93,264,32,389
3150922,0,5,5,32,16,0,48,166,14,228
3150923,13,0,13,66,25,3,94,286,28,408
3150924,3,0,3,65,15,3,83,230,49,362
3150925,0,0,0,61,16,0,77,288,47,412
3150926,0,0,0,45,12,0,57,120,15,192
3150927,0,0,0,35,11,3,49,152,18,219
3151001,0,0,0,0,0,0,0,6,0,6
3151101,0,0,0,46,24,3,73,251,19,343
3151102,10,0,10,31,9,0,40,230,16,286
3151103,8,0,8,28,15,9,52,238,37,327
3151104,3,0,3,45,33,15,93,297,26,416
3151105,4,0,4,34,7,3,44,153,15,212
3151106,12,13,25,23,23,0,46,251,47,344
3151107,0,3,3,22,15,0,37,251,36,324
3151108,14,0,14,40,20,5,65,292,49,406
3151109,0,3,3,89,32,3,124,319,51,494
3151110,0,0,0,41,10,0,51,141,27,219
3151111,3,0,3,31,11,0,42,173,22,237
3151112,0,0,0,0,0,0,0,0,0,0
3151113,0,0,0,3,3,0,6,42,9,57
3151114,7,0,7,57,24,10,91,240,22,353
3151115,0,0,0,19,8,3,30,54,3,87
3151116,3,0,3,65,14,9,88,296,25,409
3151117,3,0,3,40,9,3,52,212,17,281
3151201,3,0,3,113,42,3,158,305,36,499
3151202,6,0,6,108,45,7,160,330,26,516
3151203,19,39,58,116,36,0,152,413,129,694
3151204,3,0,3,98,38,7,143,222,21,386
3151205,9,3,12,67,17,6,90,210,9,309
3151206,12,3,15,72,22,0,94,334,37,465
3151207,6,0,6,22,14,4,40,126,16,182
3151208,4,0,4,40,9,6,55,123,13,191
3151209,6,0,6,57,33,6,96,184,15,295
3151210,0,0,0,44,9,0,53,104,15,172
3151211,7,0,7,65,21,6,92,180,22,294
3151212,8,5,13,70,32,6,108,195,13,316
3151213,9,0,9,44,15,0,59,149,48,256
3151214,0,38,38,24,0,0,24,76,87,187
3151215,7,4,11,47,19,9,75,172,27,274
3151216,4,3,7,46,6,0,52,135,23,210
3151217,9,9,18,51,26,0,77,201,37,315
3151218,18,67,85,63,19,4,86,243,128,457
3151219,4,0,4,62,9,6,77,184,30,291
3151220,12,3,15,72,29,0,101,220,15,336
3151221,6,0,6,43,16,3,62,134,24,220
3151222,9,3,12,54,26,6,86,216,46,348
3151223,6,0,6,102,37,6,145,310,35,490
3151224,9,3,12,39,15,0,54,174,34,262
3151225,4,0,4,27,15,0,42,146,16,204
3151226,13,0,13,52,15,0,67,148,10,225
3151227,0,0,0,33,18,0,51,120,24,195
3151228,5,4,9,50,9,6,65,139,28,232
3151229,9,0,9,74,21,3,98,252,40,390
3151230,3,0,3,43,15,5,63,104,20,187
3151231,8,0,8,59,26,3,88,218,13,319
3151232,10,3,13,49,37,0,86,168,12,266
3151233,4,3,7,100,34,7,141,276,29,446
3151301,0,0,0,87,26,10,123,293,27,443
3151302,3,0,3,48,29,3,80,202,18,300
3151303,3,6,9,117,20,3,140,239,41,420
3151304,10,17,27,61,31,0,92,223,90,405
3151305,3,8,11,98,24,6,128,288,42,458
3151306,3,3,6,32,13,6,51,119,24,194
3151307,11,23,34,49,29,6,84,297,99,480
3151308,3,3,6,62,16,0,78,140,33,251
3151309,3,0,3,47,14,9,70,144,24,238
3151310,3,0,3,85,18,0,103,198,11,312
3151311,4,0,4,115,35,6,156,232,18,406
3151312,4,0,4,88,21,6,115,157,10,282
3151313,12,3,15,154,38,8,200,390,36,626
3151401,0,0,0,50,22,3,75,186,16,277
3151402,6,0,6,79,15,9,103,230,27,360
3151403,3,0,3,83,27,0,110,266,32,408
3151404,3,0,3,66,18,3,87,191,28,306
3151405,0,0,0,55,26,0,81,191,21,293
3151406,0,0,0,56,9,6,71,176,28,275
3151407,0,0,0,0,0,0,0,0,0,0
3151408,0,0,0,56,17,6,79,132,18,229
3151409,8,0,8,98,18,4,120,263,19,402
3151410,6,0,6,48,14,0,62,113,6,181
3151411,0,0,0,48,12,6,66,163,11,240
3151412,3,0,3,12,6,0,18,54,3,75
3151413,3,0,3,47,24,0,71,164,15,250
3151414,5,0,5,58,24,3,85,219,15,319
3151415,6,0,6,72,21,9,102,182,11,295
3151416,3,0,3,49,17,0,66,129,21,216
3151417,3,0,3,62,21,0,83,128,12,223
3151418,5,0,5,73,27,6,106,247,30,383
3151419,0,0,0,0,0,0,0,0,0,0
3151420,0,0,0,29,3,0,32,82,9,123
3151421,0,0,0,41,11,0,52,93,9,154
3151422,6,3,9,62,20,0,82,228,33,343
3151423,3,0,3,18,4,0,22,103,9,134
3151424,6,0,6,48,8,0,56,135,10,201
3151425,0,5,5,30,7,0,37,58,17,112
3151426,0,0,0,42,6,3,51,145,21,217
3151427,0,0,0,46,10,3,59,171,15,245
3151428,3,0,3,61,25,9,95,243,22,360
3151429,3,0,3,52,11,3,66,190,21,277
3151430,0,0,0,66,5,5,76,193,26,295
3151431,0,0,0,56,18,0,74,204,37,315
3151432,0,0,0,37,10,0,47,135,21,203
3151433,4,3,7,76,17,3,96,208,27,331
3151434,0,0,0,52,11,3,66,134,35,235
3151435,6,0,6,57,20,0,77,200,24,301
3151436,0,0,0,82,28,12,122,186,8,316
3151437,6,0,6,47,12,0,59,145,7,211
3151438,4,0,4,66,23,8,97,236,11,344
3151439,4,0,4,25,3,0,28,107,18,153
3151440,3,0,3,77,12,4,93,257,24,374
3151441,3,0,3,36,9,0,45,200,24,269
3151442,3,0,3,56,13,7,76,164,16,256
3151443,3,0,3,50,18,3,71,142,4,217
3151444,0,0,0,77,21,0,98,146,12,256
3151445,7,0,7,39,9,0,48,168,27,243
3151446,3,0,3,78,13,0,91,235,27,353
3151447,0,0,0,47,15,0,62,98,11,171
3151448,0,5,5,48,13,0,61,179,19,259
3151449,0,0,0,29,9,4,42,122,9,173
3151450,4,0,4,60,22,0,82,220,33,335
3151451,3,3,6,70,32,0,102,274,41,417
3151452,3,3,6,29,9,0,38,120,15,173
3151453,4,0,4,63,24,6,93,182,18,293
3151501,5,0,5,48,18,3,69,247,18,334
3151502,6,6,12,36,15,0,51,154,21,226
3151503,3,3,6,66,31,0,97,243,45,385
3151504,3,0,3,56,22,3,81,205,68,354
3151505,3,3,6,54,20,0,74,144,57,275
3151506,0,0,0,47,15,0,62,140,18,220
3151507,6,0,6,22,5,0,27,128,12,167
3151508,0,0,0,53,12,0,65,128,18,211
3151509,4,3,7,43,21,0,64,156,16,236
3151510,0,0,0,38,12,3,53,158,13,224
3151511,0,0,0,46,13,0,59,154,16,229
3151601,3,0,3,61,23,0,84,186,17,287
3151602,4,0,4,115,28,9,152,373,34,559
3151603,0,0,0,48,17,4,69,134,9,212
3151604,0,0,0,0,0,0,0,0,0,0
3151605,0,0,0,120,42,0,162,439,36,637
3151606,0,0,0,32,12,6,50,107,3,160
3151607,0,0,0,53,23,5,81,202,22,305
3151608,0,0,0,28,12,0,40,130,4,174
3151609,3,0,3,53,19,0,72,168,22,262
3151610,0,3,3,60,30,3,93,322,27,442
3151611,0,0,0,71,21,6,98,189,12,299
3151701,0,0,0,58,16,3,77,142,9,228
3151702,0,0,0,71,21,3,95,183,13,291
3151703,7,0,7,36,11,3,50,189,3,242
3151704,0,0,0,33,21,6,60,177,12,249
3151705,0,0,0,66,10,3,79,181,18,278
3151706,0,0,0,80,24,0,104,196,25,325
3151707,8,0,8,85,31,3,119,245,40,404
3151708,0,0,0,40,16,0,56,150,7,213
3151709,0,0,0,87,20,4,111,199,27,337
3151710,0,0,0,25,16,0,41,217,20,278
3151711,0,0,0,44,22,3,69,133,6,208
3151712,5,0,5,103,34,6,143,304,32,479
3151801,7,3,10,44,20,0,64,243,52,359
3151802,10,0,10,42,16,6,64,286,30,380
3151803,7,3,10,47,22,4,73,277,56,406
3151804,29,19,48,69,26,6,101,226,58,385
3151805,6,3,9,73,24,3,100,215,25,340
3151806,5,0,5,58,22,3,83,183,15,281
3151807,3,0,3,90,33,9,132,241,16,389
3151808,0,0,0,57,24,3,84,195,14,293
3151809,6,7,13,38,18,0,56,204,75,335
3151810,32,5,37,15,13,0,28,168,20,216
3151811,3,0,3,77,23,3,103,164,24,291
3151812,4,0,4,28,21,0,49,135,16,200
3151813,0,0,0,178,42,9,229,327,44,600
3151814,21,8,29,70,17,0,87,337,32,456
3151815,3,3,6,77,26,6,109,187,17,313
3151816,0,0,0,53,10,3,66,203,23,292
3151817,0,0,0,75,25,6,106,249,20,375
3151818,0,0,0,0,0,0,0,0,0,0
3151819,0,0,0,0,0,0,0,0,0,0
3151820,0,0,0,49,7,0,56,133,26,215
3151821,6,0,6,53,22,3,78,210,41,329
3151822,12,3,15,68,27,0,95,246,38,379
3151823,0,0,0,53,25,3,81,224,14,319
3151824,4,0,4,69,0,4,73,259,34,366
3151825,3,0,3,92,22,3,117,240,34,391
3151826,53,14,67,12,3,3,18,313,38,369
3151827,17,3,20,44,12,6,62,299,46,407
3151828,26,5,31,0,12,0,12,489,47,548
3151829,3,0,3,75,21,0,96,271,22,389
3151830,4,7,11,133,31,0,164,327,31,522
3151901,0,0,0,0,0,0,0,0,0,0
3151902,0,0,0,88,15,0,103,321,26,450
3151903,3,0,3,74,17,3,94,186,26,306
3151904,6,0,6,55,18,4,77,135,13,225
3151905,8,3,11,68,30,3,101,298,51,450
3151906,6,0,6,88,13,4,105,219,17,341
3151907,0,0,0,65,12,3,80,131,25,236
3151908,50,0,50,58,28,0,86,300,39,425
3151909,37,3,40,41,11,4,56,222,6,284
3151910,4,0,4,53,19,0,72,184,27,283
3151911,8,0,8,44,13,3,60,272,12,344
3151912,7,3,10,58,26,0,84,223,24,331
3151913,3,0,3,33,10,3,46,137,15,198
3151914,7,0,7,51,21,9,81,242,30,353
3151915,8,0,8,47,25,3,75,246,24,345
3152001,7,0,7,61,21,0,82,208,26,316
3152002,3,0,3,56,16,6,78,223,32,333
3152003,3,6,9,54,19,3,76,230,25,331
3152004,0,3,3,35,15,3,53,106,24,183
3152005,9,3,12,55,12,0,67,212,51,330
3152006,4,3,7,27,5,0,32,150,20,202
3152007,6,10,16,81,33,3,117,372,61,550
3152008,18,0,18,62,22,6,90,254,19,363
3152009,6,3,9,41,18,0,59,218,49,326
3152010,7,4,11,47,27,0,74,229,61,364
3152011,6,0,6,31,21,0,52,226,17,295
3152012,4,0,4,30,12,0,42,160,19,221
3152013,7,3,10,39,8,0,47,161,36,244
3152014,0,3,3,40,28,9,77,217,27,321
3152015,6,3,9,42,18,0,60,202,46,308
3152016,3,3,6,24,12,0,36,186,23,245
3152017,4,3,7,42,25,6,73,313,30,416
3152018,16,0,16,82,26,0,108,300,39,447
3152019,0,4,4,92,17,4,113,256,24,393
3152020,6,0,6,77,41,3,121,307,26,454
3152021,86,61,147,20,14,3,37,270,135,442
3152022,9,0,9,69,32,3,104,240,29,373
3152023,8,0,8,76,18,3,97,274,25,396
3152024,3,3,6,57,30,3,90,272,24,386
3152025,6,0,6,24,12,0,36,192,14,242
3152026,3,0,3,114,35,9,158,315,38,511
3152027,11,0,11,48,16,3,67,201,7,275
3152028,0,0,0,58,9,0,67,130,11,208
3152029,6,0,6,65,15,6,86,169,22,277
3152030,4,0,4,67,23,7,97,260,36,393
3152031,62,69,131,0,0,0,0,191,115,306
3152032,3,0,3,115,30,4,149,333,28,510
3152033,0,0,0,68,23,0,91,159,6,256
3152034,3,0,3,46,21,3,70,191,15,276
3152035,5,0,5,82,26,5,113,250,28,391
3152101,7,6,13,57,28,3,88,280,47,415
3152102,6,0,6,23,12,3,38,148,19,205
3152103,12,3,15,43,29,0,72,248,27,347
3152104,0,0,0,33,19,0,52,209,21,282
3152105,4,0,4,31,15,3,49,197,27,273
3152106,7,6,13,59,16,3,78,277,18,373
3152107,5,4,9,54,23,6,83,390,37,510
3152108,0,0,0,41,9,10,60,131,16,207
3152109,8,6,14,68,30,0,98,379,46,523
3152110,0,3,3,40,23,0,63,164,15,242
3152111,7,0,7,32,12,3,47,190,24,261
3152112,6,0,6,41,15,3,59,166,24,249
3152113,4,0,4,87,17,0,104,251,26,381
3152114,5,0,5,52,13,7,72,275,31,378
3152115,0,0,0,64,12,0,76,180,21,277
3152116,6,3,9,74,27,0,101,281,30,412
3152117,0,0,0,99,27,3,129,298,43,470
3152118,3,0,3,36,10,7,53,198,15,266
3152119,6,0,6,47,11,0,58,128,6,192
3152120,4,0,4,57,29,7,93,164,21,278
3152121,3,3,6,78,15,3,96,219,22,337
3152122,3,0,3,86,10,3,99,141,18,258
3152123,0,0,0,110,21,9,140,240,19,399
3152124,0,0,0,4,8,0,12,48,3,63
3152125,16,0,16,191,53,12,256,493,78,827
3152126,7,0,7,38,26,4,68,179,18,265
3152127,9,0,9,53,21,3,77,248,14,339
3152128,0,0,0,84,9,3,96,112,9,217
3152201,0,0,0,73,23,3,99,241,23,363
3152202,7,3,10,56,28,3,87,344,36,467
3152203,3,0,3,79,19,7,105,228,23,356
3152204,0,0,0,46,10,6,62,159,15,236
3152205,3,0,3,37,8,0,45,162,9,216
3152206,3,0,3,92,28,0,120,199,8,327
3152207,0,3,3,61,14,0,75,187,27,289
3152208,0,0,0,103,28,7,138,274,36,448
3152209,0,0,0,36,17,0,53,178,64,295
3152210,0,0,0,0,0,0,0,9,0,9
3152211,6,0,6,40,17,9,66,213,18,297
3152212,0,0,0,61,12,0,73,132,28,233
3152213,0,3,3,32,22,0,54,390,22,466
3152214,0,0,0,42,19,6,67,135,18,220
3152215,9,3,12,24,3,6,33,170,22,225
3152216,6,0,6,17,6,3,26,221,37,284
3152217,6,0,6,6,6,3,15,106,20,141
3152218,0,0,0,44,9,0,53,202,20,275
3152219,0,0,0,36,8,0,44,230,20,294
3152220,0,3,3,45,9,3,57,156,31,244
3152221,3,4,7,25,16,0,41,197,29,267
3152222,8,0,8,37,16,0,53,202,16,271
3152223,5,3,8,49,9,3,61,186,39,286
3152224,0,0,0,0,0,0,0,48,0,48
3152225,8,0,8,42,15,6,63,129,22,214
3152226,0,3,3,25,15,0,40,183,32,255
3152301,4,0,4,65,38,0,103,218,32,353
3152302,3,0,3,74,31,6,111,216,19,346
3152303,9,28,37,63,27,3,93,208,79,380
3152304,3,6,9,54,21,6,81,176,26,283
3152305,3,0,3,86,33,0,119,208,25,352
3152306,6,0,6,79,25,3,107,257,15,379
3152307,0,0,0,79,29,0,108,251,24,383
3152401,7,0,7,107,31,3,141,305,21,467
3152402,8,4,12,28,22,3,53,179,28,260
3152403,9,0,9,74,37,0,111,234,21,366
3152404,3,0,3,30,21,3,54,119,24,197
3152405,4,3,7,53,30,3,86,122,16,224
3152406,4,0,4,42,12,3,57,143,26,226
3152407,6,0,6,33,15,0,48,138,24,210
3152408,11,0,11,44,13,3,60,133,22,215
3152409,3,0,7,31,9,0,40,101,13,154
3152410,3,44,47,43,23,3,69,166,126,361
3152411,15,0,15,90,27,6,123,269,25,417
3152412,4,0,4,52,19,0,71,182,6,259
3152413,3,3,6,50,21,0,71,187,29,287
3152414,0,0,0,0,0,0,0,0,473,473
3152415,5,0,5,45,15,3,63,163,13,239
3152416,4,3,7,45,30,6,81,213,16,310
3152417,9,0,9,51,27,0,78,179,18,275
3152418,3,3,6,36,17,0,53,154,22,229
3152419,8,4,12,89,24,0,113,238,27,378
3152420,3,0,3,46,33,0,79,205,24,308
3152421,11,6,17,99,42,7,148,274,43,465
3152422,16,6,22,36,14,0,50,200,40,290
3152423,4,0,8,17,23,0,40,116,29,185
3152424,0,0,0,35,15,6,56,165,10,231
3152425,11,0,11,77,25,0,102,286,35,423
3152426,9,0,9,35,16,5,56,143,18,217
3152427,6,0,6,47,18,3,68,208,41,317
3152428,7,0,7,34,15,6,55,146,12,213
3152429,13,3,16,79,19,5,103,260,26,389
3152430,7,0,7,44,13,0,57,142,18,217
3152431,5,0,5,36,13,6,55,185,20,260
3152432,3,12,15,52,17,0,69,232,56,357
3152433,3,6,9,29,12,4,45,114,27,186
3152434,0,9,9,59,26,7,92,201,33,326
3152435,0,0,0,42,8,0,50,183,36,269
3152436,7,3,10,39,19,0,58,139,22,219
3152437,8,5,13,44,13,0,57,168,36,261
3152438,0,0,0,3,0,0,3,0,0,3
3152439,4,4,8,80,38,0,118,258,13,389
3152440,0,3,3,153,32,7,192,301,26,519
3152441,6,6,12,59,22,9,90,192,25,307
3152442,8,0,8,59,22,0,81,243,27,351
3152443,9,3,12,48,21,0,69,201,48,318
3152444,11,0,11,43,15,9,67,180,32,279
3152445,3,3,6,36,15,0,51,175,27,253
3152446,4,0,4,58,21,0,79,176,19,274
3152447,77,10,87,38,14,0,52,292,21,365
3152448,3,0,3,52,34,3,89,213,25,327
3152449,3,3,6,47,11,0,58,132,12,202
3152450,53,49,102,10,4,0,14,150,100,264
3152451,4,3,7,35,16,4,55,144,38,237
3152501,0,0,0,82,25,0,107,328,52,487
3152502,0,0,0,75,27,4,106,396,55,557
3152503,0,0,0,32,6,5,43,173,18,234
3152504,0,0,0,37,21,0,58,156,18,232
3152505,0,0,0,115,49,3,167,355,32,554
3152506,0,0,0,31,6,3,40,84,19,143
3152507,0,0,0,45,10,0,55,143,21,219
3152508,0,0,0,89,21,4,114,252,13,379
3152509,0,0,0,50,6,0,56,170,19,245
3152510,0,0,0,43,11,0,54,194,19,267
3152511,0,0,0,40,18,0,58,121,29,208
3152512,4,0,4,48,18,3,69,207,34,310
3152513,6,0,6,46,7,6,59,160,18,237
3152514,0,0,0,66,18,4,88,257,34,379
3152515,0,0,0,0,3,0,3,3,0,6
3152516,3,0,3,24,15,0,39,95,21,155
3152517,5,0,5,64,20,0,84,194,6,284
3152518,0,0,0,47,18,9,74,284,31,389
3152519,0,0,0,15,3,0,18,174,19,211
3152520,4,0,4,29,14,0,43,163,21,227
3152521,0,7,7,28,20,0,48,268,32,348
3152522,4,0,4,31,11,0,42,226,46,314
3152601,0,0,0,120,25,11,156,249,22,427
3152602,6,0,6,40,17,0,57,161,15,233
3152603,3,0,3,37,9,3,49,87,7,143
3152604,6,3,9,78,30,0,108,220,21,349
3152605,3,0,3,55,30,3,88,166,29,283
3152606,3,0,3,44,18,0,62,155,11,228
3152607,4,6,10,57,23,0,80,232,24,336
3152608,0,0,0,106,34,0,140,236,21,397
3152609,0,0,0,69,27,0,96,276,6,378
3152610,0,0,0,60,21,6,87,131,3,221
3152611,5,0,5,47,30,6,83,158,10,251
3152612,6,0,6,74,31,8,113,187,18,318
3152613,0,0,0,55,15,4,74,140,6,220
3949999,41,11,52,912,636,49,1597,7974,1912,11483
3979991,0,0,0,0,0,0,0,0,0,0
3979992,0,0,0,0,0,0,0,3,0,3
3979993,6,6,12,31,23,0,54,300,91,445
4100101,9,3,12,33,33,0,66,345,32,443
4100102,0,0,0,13,19,6,38,291,29,358
4100103,3,3,6,15,10,4,29,140,21,190
4100104,9,0,9,34,25,0,59,423,70,552
4100105,0,3,3,26,24,3,53,261,24,338
4100106,5,0,5,33,18,6,57,239,47,343
4100107,6,3,9,26,15,0,41,385,114,540
4100108,3,3,6,17,19,0,36,196,87,319
4100109,3,0,3,34,24,0,58,420,50,528
4100110,9,0,9,59,32,0,91,829,127,1047
4100111,9,7,16,3,9,0,12,252,65,329
4100112,3,0,3,56,22,0,78,522,60,660
4100113,6,0,6,34,19,0,53,464,51,568
4100114,0,0,0,22,11,0,33,218,18,269
4100115,0,0,0,38,30,0,68,267,30,365
4100116,0,0,0,12,18,0,30,267,46,343
4100117,0,0,0,36,15,0,51,317,20,388
4100118,3,6,9,28,4,0,32,194,18,244
4100119,4,0,4,44,16,0,60,374,44,478
4100120,3,0,3,10,3,0,13,374,11,398
4100121,0,0,0,21,19,0,40,621,93,754
4100122,0,0,0,0,0,0,0,49,267,316
4100123,3,0,3,38,15,0,53,1114,153,1320
4100124,0,0,0,7,6,0,13,251,98,362
4100125,0,0,0,14,12,0,26,496,66,588
4100126,0,0,0,0,0,0,0,6,0,6
4100127,0,0,0,0,0,0,0,0,0,0
4100128,0,0,0,0,0,0,0,0,0,0
4100129,0,0,0,0,0,0,0,0,9,9
4100130,9,3,12,17,27,0,44,245,26,315
4100131,0,0,0,0,0,0,0,3,0,3
4100132,0,0,0,0,0,0,0,0,0,0
4100201,6,4,10,26,35,0,61,320,33,414
4100202,0,0,0,27,33,0,60,295,24,379
4100203,9,3,12,28,19,0,47,220,22,289
4100204,9,0,9,26,11,0,37,305,23,365
4100205,6,0,6,50,44,0,94,444,44,582
4100206,6,0,6,36,18,0,54,208,20,282
4100207,5,0,5,28,22,0,50,179,7,236
4100208,125,12,140,44,30,3,77,416,44,537
4100209,3,0,3,33,11,0,44,244,18,306
4100210,0,0,0,28,15,0,43,185,9,237
4100211,5,0,5,43,15,3,61,232,17,310
4100212,8,0,8,44,16,3,63,223,15,301
4100213,0,0,0,0,0,0,0,0,0,0
4100214,15,8,23,33,20,0,53,177,26,256
4100215,11,3,14,51,33,3,87,278,48,413
4100216,6,0,6,21,31,0,52,337,23,412
4100217,0,0,0,0,0,0,0,0,0,0
4100218,0,0,0,0,0,0,0,0,0,0
4100219,6,3,9,9,13,0,22,226,29,277
4100220,0,0,0,23,18,6,47,148,34,229
4100221,3,0,3,25,25,0,50,199,39,288
4100301,0,0,0,63,21,0,84,136,8,228
4100302,0,0,0,53,22,0,75,125,12,212
4100303,3,0,3,66,19,0,85,212,6,303
4100304,0,0,0,64,20,4,88,171,8,267
4100305,3,0,3,53,25,3,81,146,12,239
4100306,0,3,3,93,31,7,131,197,13,341
4100307,3,0,3,32,18,0,50,144,6,200
4100308,0,0,0,70,41,3,114,168,9,291
4100309,0,0,0,28,23,6,57,114,3,174
4100310,0,0,0,33,14,3,50,116,9,175
4100311,3,0,3,37,18,0,55,191,18,264
4100312,6,0,6,79,37,6,122,294,21,437
4100313,5,0,5,48,35,0,83,181,8,272
4100314,33,3,36,62,21,0,83,225,10,318
4100315,7,0,7,45,24,6,75,194,9,278
4100316,4,0,4,41,14,3,58,196,9,263
4100317,6,0,6,47,22,0,69,95,3,167
4100318,3,3,6,58,17,3,78,158,18,254
4100319,7,0,7,98,31,13,142,239,17,398
4100320,0,0,0,0,6,0,6,3,0,9
4100321,0,0,0,45,23,3,71,122,4,197
4100322,6,0,6,22,5,3,30,74,0,104
4100323,0,0,0,36,7,0,43,89,9,141
4100401,7,3,10,69,33,4,106,238,18,362
4100402,0,0,0,102,42,7,151,244,10,405
4100403,13,24,37,60,29,6,95,219,34,348
4100404,7,0,7,68,16,0,84,135,6,225
4100405,3,3,6,106,34,9,149,207,13,369
4100406,0,0,0,71,23,0,94,185,16,295
4100407,0,0,0,36,24,5,65,159,4,228
4100408,8,0,8,68,34,9,111,184,0,295
4100409,3,0,3,66,16,6,88,133,3,224
4100410,0,0,0,82,16,4,102,142,10,254
4100411,4,0,4,69,28,9,106,200,0,306
4100412,0,0,0,83,31,6,120,170,15,305
4100413,6,0,6,58,16,4,78,140,9,227
4100414,3,0,3,65,30,0,95,249,4,348
4100415,0,0,0,50,15,0,65,136,26,227
4100416,5,3,8,104,25,4,133,270,15,418
4100417,25,3,28,60,24,0,84,272,30,386
4100418,6,0,6,61,39,10,110,182,7,299
4100419,0,0,0,59,27,10,96,182,9,287
4100420,0,0,3,48,30,3,81,102,9,192
4100421,6,0,6,108,32,9,149,201,14,364
4100422,6,3,9,95,52,7,154,232,10,396
4100423,3,0,3,93,46,3,142,220,18,380
4100424,4,0,4,84,31,7,122,189,6,317
4100425,23,0,23,64,31,3,98,220,15,333
4100426,3,0,3,63,24,7,94,243,15,352
4100427,3,0,3,73,62,6,141,260,18,419
4100428,7,3,15,66,38,4,108,180,15,303
4100429,0,0,0,59,19,3,81,145,12,238
4100430,0,3,3,54,18,5,77,169,3,249
4100431,0,0,0,63,32,6,101,147,0,248
4100432,0,3,3,35,18,4,57,128,3,188
4100433,3,0,3,69,29,3,101,225,6,332
4100434,6,0,6,114,33,6,153,296,12,461
4100435,0,0,0,112,35,9,156,239,17,412
4100436,4,0,4,62,17,0,79,152,0,231
4100437,0,0,0,36,12,11,59,133,3,195
4100438,0,0,0,65,16,0,81,143,7,231
4100439,3,0,3,106,44,3,153,237,18,408
4100440,4,0,4,86,20,7,113,242,13,368
4100441,0,0,0,73,21,7,101,181,7,289
4100442,0,0,0,75,35,3,113,190,25,328
4100443,0,0,0,43,18,6,67,83,9,159
4100444,0,0,0,42,18,0,60,94,3,157
4100445,0,3,3,33,22,3,58,91,12,161
4100446,0,0,0,27,22,4,53,124,0,177
4100447,3,0,3,32,12,7,51,112,9,172
4100501,0,0,0,58,16,6,80,104,7,191
4100502,60,6,69,53,47,4,104,256,31,391
4100503,3,0,3,32,19,3,54,133,21,208
4100504,0,0,0,34,10,7,51,126,6,183
4100505,0,0,0,44,25,0,69,140,15,224
4100506,3,0,3,41,25,0,66,117,3,186
4100507,4,0,7,68,34,0,102,197,12,311
4100508,6,3,9,74,22,4,100,250,12,362
4100509,6,0,6,67,22,6,95,123,12,230
4100510,4,0,4,79,37,11,127,252,21,400
4100511,0,0,0,32,23,0,55,91,9,155
4100512,0,0,0,41,15,3,59,101,3,163
4100513,0,0,0,53,14,6,73,132,0,205
4100514,47,3,50,37,14,4,55,187,18,260
4100601,19,3,22,61,20,9,90,258,30,378
4100602,3,0,3,57,9,3,69,77,7,153
4100603,0,0,0,43,23,4,70,157,11,238
4100604,0,0,0,50,20,10,80,132,6,218
4100605,0,0,0,44,22,0,66,230,226,522
4100606,3,0,3,80,24,3,107,241,15,363
4100607,6,0,6,75,34,9,118,146,9,273
4100608,6,0,6,87,27,9,123,158,11,292
4100609,6,0,6,84,15,7,106,123,9,238
4100610,4,0,4,29,23,0,52,112,8,172
4100611,6,3,9,55,35,9,99,198,22,319
4100612,35,0,35,37,18,3,58,152,4,214
4100613,0,0,0,70,38,3,111,203,13,327
4100614,3,0,3,61,21,3,85,130,9,224
4100615,0,3,3,83,21,0,104,198,21,323
4100616,6,0,6,86,49,3,138,222,19,379
4100617,6,0,6,73,44,9,126,305,16,447
4100618,3,6,9,121,50,7,178,323,33,534
4100619,3,0,3,60,26,0,86,185,15,286
4100620,6,0,6,72,14,12,98,148,6,252
4100621,9,0,12,72,33,7,112,186,22,320
4100622,0,4,4,33,21,0,54,70,12,136
4100623,6,0,6,53,18,3,74,118,3,195
4100624,32,0,32,44,13,3,60,169,13,242
4100625,0,0,0,20,12,0,32,103,10,145
4100701,3,0,3,41,0,4,45,94,8,147
4100702,10,6,16,62,30,3,95,170,15,280
4100703,5,0,5,72,36,3,111,253,0,364
4100704,27,13,40,15,10,0,25,193,28,246
4100705,0,4,4,23,14,3,40,92,4,136
4100706,3,0,3,69,31,4,104,166,0,270
4100707,0,0,0,48,22,0,70,148,15,233
4100708,46,8,54,26,40,0,66,290,26,382
4100709,0,0,0,46,21,3,70,141,18,229
4100710,48,0,48,39,26,0,65,273,16,354
4100711,5,0,5,161,74,6,241,298,26,565
4100712,0,0,0,113,26,4,143,203,7,353
4100713,0,0,0,62,12,3,77,114,9,200
4100714,3,3,6,108,20,9,137,255,24,416
4100715,0,0,0,48,18,0,66,75,12,153
4100716,3,0,3,120,29,4,153,202,11,366
4100717,6,0,6,44,15,0,59,136,12,207
4100718,0,3,3,96,40,0,136,202,13,351
4100719,0,0,0,74,30,10,114,227,18,359
4100720,4,0,4,51,27,0,78,235,15,328
4100721,0,0,0,80,29,0,109,254,31,394
4100722,0,0,3,79,63,9,151,251,12,414
4100723,0,0,0,95,44,9,148,246,18,412
4100724,0,0,0,113,33,0,146,244,18,408
4100725,0,0,0,108,43,6,157,260,24,441
4100726,3,0,3,124,36,5,165,244,12,421
4100727,6,3,9,51,25,6,82,169,22,273
4100728,3,0,3,149,50,12,211,266,15,492
4100729,3,0,3,32,16,0,48,115,3,166
4100730,0,0,0,62,23,3,88,219,24,331
4100731,0,0,0,61,13,0,74,143,0,217
4100732,0,0,0,92,18,10,120,179,12,311
4100733,0,0,0,209,33,19,261,282,12,555
4100734,0,0,0,168,38,9,215,280,10,505
4100735,3,0,3,94,32,12,138,153,13,304
4100801,0,0,0,42,33,0,75,161,12,248
4100802,0,0,0,39,9,0,48,105,12,165
4100803,3,0,3,116,26,12,154,207,13,374
4100804,0,0,0,72,33,0,105,201,9,315
4100805,6,0,6,34,22,4,60,141,7,208
4100806,0,0,0,49,7,6,62,137,0,199
4100807,0,0,0,67,24,0,91,188,16,295
4100808,3,0,3,37,12,0,49,91,12,152
4100809,0,0,0,48,12,0,60,162,14,236
4100810,0,0,0,75,33,0,108,147,6,261
4100811,3,0,3,47,26,0,73,123,7,203
4100812,0,0,0,46,26,0,72,153,8,233
4100813,5,0,5,86,35,4,125,216,15,356
4100814,0,0,0,104,34,6,144,238,20,402
4100815,6,0,6,45,14,6,65,147,0,212
4100816,6,0,6,135,51,0,186,338,27,551
4100817,3,0,3,57,27,9,93,168,9,270
4100901,0,0,4,86,39,9,134,223,21,378
4100902,0,0,0,94,29,7,130,188,12,330
4100903,0,0,0,51,19,9,79,124,18,221
4100904,0,0,0,198,47,12,257,297,24,578
4100905,0,0,0,72,28,9,109,144,20,273
4100906,0,0,0,157,40,12,209,385,15,609
4100907,0,0,0,112,32,12,156,194,12,362
4100908,0,0,0,53,21,13,87,159,3,249
4100909,3,0,3,36,18,0,54,110,12,176
4100910,3,0,3,39,7,4,50,121,3,174
4101001,6,0,6,54,35,4,93,261,20,374
4101002,0,0,0,0,0,0,0,0,0,0
4101003,8,0,8,86,39,0,125,346,28,499
4101004,3,0,3,58,28,3,89,169,18,276
4101005,4,0,4,91,34,6,131,212,5,348
4101006,0,0,0,0,0,0,0,0,0,0
4101007,4,0,4,55,31,0,86,266,20,372
4101008,3,0,3,114,36,12,162,248,27,437
4101009,6,3,9,91,29,4,124,242,12,378
4101010,0,0,0,71,22,7,100,189,10,299
4101011,6,0,6,43,22,4,69,137,6,212
4101012,0,3,3,62,18,0,80,171,27,278
4101013,0,0,0,68,30,8,106,186,6,298
4101014,3,0,3,84,36,4,124,208,14,346
4101015,0,0,0,0,0,0,0,6,0,6
4101016,20,0,20,39,19,3,61,169,11,241
4101101,7,0,7,78,36,6,120,235,21,376
4101102,6,0,6,48,29,0,77,191,18,286
4101103,8,3,11,87,30,6,123,326,26,475
4101104,0,3,3,76,38,0,114,265,21,400
4101105,6,0,6,73,35,0,108,211,17,336
4101106,9,0,9,57,20,3,80,169,15,264
4101107,18,0,18,71,27,0,98,269,21,388
4101108,10,0,13,41,27,3,71,186,12,269
4101109,6,3,9,74,25,3,102,191,13,306
4101110,0,4,4,55,29,3,87,188,20,295
4101111,5,0,5,60,29,0,89,183,18,290
4101112,8,0,11,43,37,3,83,253,20,356
4101113,6,0,6,67,37,3,107,202,8,317
4101114,20,0,20,87,41,0,128,262,22,412
4101115,14,4,18,78,55,0,133,315,11,459
4101116,3,0,3,57,35,0,92,274,8,374
4101117,0,0,0,42,39,0,81,220,5,306
4101118,4,0,4,32,19,0,51,169,9,229
4101119,9,4,13,72,23,0,95,253,16,364
4101120,0,3,3,89,24,9,122,174,15,311
4101121,8,0,8,51,22,3,76,155,3,234
4101122,3,0,3,40,24,3,67,166,9,242
4101123,3,0,3,56,21,0,77,133,24,234
4101124,6,0,6,64,19,0,83,209,22,314
4101125,26,3,29,53,39,3,95,285,21,401
4101126,7,0,7,83,16,0,99,242,6,347
4101127,10,0,10,82,38,4,124,269,15,408
4101128,8,0,8,110,37,8,155,292,14,461
4101129,0,0,0,62,16,4,82,202,6,290
4101130,7,0,7,50,27,6,83,224,11,318
4101131,6,0,6,43,23,0,66,233,0,299
4101132,12,8,20,67,12,5,84,171,14,269
4101133,20,4,24,72,22,0,94,315,20,429
4101134,15,3,18,51,22,0,73,297,22,392
4101135,27,3,30,33,19,6,58,180,11,249
4101136,10,3,13,41,22,0,63,203,19,285
4101137,18,0,21,43,36,7,86,225,18,329
4101138,13,0,13,52,36,3,91,245,21,357
4101139,18,7,28,96,26,4,126,387,30,543
4101140,6,0,6,50,11,3,64,172,6,242
4101141,10,3,13,67,33,0,100,303,18,421
4101142,6,3,9,81,29,0,110,265,36,411
4101143,6,6,12,74,32,3,109,254,30,393
4101144,28,0,28,90,41,0,131,237,14,382
4101201,6,3,9,66,31,3,100,254,17,371
4101202,7,6,13,43,20,6,69,146,34,249
4101203,3,3,6,51,25,0,76,237,28,341
4101204,0,0,0,61,21,0,82,161,19,262
4101205,22,0,22,69,48,0,117,271,23,411
4101206,10,0,10,59,23,0,82,203,12,297
4101207,64,3,67,77,39,0,116,384,18,518
4101208,3,4,7,48,31,7,86,221,4,311
4101209,6,3,9,75,41,0,116,272,27,415
4101210,3,3,6,86,32,6,124,280,12,416
4101211,6,0,6,43,22,0,65,189,15,269
4101212,14,0,14,105,29,4,138,404,20,562
4101213,9,3,12,82,28,9,119,264,30,413
4101214,20,0,20,32,15,0,47,183,18,248
4101215,10,0,10,81,30,0,111,290,24,425
4101216,9,4,16,74,47,4,125,262,21,408
4101217,4,6,10,55,33,0,88,208,12,308
4101218,7,6,13,51,24,0,75,197,12,284
4101219,14,0,14,81,38,4,123,231,8,362
4101220,3,0,3,83,31,9,123,245,19,387
4101221,10,0,10,39,29,0,68,179,14,261
4101301,3,0,3,44,16,0,60,195,19,274
4101302,13,3,16,38,9,3,50,233,24,307
4101303,23,3,26,87,32,0,119,319,12,450
4101304,6,0,6,84,45,6,135,237,12,384
4101305,12,0,12,66,50,0,116,304,21,441
4101306,27,0,27,47,10,9,66,203,24,293
4101307,16,82,98,53,18,9,80,200,156,436
4101308,9,3,12,53,28,0,81,267,40,388
4101309,3,0,3,97,15,6,118,281,29,428
4101310,6,0,6,97,48,4,149,274,19,442
4101311,33,0,33,58,42,3,103,338,17,458
4101312,4,0,4,39,12,3,54,198,12,264
4101313,95,12,107,0,17,0,17,215,27,259
4101314,9,3,12,69,20,5,94,197,33,324
4101315,6,0,6,71,29,9,109,193,15,317
4101316,3,4,7,106,20,7,133,279,16,428
4101317,71,73,144,56,24,0,80,316,107,503
4101318,32,6,38,72,58,0,130,388,46,564
4101319,5,0,5,47,25,0,72,185,27,284
4101320,19,0,19,53,23,4,80,218,6,304
4101321,4,0,4,90,39,6,135,215,21,371
4101322,4,3,7,124,35,3,162,250,33,445
4101323,5,3,8,79,33,6,118,265,30,413
4101324,6,0,6,69,32,11,112,270,20,402
4101325,12,0,12,84,25,0,109,210,33,352
4101326,6,0,6,71,44,0,115,257,11,383
4101327,58,9,67,75,30,3,108,322,30,460
4101328,3,3,6,20,13,3,36,177,6,219
4101329,6,3,9,67,20,0,87,188,3,278
4101330,25,3,28,49,27,9,85,310,25,420
4101331,13,0,13,55,19,3,77,204,14,295
4101332,7,0,7,37,27,4,68,141,3,212
4101333,3,5,8,46,5,6,57,110,15,182
4101334,10,0,10,61,22,0,83,286,32,401
4101335,3,0,3,38,33,0,71,156,27,254
4101336,4,0,4,22,25,0,47,189,29,265
4101401,6,0,6,70,17,8,95,221,4,320
4101402,0,0,0,77,31,3,111,211,12,334
4101403,0,0,0,39,3,9,51,163,15,229
4101404,7,0,7,55,24,6,85,155,15,255
4101405,6,0,6,75,23,4,102,170,12,284
4101406,3,0,3,51,19,3,73,189,21,283
4101407,0,0,0,0,0,0,0,0,0,0
4101408,0,0,0,42,34,3,79,213,7,299
4101409,0,0,3,38,29,0,67,162,6,235
4101410,6,3,9,90,31,0,121,249,12,382
4101411,3,3,6,74,34,3,111,247,27,385
4101412,7,0,7,54,36,3,93,232,13,338
4101413,0,0,0,86,56,4,146,326,18,490
4101414,0,0,0,51,41,4,96,212,10,318
4101415,0,0,0,104,41,3,148,261,11,420
4101416,7,0,7,79,39,6,124,270,8,402
4101417,0,0,0,65,37,4,106,245,9,360
4101418,3,0,3,43,9,0,52,114,9,175
4101419,6,0,6,26,21,0,47,89,0,136
4101420,3,0,3,65,37,0,102,219,9,330
4101421,6,3,9,107,32,0,139,290,15,444
4101422,3,0,3,61,20,0,81,174,3,258
4101423,0,0,0,0,0,0,0,0,0,0
4101424,4,0,4,54,15,0,69,130,6,205
4101425,0,0,0,29,27,0,56,158,12,226
4101426,0,0,0,59,32,9,100,172,0,272
4101427,0,0,0,24,6,9,39,158,9,206
4101501,6,0,6,58,37,6,101,166,6,273
4101502,11,0,11,69,37,3,109,328,46,483
4101503,39,3,42,72,23,0,95,245,27,367
4101504,4,0,4,56,15,3,74,242,51,367
4101505,104,7,111,33,14,0,47,309,27,383
4101506,8,0,8,106,37,0,143,245,22,410
4101507,32,0,32,32,0,0,32,219,9,260
4101508,6,0,6,39,16,0,55,230,17,302
4101509,9,3,12,63,26,0,89,186,18,293
4101510,23,0,23,54,29,3,86,237,11,334
4101511,4,4,8,62,19,9,90,210,7,307
4101512,34,0,34,95,40,3,138,361,19,518
4101513,8,0,8,32,17,3,52,159,6,217
4101514,3,6,9,46,22,0,68,172,21,261
4101515,13,3,16,66,36,0,102,305,37,444
4101516,3,0,3,52,21,0,73,148,33,254
4101517,0,0,0,42,29,0,71,162,22,255
4101518,0,0,0,74,30,4,108,227,25,360
4101519,3,0,3,72,35,0,107,318,26,451
4101520,0,0,0,56,22,0,78,136,15,229
4101521,3,0,3,67,48,3,118,270,12,400
4101522,0,3,3,56,13,0,69,166,27,262
4101523,12,4,16,84,49,12,145,288,21,454
4101524,0,0,0,31,14,3,48,144,15,207
4101525,0,0,0,25,11,0,36,190,29,255
4101526,10,0,10,69,35,0,104,294,28,426
4101527,11,0,11,56,34,0,90,282,15,387
4101528,14,0,14,50,21,0,71,212,33,316
4101529,3,0,3,104,30,0,134,263,9,406
4101530,4,0,4,73,30,8,111,242,10,363
4101531,7,0,7,65,35,0,100,230,19,349
4101532,3,3,6,78,30,3,111,250,18,379
4101533,6,0,6,50,39,6,95,209,7,311
4101534,39,0,39,65,29,0,94,396,25,515
4101535,6,0,6,40,24,0,64,139,10,213
4101536,6,0,6,61,39,9,109,265,30,404
4101537,3,0,3,100,45,6,151,245,18,414
4101538,82,17,99,63,30,0,93,281,30,404
4101539,3,0,3,28,14,0,42,146,0,188
4101540,6,0,6,87,48,3,138,340,33,511
4101541,6,0,6,82,35,4,121,282,9,412
4101542,26,0,26,36,32,6,74,161,8,243
4101543,3,0,3,47,37,0,84,181,3,268
4101544,8,0,8,53,27,0,80,281,30,391
4101545,6,0,9,59,49,0,108,282,22,412
4101601,17,0,17,104,33,0,137,324,31,492
4101602,10,3,13,93,24,6,123,263,21,407
4101603,72,0,72,74,29,0,103,339,22,464
4101604,38,6,44,56,12,9,77,274,35,386
4101605,8,3,11,61,37,0,98,223,13,334
4101606,11,8,19,84,44,6,134,248,17,399
4101607,7,0,7,72,21,0,93,260,18,371
4101608,7,6,13,73,19,0,92,278,32,402
4101609,6,0,6,78,30,3,111,251,12,374
4101610,8,3,11,131,51,3,185,326,36,547
4101611,3,0,3,73,30,4,107,251,18,376
4101612,8,0,8,68,51,3,122,394,24,540
4101613,0,3,3,51,12,6,69,160,12,241
4101614,3,0,3,22,20,3,45,142,4,191
4101615,3,0,3,48,30,3,81,187,9,277
4101616,8,5,13,96,24,0,120,371,28,519
4101617,10,0,10,51,36,0,87,204,15,306
4101618,8,3,17,93,36,3,132,245,17,394
4101619,11,0,14,90,43,0,133,295,20,448
4101620,5,0,8,54,37,3,94,161,21,276
4101621,25,3,28,75,31,7,113,278,26,417
4101622,8,3,11,45,32,6,83,310,25,418
4101623,5,3,8,69,27,3,99,198,14,311
4101624,4,0,4,62,35,4,101,229,12,342
4101625,8,0,8,46,31,0,77,243,12,332
4101626,12,0,12,63,36,0,99,338,43,480
4101627,0,0,3,57,16,5,78,245,7,330
4101628,9,5,14,97,32,0,129,333,21,483
4101629,0,0,0,43,9,0,52,216,0,268
4101630,9,3,12,54,35,0,89,195,33,317
4101631,6,3,9,78,22,0,100,297,26,423
4101632,11,0,11,65,36,6,107,274,24,405
4101633,12,52,64,47,29,0,76,179,85,340
4101634,9,3,12,112,41,10,163,318,24,505
4101635,10,0,10,105,43,0,148,338,37,523
4101636,9,3,12,125,27,6,158,362,29,549
4101637,28,6,34,36,25,3,64,216,28,308
4101638,6,3,9,51,24,6,81,237,21,339
4101639,0,0,0,49,33,4,86,194,5,285
4101640,13,0,16,107,83,11,201,350,17,568
4101641,13,0,13,88,53,0,141,301,17,459
4101642,7,3,10,49,26,0,75,158,12,245
4101643,6,0,6,41,18,0,59,149,15,223
4101644,11,0,11,39,12,0,51,164,19,234
4101645,6,0,6,52,19,3,74,198,16,288
4101701,6,0,6,37,22,0,59,322,27,408
4101702,0,0,0,54,14,3,71,297,45,413
4101703,3,0,3,50,17,3,70,235,18,323
4101704,20,0,20,50,29,0,79,299,20,398
4101705,3,0,3,43,21,0,64,227,41,332
4101706,3,0,3,35,41,6,82,218,20,320
4101707,9,3,12,53,22,0,75,240,21,336
4101708,33,3,36,43,22,3,68,255,30,353
4101709,19,3,22,53,26,0,79,250,20,349
4101710,4,3,7,63,37,0,100,304,17,421
4101711,9,0,13,31,33,0,64,265,19,348
4101712,9,0,12,27,32,3,62,231,21,314
4101713,3,3,6,60,42,0,102,239,20,361
4101714,6,3,9,38,27,3,68,269,44,381
4101715,22,0,22,37,20,0,57,269,36,362
4101716,6,3,9,35,26,3,64,375,47,486
4101717,8,0,8,16,22,0,38,175,21,234
4101718,15,3,18,70,26,15,111,307,18,436
4101719,21,7,28,92,31,0,123,343,34,500
4101720,42,7,49,28,33,0,61,308,38,407
4101721,8,0,8,51,26,4,81,261,16,358
4101722,10,0,10,69,36,7,112,333,21,466
4101723,10,0,10,43,13,0,56,180,3,239
4101724,0,4,4,17,18,3,38,155,19,212
4101801,15,4,19,66,33,0,99,349,63,511
4101802,13,4,17,41,28,0,69,213,13,295
4101803,12,0,12,85,38,6,129,351,22,502
4101804,13,0,13,42,18,6,66,221,7,294
4101805,21,3,24,45,20,0,65,255,17,337
4101806,13,6,19,60,31,3,94,213,21,328
4101807,9,0,9,87,33,0,120,285,15,420
4101808,8,0,8,73,42,10,125,273,21,419
4101809,4,0,4,49,28,4,81,174,11,266
4101810,16,0,19,56,22,0,78,190,12,280
4101811,18,0,18,84,36,0,120,286,17,423
4101812,42,9,51,51,7,5,63,286,15,364
4101813,3,0,3,37,18,0,55,166,8,229
4101814,4,0,4,44,27,3,74,194,3,271
4101815,12,0,12,90,40,0,130,273,12,415
4101816,11,6,17,78,27,0,105,226,31,362
4101817,5,3,8,87,26,0,113,284,20,417
4101818,15,0,15,38,24,0,62,190,13,265
4101819,6,0,6,49,23,6,78,217,15,310
4101820,3,0,3,37,18,3,58,173,39,270
4101821,76,0,76,41,30,0,71,313,14,398
4101822,11,0,11,66,24,0,90,237,18,345
4101823,137,17,154,17,23,6,46,412,51,509
4101824,43,7,50,91,30,4,125,411,40,576
4101825,13,0,13,32,14,6,52,198,20,270
4101826,3,4,7,62,23,0,85,200,11,296
4101827,0,0,0,54,14,0,68,133,3,204
4101828,16,0,16,64,30,3,97,335,28,460
4101829,6,0,6,44,16,3,63,152,27,242
4101901,6,0,6,36,13,0,49,196,13,258
4101902,12,6,18,41,9,0,50,259,33,342
4101903,31,6,37,45,37,4,86,408,69,563
4101904,3,0,3,75,40,5,120,217,12,349
4101905,6,0,6,39,18,3,60,186,11,257
4101906,6,3,9,53,22,0,75,192,11,278
4101907,12,4,16,40,11,0,51,135,8,194
4101908,0,0,0,60,31,5,96,235,9,340
4101909,6,0,6,41,27,0,68,167,5,240
4101910,3,3,6,75,28,0,103,220,12,335
4101911,3,0,3,51,10,0,61,205,21,287
4101912,12,8,20,59,30,7,96,220,27,343
4101913,8,0,8,75,40,0,115,283,18,416
4101914,15,5,20,44,19,0,63,331,31,425
4101915,76,4,80,60,21,6,87,256,11,354
4101916,10,3,16,46,31,3,80,208,15,303
4101917,7,3,10,84,29,6,119,238,27,384
4101918,6,3,9,74,25,3,102,275,15,392
4101919,7,0,7,45,25,0,70,198,9,277
4101920,6,0,6,77,38,4,119,310,36,465
4101921,9,0,12,62,23,3,88,262,49,399
4101922,6,6,12,51,22,3,76,176,21,273
4101923,17,0,17,75,23,0,98,333,15,446
4101924,0,0,0,51,31,6,88,222,15,325
4101925,4,0,4,69,41,0,110,352,21,483
4101926,8,3,11,103,37,3,143,278,31,452
4101927,6,0,6,71,20,4,95,181,30,306
4101928,3,0,3,52,17,7,76,170,0,246
4101929,0,0,0,54,11,0,65,158,19,242
4101930,3,0,3,43,20,0,63,184,3,250
4101931,6,4,10,72,22,7,101,207,7,315
4101932,12,0,12,122,34,3,159,272,15,446
4102001,6,0,6,47,13,0,60,236,18,314
4102002,15,0,15,50,22,3,75,196,21,292
4102003,10,3,13,70,21,0,91,188,23,302
4102004,21,0,21,83,31,7,121,371,26,518
4102005,12,3,15,61,30,0,91,317,9,417
4102006,7,0,7,115,27,9,151,277,23,451
4102007,12,0,12,126,27,0,153,271,18,442
4102008,8,3,11,69,19,0,88,218,21,327
4102009,7,3,10,60,17,0,77,190,17,284
4102010,3,0,3,77,27,0,104,185,9,298
4102011,8,6,14,91,22,0,113,299,33,445
4102012,4,0,4,65,25,0,90,170,16,276
4102013,10,0,10,39,11,0,50,137,12,199
4102014,11,0,11,81,14,3,98,233,24,355
4102101,5,0,5,66,30,6,102,248,23,373
4102102,8,0,8,99,20,7,126,296,39,461
4102103,6,0,6,70,12,3,85,242,24,351
4102104,11,3,14,90,22,3,115,362,37,514
4102105,10,0,10,57,23,0,80,236,19,335
4102106,6,3,9,103,19,9,131,254,26,411
4102107,6,0,6,49,18,3,70,200,20,290
4102108,3,3,6,81,17,3,101,190,24,315
4102109,3,3,6,101,32,0,133,339,26,498
4102110,3,0,3,68,18,0,86,239,22,347
4102111,29,3,32,64,26,8,98,325,30,453
4102112,0,0,0,0,0,0,0,0,0,0
4102113,0,0,0,69,12,7,88,173,25,286
4102114,3,0,3,55,24,0,79,187,15,281
4102115,3,0,3,45,7,3,55,159,15,229
4102116,6,0,6,67,12,0,79,261,23,363
4102117,8,3,11,59,29,3,91,265,12,368
4102118,9,0,9,53,40,0,93,216,9,318
4102119,6,3,9,85,26,3,114,322,32,468
4102120,3,0,3,71,12,3,86,158,6,250
4102121,73,4,77,79,29,9,117,377,31,525
4102122,0,0,0,91,32,3,126,238,13,377
4102123,9,0,9,56,0,0,56,177,21,254
4102124,3,6,9,34,22,0,56,154,6,216
4102125,17,0,17,88,29,0,117,317,24,458
4102126,7,0,7,69,23,12,104,250,24,378
4102127,6,5,11,62,25,0,87,252,13,352
4102128,3,0,3,46,18,3,67,202,27,296
4102129,3,4,7,45,26,0,71,193,17,281
4102130,3,0,3,40,11,0,51,214,9,274
4102131,3,0,3,35,9,0,44,137,9,190
4102132,7,3,10,57,19,3,79,225,46,350
4102133,8,0,8,81,23,3,107,161,12,280
4102134,11,0,11,80,25,0,105,232,23,360
4102135,6,0,6,17,8,0,25,149,3,177
4102201,91,17,108,48,39,0,87,364,34,485
4102202,17,0,17,46,39,0,85,196,5,286
4102203,21,8,29,56,27,3,86,253,21,360
4102204,9,3,12,59,21,0,80,271,21,372
4102205,3,0,9,57,33,6,96,193,18,307
4102206,8,0,8,71,28,6,105,300,57,462
4102207,13,3,16,67,24,6,97,332,23,452
4102208,3,0,3,12,29,0,41,214,32,287
4102209,6,3,9,59,29,0,88,260,21,369
4102210,13,3,16,77,51,9,137,288,41,466
4102211,8,3,11,98,33,0,131,285,22,438
4102212,6,0,6,49,30,3,82,148,17,247
4102213,13,0,13,66,35,0,101,270,9,380
4102214,11,0,11,43,30,10,83,190,6,279
4102215,6,0,6,45,19,3,67,208,24,299
4102216,0,0,0,63,25,3,91,154,11,256
4102217,6,3,9,52,23,0,75,143,6,224
4102301,8,0,8,79,40,0,119,163,9,291
4102302,10,0,10,93,50,9,152,295,24,471
4102303,11,3,14,64,50,0,114,233,24,371
4102304,7,0,7,82,40,3,125,303,32,460
4102305,3,0,3,91,55,0,146,310,15,471
4102306,4,0,4,51,19,3,73,233,4,310
4102307,7,3,13,85,39,9,133,209,12,354
4102308,10,0,10,103,31,6,140,271,13,424
4102309,0,0,0,96,40,5,141,234,12,387
4102310,8,0,8,100,62,0,162,288,28,478
4102311,22,3,25,43,14,0,57,194,21,272
4102312,7,3,10,98,16,0,114,257,27,398
4102313,6,0,6,45,14,6,65,152,21,238
4102314,0,0,0,70,14,9,93,171,9,273
4102315,0,0,0,64,24,0,88,258,27,373
4102316,7,0,7,51,23,0,74,175,21,270
4102317,6,0,6,25,4,0,29,138,12,179
4102318,0,0,0,63,22,4,89,269,18,376
4102319,0,0,0,67,21,0,88,337,36,461
4102320,0,72,72,30,22,3,55,119,122,296
4102321,3,0,3,30,18,6,54,144,9,207
4102322,5,51,56,46,18,3,67,202,89,358
4102323,6,0,6,70,23,12,105,213,12,330
4102324,7,0,7,69,41,5,115,283,27,425
4102325,4,0,4,98,49,9,156,364,11,531
4102326,3,0,3,50,23,10,83,195,12,290
4102327,3,0,3,66,30,4,100,235,11,346
4102328,11,3,14,64,31,3,98,291,41,430
4102329,3,0,3,61,19,0,80,222,18,320
4102330,11,3,14,99,30,9,138,338,15,491
4102331,8,0,12,78,35,4,117,301,12,430
4102332,13,0,13,59,25,7,91,258,12,361
4102333,6,0,6,68,30,5,103,251,21,375
4102334,6,0,6,80,35,0,115,282,15,412
4102335,7,0,7,67,21,3,91,220,26,337
4102336,0,0,0,52,21,3,76,170,5,251
4102337,7,3,10,56,13,0,69,175,18,262
4102338,12,5,17,40,12,0,52,199,24,275
4102339,15,48,63,51,14,0,65,170,82,317
4102340,33,6,39,20,12,0,32,204,18,254
4102341,10,0,10,48,19,0,67,176,8,251
4102401,5,0,5,51,19,0,70,277,38,385
4102402,3,0,3,63,26,0,89,278,15,382
4102403,7,0,7,58,33,3,94,182,9,285
4102404,11,0,11,48,3,3,54,380,6,440
4102405,11,0,11,119,42,6,167,273,9,449
4102406,0,3,3,59,24,3,86,290,24,400
4102407,10,3,13,60,25,0,85,194,40,319
4102408,3,3,6,54,30,0,84,223,16,323
4102409,0,0,0,69,28,0,97,170,9,276
4102410,8,0,8,85,38,4,127,428,29,584
4102411,3,3,6,77,38,3,118,393,31,542
4102412,8,3,11,112,46,3,161,329,33,523
4102413,9,0,9,121,41,4,166,268,13,447
4102414,6,0,6,67,32,0,99,331,18,448
4102415,30,0,30,78,29,6,113,314,27,454
4102416,13,0,13,77,34,6,117,357,26,500
4102417,7,3,10,107,35,3,145,245,8,398
4102418,50,0,50,112,24,3,139,320,10,469
4102419,3,0,3,80,32,0,112,219,17,348
4102420,149,8,157,64,33,15,112,427,28,567
4102421,39,6,45,91,28,4,123,243,12,378
4102422,13,3,16,41,22,3,66,222,27,315
4102423,21,3,24,84,40,3,127,345,30,502
4102424,111,0,111,67,34,4,105,333,13,451
4102425,42,0,42,72,34,5,111,346,20,477
4102426,9,0,9,82,26,6,114,209,10,333
4102427,178,15,193,19,21,0,40,433,50,523
4102428,3,3,6,93,28,0,121,191,15,327
4102429,5,0,5,84,40,9,133,332,25,490
4102430,7,0,7,101,12,9,122,242,17,381
4102431,9,0,9,64,27,3,94,211,10,315
4102432,3,3,9,80,28,0,108,189,22,319
4102433,4,3,7,75,22,0,97,153,18,268
4102434,10,0,10,72,35,6,113,205,12,330
4102435,3,0,3,58,24,3,85,216,16,317
4102436,9,0,9,63,39,3,105,251,32,388
4102437,61,9,70,79,34,0,113,329,49,491
4102438,9,6,18,53,28,3,84,351,52,487
4102439,18,0,18,106,61,6,173,394,30,597
4102440,3,0,3,42,25,3,70,184,5,259
4102501,0,0,0,104,27,0,131,182,26,339
4102502,0,0,0,51,7,0,58,73,0,131
4102503,0,0,0,86,40,7,133,266,26,425
4102504,0,0,0,30,15,4,49,94,4,147
4102505,3,3,6,60,27,0,87,194,7,288
4102506,7,0,7,81,39,12,132,195,24,351
4102507,4,0,4,139,41,10,190,249,29,468
4102508,12,0,12,58,35,0,93,305,24,422
4102509,12,4,16,48,24,3,75,240,18,333
4102510,12,3,15,81,47,9,137,325,28,490
4102511,0,3,6,75,34,6,115,194,12,321
4102512,0,3,3,94,20,8,122,221,13,356
4102513,3,0,3,110,43,3,156,227,6,389
4102514,0,0,0,96,19,0,115,222,10,347
4102515,4,0,4,93,18,6,117,173,7,297
4102516,0,0,0,46,6,6,58,59,4,121
4102517,0,0,0,86,19,0,105,150,12,267
4102518,0,0,0,119,20,13,152,110,3,265
4102519,0,0,0,63,30,3,96,105,3,204
4102520,0,0,0,47,18,0,65,102,3,170
4102521,0,0,0,108,9,7,124,146,15,285
4102522,5,0,5,46,22,4,72,198,25,295
4102523,0,0,0,0,0,0,0,0,0,0
4102601,0,0,0,86,36,8,130,249,56,435
4102602,8,0,8,69,23,3,95,190,20,305
4102603,7,3,10,40,21,0,61,174,25,260
4102604,9,3,12,60,18,3,81,209,66,356
4102605,6,0,6,39,13,0,52,116,11,179
4102606,15,0,15,34,12,0,46,174,8,228
4102607,0,0,0,46,21,3,70,171,18,259
4102608,6,3,9,78,45,3,126,322,11,459
4102609,39,3,42,85,54,10,149,377,29,555
4102610,8,0,8,53,26,4,83,195,23,301
4102611,20,3,23,53,26,0,79,219,31,329
4102612,11,6,17,41,28,0,69,214,28,311
4102613,6,0,6,47,21,0,68,135,9,212
4102614,3,0,3,49,24,0,73,245,12,330
4102615,3,0,3,65,15,3,83,215,16,314
4102616,3,3,6,38,12,3,53,146,15,214
4102617,3,3,6,17,16,0,33,88,3,124
4102618,3,0,3,21,21,3,45,110,9,164
4102619,6,3,9,86,44,0,130,410,46,586
4102620,0,0,0,0,0,0,0,0,0,0
4102621,5,0,5,70,32,6,108,174,11,293
4102622,27,6,33,3,31,0,34,366,33,433
4102623,6,3,9,142,59,9,210,457,50,717
4102624,3,0,3,69,26,0,95,140,21,256
4102625,6,0,6,111,47,9,167,258,22,447
4102626,17,0,17,65,46,3,114,296,25,435
4102627,0,0,0,39,35,0,74,156,13,243
4102628,4,0,4,73,44,4,121,256,22,399
4102629,0,0,0,120,24,6,150,243,18,411
4102630,6,0,6,113,33,6,152,252,26,430
4102631,0,0,0,62,3,4,69,115,3,187
4102632,3,4,7,108,33,0,141,300,35,476
4102633,15,0,15,78,33,0,111,261,20,392
4102634,7,6,13,41,26,6,73,193,18,284
4102635,0,4,4,61,23,0,84,176,30,290
4102636,5,6,11,36,28,0,64,222,24,310
4102637,13,3,16,65,28,0,93,235,33,361
4102638,0,0,0,49,24,0,73,126,9,208
4102639,15,7,22,121,30,3,154,302,34,490
4102640,0,0,0,49,6,7,62,120,5,187
4102641,3,3,6,45,29,0,74,124,6,204
4102642,8,8,16,22,4,0,26,117,26,169
4102643,55,3,58,23,15,3,41,222,12,275
4102644,6,3,9,40,13,0,53,128,26,207
4102645,0,5,5,48,21,0,69,168,22,259
4102646,0,0,0,49,10,4,63,82,15,160
4102647,0,0,0,0,0,0,0,0,0,0
4102701,0,0,0,72,7,6,85,116,12,213
4102702,3,0,3,91,31,3,125,240,15,380
4102703,0,0,0,53,10,3,66,121,12,199
4102704,0,0,0,71,12,3,86,147,21,254
4102705,0,0,0,51,16,7,74,113,13,200
4102706,0,0,0,45,19,7,71,131,12,214
4102707,4,3,7,44,27,0,71,137,18,226
4102708,3,0,3,65,27,6,98,186,14,298
4102709,3,3,6,44,27,3,74,111,3,188
4102710,0,0,0,63,26,3,92,160,0,252
4102711,0,0,0,57,20,4,81,202,29,312
4102712,0,0,0,85,20,8,113,242,19,374
4102713,0,0,0,83,34,0,117,246,10,373
4102714,0,0,0,45,14,0,59,164,9,232
4102715,0,0,0,33,18,0,51,133,21,205
4102716,0,0,0,50,18,3,71,115,18,204
4102801,3,0,3,71,24,3,98,198,12,308
4102802,3,0,3,73,12,0,85,207,9,301
4102803,0,0,0,90,33,9,132,179,11,322
4102804,6,0,6,96,28,7,131,216,14,361
4102805,6,0,6,104,47,7,158,336,16,510
4102806,59,4,63,71,31,12,114,392,23,529
4102807,6,4,10,71,25,0,96,191,46,333
4102808,0,0,0,33,22,3,58,111,19,188
4102809,0,0,0,110,40,8,158,271,29,458
4102810,0,0,0,148,39,3,190,277,18,485
4102811,0,0,0,60,17,3,80,129,4,213
4102812,0,0,0,83,29,3,115,238,35,388
4102813,3,0,3,85,23,11,119,187,18,324
4102814,6,3,9,76,28,3,107,221,21,349
4102815,0,0,0,178,46,8,232,290,17,539
4102816,0,0,0,260,49,7,316,319,25,660
4102817,41,3,44,114,25,0,139,284,16,439
4102818,0,0,0,149,36,7,192,343,17,552
4102819,0,0,0,79,32,0,111,207,7,325
4102820,0,0,0,88,46,0,134,244,13,391
4102821,0,0,0,102,10,6,118,126,9,253
4102822,0,0,0,108,37,9,154,164,9,327
4102823,3,0,3,67,23,0,90,184,39,313
4102824,3,0,3,118,33,19,170,183,15,368
4102825,0,0,0,101,22,9,132,268,9,409
4102826,0,3,3,74,22,3,99,181,21,301
4102827,0,4,4,106,27,4,137,232,24,393
4102828,0,0,0,43,27,3,73,164,25,262
4102829,3,0,3,120,41,0,161,261,25,447
4102830,0,0,0,108,53,4,165,288,31,484
4102831,0,0,0,167,33,4,204,334,18,556
4102832,0,0,0,37,25,4,66,142,7,215
4102901,0,0,0,36,17,3,56,149,32,237
4102902,0,0,0,81,10,10,101,163,15,279
4102903,0,0,0,87,33,0,120,214,16,350
4102904,3,0,3,92,32,0,124,188,15,327
4102905,3,0,3,95,27,0,122,128,9,259
4102906,3,0,3,73,24,5,102,245,48,395
4102907,5,0,5,72,35,6,113,263,48,424
4102908,0,0,0,219,62,7,288,459,61,808
4102909,5,0,5,65,25,0,90,243,49,382
4102910,6,0,6,46,37,0,83,194,51,328
4102911,43,11,54,67,19,0,86,289,57,432
4102912,3,6,9,39,12,6,57,158,33,248
4102913,0,0,0,95,18,5,118,218,41,377
4102914,3,0,3,50,16,3,69,156,27,252
4102915,0,0,0,31,20,0,51,107,34,192
4102916,0,0,0,31,15,0,46,130,25,201
4102917,3,0,3,120,23,6,149,308,68,525
4102918,3,3,6,55,27,3,85,202,47,334
4102919,0,0,0,670,181,47,898,1124,163,2185
4102920,0,0,0,132,38,10,180,229,28,437
4102921,0,0,0,86,23,8,117,204,21,342
4102922,0,0,0,0,0,0,0,3,0,3
4102923,0,0,0,63,22,3,88,209,34,331
4102924,0,0,0,64,26,7,97,187,31,315
4102925,6,0,6,72,35,0,107,261,37,405
4102926,8,3,11,48,24,0,72,193,22,287
4102927,3,4,7,80,25,4,109,253,34,396
4102928,0,0,0,28,7,0,35,67,6,108
4102929,0,0,0,63,12,3,78,107,6,191
4103001,6,3,9,53,24,0,77,197,31,305
4103002,0,0,0,0,0,0,0,0,0,0
4103003,12,0,12,69,36,12,117,367,54,538
4103004,8,0,8,73,22,3,98,252,40,390
4103005,10,0,10,45,23,6,74,251,36,361
4103006,6,3,9,82,16,6,104,265,49,418
4103007,3,0,3,59,27,12,98,277,39,414
4103008,3,3,6,51,13,3,67,147,28,242
4103009,4,0,4,69,21,3,93,231,46,370
4103010,9,0,9,52,16,12,80,287,29,396
4103011,6,0,6,31,22,6,59,210,31,300
4103012,8,3,11,58,14,3,75,258,31,364
4103013,6,0,6,47,11,0,58,158,31,247
4103014,3,0,3,45,11,4,60,167,37,264
4103015,11,6,17,36,21,0,57,204,32,293
4103016,0,0,0,0,0,0,0,0,0,0
4103017,0,0,0,22,0,0,22,96,15,133
4103018,0,3,3,51,18,3,72,184,14,270
4103019,9,0,9,62,25,0,87,230,53,370
4103020,69,20,89,27,6,3,36,248,50,334
4103021,9,0,9,32,23,5,60,168,10,238
4103022,4,0,4,59,28,0,87,275,33,395
4103023,16,6,22,83,21,0,104,317,42,463
4103024,3,3,6,47,31,3,81,187,13,281
4103025,0,0,0,0,0,0,0,0,0,0
4103026,6,6,12,32,31,0,63,208,56,327
4103027,6,6,12,25,13,3,41,92,6,139
4103101,7,0,7,75,15,8,98,231,47,376
4103102,3,3,6,66,30,5,101,235,13,349
4103103,3,0,3,39,39,3,81,191,15,287
4103104,7,0,7,34,21,3,58,123,11,192
4103105,48,3,51,56,24,0,80,342,15,437
4103106,0,0,0,74,27,7,108,301,14,423
4103107,6,0,6,65,34,3,102,188,13,303
4103108,3,0,3,51,29,0,80,130,23,233
4103109,0,0,0,54,19,7,80,221,18,319
4103110,9,0,9,78,40,0,118,277,31,426
4103111,0,0,0,59,35,3,97,206,31,334
4103112,3,3,6,40,14,0,54,169,22,245
4103113,3,0,3,103,44,3,150,267,19,436
4103114,0,0,0,58,32,0,90,292,9,391
4103115,3,0,3,56,23,3,82,179,18,279
4103116,5,3,8,40,24,0,64,142,21,227
4103117,13,3,16,57,14,0,71,220,42,333
4103118,25,0,25,55,18,6,79,170,13,262
4103119,0,0,0,41,28,0,69,168,35,272
4103120,0,0,0,102,43,0,145,216,16,377
4103121,25,3,28,64,27,0,91,318,39,448
4103122,10,3,13,41,18,6,65,146,18,229
4103123,14,4,18,70,33,0,103,238,56,397
4103124,3,0,3,81,24,0,105,206,12,323
4103125,0,0,0,89,26,0,115,163,10,288
4103126,3,0,3,79,15,4,98,128,6,232
4103127,13,9,22,78,27,0,105,274,43,422
4103128,3,0,3,50,18,4,72,161,26,259
4103129,6,0,6,57,3,4,64,117,0,181
4103130,0,0,0,52,29,3,84,164,12,260
4103131,0,0,0,47,13,0,60,87,22,169
4103201,3,0,3,18,9,3,30,110,26,166
4103202,0,3,3,291,55,20,366,394,72,832
4103203,0,0,0,234,67,9,310,450,56,816
4103204,3,0,3,210,36,15,261,401,36,698
4103205,0,0,0,47,9,0,56,156,15,227
4103206,4,0,4,43,30,0,73,217,6,296
4103207,0,0,0,78,24,7,109,143,3,255
4103208,3,0,3,89,36,8,133,166,13,312
4103209,0,0,0,193,29,0,222,202,14,438
4103210,3,0,3,144,37,12,193,202,31,426
4103211,0,0,0,16,15,0,31,95,3,129
4103212,0,0,0,239,58,17,314,398,25,737
4103213,4,0,4,59,28,3,90,258,39,387
4103301,3,0,3,54,23,3,80,195,22,297
4103302,3,0,3,26,21,0,47,119,26,192
4103303,0,0,0,19,16,0,35,123,21,179
4103304,6,0,6,60,41,6,107,219,19,345
4103305,8,0,8,42,28,3,73,178,12,263
4103306,0,0,0,58,27,4,89,147,6,242
4103307,0,0,0,3,3,0,6,6,0,12
4103308,0,0,0,76,29,8,113,160,6,279
4103309,0,0,0,48,18,0,66,90,0,156
4103401,0,0,0,84,31,0,115,232,11,358
4103402,3,3,6,64,36,0,100,195,37,332
4103403,13,6,19,56,20,0,76,194,33,303
4103404,4,0,4,33,20,4,57,164,24,245
4103405,0,0,0,60,29,12,101,224,15,340
4103406,3,0,3,53,29,3,85,162,18,265
4103407,0,0,0,94,25,4,123,258,43,424
4103408,8,0,8,38,18,0,56,185,25,266
4103409,0,0,0,74,9,6,89,184,27,300
4103410,6,0,6,47,23,6,76,179,23,278
4103411,37,0,37,31,18,3,52,287,13,352
4103412,3,0,3,42,38,3,83,248,20,351
4103413,0,0,0,74,28,7,109,161,27,297
4103414,4,0,4,60,18,3,81,208,42,331
4103415,5,0,5,67,28,3,98,248,36,382
4103416,5,0,5,48,25,0,73,175,33,281
4103417,7,3,10,71,28,4,103,192,29,324
4103418,6,0,6,47,16,0,63,198,21,282
4103419,11,0,11,39,24,3,66,241,35,342
4103420,3,4,7,49,21,0,70,208,38,316
4103421,7,3,10,97,40,0,137,235,20,392
4103422,3,0,6,32,37,3,72,181,12,265
4103423,0,3,3,62,26,3,91,160,10,261
4103424,0,4,4,74,36,13,123,248,26,397
4103425,3,0,3,66,35,4,105,243,46,394
4103426,6,0,6,67,30,3,100,214,31,345
4103427,6,3,9,95,39,10,144,287,23,454
4103428,0,0,0,41,17,0,58,127,19,204
4103429,0,0,0,77,27,0,104,229,71,404
4103501,6,0,6,35,37,0,72,384,52,508
4103502,0,0,0,40,10,4,54,205,31,290
4103503,3,0,3,44,22,6,72,132,14,218
4103504,0,0,0,24,7,0,31,105,27,163
4103505,0,0,0,33,13,0,46,151,26,223
4103506,0,0,0,30,14,0,44,81,9,134
4103507,0,0,0,74,45,0,119,315,48,482
4103508,5,0,5,124,40,10,174,378,33,585
4103509,8,3,11,52,47,4,103,403,36,542
4103601,3,0,3,27,6,4,37,120,10,167
4103602,0,0,0,0,0,0,0,0,0,0
4103603,5,0,5,90,56,3,149,284,46,479
4103604,10,0,10,47,22,6,75,204,51,330
4103605,15,0,15,87,32,3,122,285,43,450
4103606,3,0,3,46,14,0,60,178,32,270
4103607,3,3,6,66,24,0,90,241,53,384
4103608,6,0,6,63,20,0,83,229,29,341
4103609,3,6,9,70,20,3,93,204,47,344
4103610,14,0,14,86,24,3,113,344,44,501
4103611,15,3,18,82,26,3,111,284,15,410
4103612,15,0,19,83,17,3,103,271,20,394
4103613,11,0,11,54,18,9,81,231,52,364
4103614,13,5,18,52,19,0,71,233,20,324
4103615,15,0,15,76,30,3,109,228,27,364
4103616,22,3,25,103,31,10,144,305,35,484
4103617,6,3,9,66,34,4,104,313,54,471
4103618,6,6,12,84,19,3,106,306,28,440
4103619,10,5,15,79,24,0,103,273,22,398
4103620,9,3,12,78,24,0,102,288,45,435
4103621,10,6,16,110,35,6,151,396,39,586
4103622,8,0,8,72,31,3,106,335,38,479
4103623,14,3,17,83,32,0,115,293,46,454
4103624,14,0,14,63,13,3,79,282,41,402
4103625,10,0,10,56,15,0,71,230,54,355
4103626,10,0,10,59,16,0,75,233,21,329
4103627,6,6,12,55,14,9,78,162,23,263
4103628,9,6,15,83,25,3,111,276,55,442
4103629,11,0,11,50,14,12,76,208,15,299
4103630,8,0,8,79,25,3,107,210,15,332
4103631,9,3,12,89,33,3,125,340,56,521
4103632,9,3,12,67,23,6,96,211,40,347
4103633,7,3,13,70,28,0,98,228,28,354
4103634,5,3,8,62,22,6,90,237,31,358
4103635,41,12,53,43,23,6,72,281,30,383
4103636,13,0,13,85,30,6,121,319,33,473
4103637,9,6,15,85,40,0,125,260,21,406
4103638,0,0,0,50,25,0,75,164,8,247
4103639,5,0,5,38,9,0,47,173,21,241
4103640,22,0,22,74,23,9,106,221,32,359
4103641,7,0,7,55,16,0,71,277,44,392
4103642,102,14,116,54,29,6,89,381,46,516
4103643,10,0,10,75,40,3,118,300,19,437
4103644,11,31,42,58,27,0,85,250,99,434
4103645,0,0,0,0,0,0,0,0,0,0
4103646,4,29,33,71,24,0,95,292,90,477
4103647,0,0,0,0,0,0,0,12,0,12
4103648,0,0,0,0,0,0,0,0,0,0
4103649,6,0,9,24,19,9,52,175,33,260
4103650,3,0,3,32,6,0,38,136,22,196
4103651,0,0,0,0,0,0,0,0,0,0
4103701,3,3,6,61,30,3,94,191,12,297
4103702,0,0,0,84,37,6,127,148,6,281
4103703,3,0,3,71,27,0,98,198,15,311
4103704,0,0,0,74,17,0,91,167,6,264
4103705,3,0,3,56,36,3,95,249,21,365
4103706,6,0,6,78,36,3,117,275,18,410
4103707,0,0,0,45,17,0,62,121,21,204
4103708,3,0,3,38,16,0,54,171,18,243
4103709,0,0,3,82,43,7,132,271,12,415
4103710,4,0,4,45,10,0,55,139,15,209
4103711,3,0,3,41,19,7,67,186,4,257
4103712,10,0,10,122,45,9,176,392,20,588
4103713,20,3,23,3,0,0,3,165,14,182
4103714,6,3,9,88,27,0,115,314,27,456
4103715,0,0,0,81,33,4,118,270,18,406
4103716,0,0,0,0,0,0,0,0,629,629
4103717,3,6,9,56,20,0,76,215,33,324
4103718,7,0,7,42,26,3,71,191,31,293
4103719,6,3,9,50,15,0,65,198,29,292
4103720,6,0,6,54,12,0,66,151,29,246
4103721,4,0,4,81,30,0,111,243,34,388
4103722,48,0,48,36,30,3,69,180,6,255
4103723,0,0,0,61,34,6,101,188,12,301
4103724,0,3,3,71,24,0,95,288,28,411
4103725,3,0,3,82,18,10,110,193,4,307
4103726,3,0,3,39,16,3,58,154,21,233
4103727,8,0,8,77,54,0,131,304,8,443
4103728,3,3,6,94,30,4,128,269,20,417
4103729,0,0,0,86,33,0,119,173,7,299
4103730,3,3,6,131,17,6,154,234,30,418
4103731,0,0,0,160,41,8,209,209,18,436
4103732,0,0,0,64,40,0,104,243,18,365
4103733,3,0,3,63,37,3,103,180,25,308
4103734,3,0,3,51,23,9,83,162,12,257
4103735,0,0,0,87,37,5,129,318,18,465
4103736,23,3,26,108,25,4,137,376,42,555
4103737,3,0,3,91,18,0,109,209,24,342
4103738,3,0,3,55,49,0,104,260,22,386
4103739,3,3,6,71,36,9,116,298,16,430
4103740,3,0,6,47,37,0,84,192,14,290
4103741,4,0,4,105,38,6,149,221,10,380
4103742,9,3,12,93,35,0,128,259,21,408
4103743,0,0,0,75,15,3,93,144,22,259
4103744,0,0,0,50,24,6,80,133,3,216
4103745,4,0,4,16,12,0,28,135,24,187
4103746,8,0,8,77,26,0,103,267,76,446
4103747,13,7,20,57,18,0,75,276,64,415
4103748,0,0,0,56,15,0,71,70,10,151
4103749,3,3,6,41,15,0,56,170,34,260
4103750,8,3,11,69,22,0,91,161,6,258
4103801,9,6,15,57,35,0,92,265,38,395
4103802,7,6,13,47,26,0,73,220,38,331
4103803,6,3,9,70,24,0,94,338,27,459
4103804,9,3,12,51,34,3,88,279,13,380
4103805,9,0,9,70,38,0,108,297,27,432
4103806,3,0,3,78,25,3,106,265,30,401
4103807,8,3,11,94,36,0,130,352,40,522
4103808,5,3,8,44,15,9,68,262,32,362
4103809,6,3,9,73,39,0,112,220,19,351
4103810,9,0,9,60,28,9,97,245,20,362
4103811,3,3,6,84,11,0,95,342,40,477
4103812,5,3,8,53,27,4,84,228,15,327
4103813,12,4,16,86,51,8,145,357,22,524
4103814,7,0,7,112,25,6,143,349,38,530
4103815,7,3,10,65,9,4,78,257,38,373
4103816,13,0,13,50,22,0,72,250,22,344
4103817,0,0,0,69,45,4,118,287,40,445
4103818,3,0,3,50,26,3,79,205,15,299
4103819,6,0,6,64,35,6,105,247,18,370
4103820,3,3,6,105,21,5,131,288,39,458
4103821,3,6,9,71,32,0,103,247,30,380
4103822,6,3,9,72,20,3,95,226,27,348
4103823,26,7,33,71,25,6,102,296,42,440
4103824,10,6,16,77,23,5,105,239,35,379
4103825,6,3,9,129,31,4,164,334,27,525
4103826,7,3,10,41,44,4,89,229,21,339
4103827,6,3,9,50,22,3,75,221,26,322
4103828,7,0,7,82,23,0,105,223,30,358
4103829,16,0,16,83,37,0,120,333,41,494
4103830,5,0,5,87,37,9,133,328,20,481
4103831,12,42,54,64,23,0,87,244,92,423
4103832,12,3,15,59,15,0,74,251,34,359
4103833,6,0,6,112,39,6,157,266,21,444
4103834,3,0,3,75,24,6,105,189,27,321
4103835,3,0,3,103,26,6,135,349,36,520
4103836,8,15,23,36,15,3,54,144,34,232
4103837,9,3,15,38,35,0,73,246,15,334
4103838,6,3,9,62,34,3,99,280,20,399
4103839,3,0,3,74,20,0,94,177,6,277
4103901,0,0,0,0,0,0,0,3,0,3
4104001,0,0,0,55,27,0,82,252,21,355
4104002,3,0,3,76,32,0,108,288,16,412
4104003,7,0,7,51,27,4,82,251,9,342
4104004,0,0,0,46,30,0,76,164,20,260
4104005,3,0,3,71,45,0,116,314,38,468
4104006,3,0,3,69,39,0,108,269,15,392
4104007,8,0,8,31,20,0,51,154,15,220
4104008,0,0,0,29,28,0,57,206,24,287
4104009,0,0,0,39,24,0,63,150,6,219
4104010,57,3,60,29,10,4,43,264,28,335
4104011,0,0,0,147,55,9,211,248,32,491
4104012,9,4,13,63,19,3,85,203,18,306
4104013,0,0,0,101,24,9,134,182,9,325
4104014,62,5,67,22,22,0,44,302,24,370
4104015,0,0,0,70,18,6,94,165,7,266
4104016,0,0,0,80,24,0,104,134,0,238
4104017,0,0,0,139,20,4,163,270,14,447
4104018,6,0,6,84,34,0,118,244,21,383
4104019,6,0,6,65,46,0,111,235,16,362
4104020,3,0,3,40,21,0,61,162,4,227
4104021,62,0,62,54,26,0,80,267,21,368
4104022,8,0,8,58,29,7,94,288,27,409
4104023,0,0,0,67,33,9,109,235,26,370
4104024,0,0,0,54,36,4,94,228,24,346
4104025,8,0,8,86,46,0,132,277,25,434
4104026,6,0,6,56,37,0,93,217,18,328
4104027,6,0,6,76,27,3,106,257,19,382
4104028,0,3,3,46,36,0,82,205,16,303
4104029,0,0,0,0,0,0,0,0,0,0
4104030,0,3,3,45,36,3,84,251,18,353
4104031,9,6,15,41,28,4,73,232,19,324
4104032,0,0,0,50,22,5,77,128,22,227
4104033,4,0,4,51,25,3,79,179,26,284
4104034,0,0,0,65,35,0,100,177,6,283
4104035,3,3,6,74,40,3,117,196,12,325
4104036,0,0,0,37,24,12,73,173,12,258
4104037,5,0,5,44,29,12,85,211,25,321
4104101,0,0,0,62,34,3,99,162,3,264
4104102,6,4,10,86,28,0,114,264,47,425
4104103,3,5,8,55,36,0,91,278,25,394
4104104,7,0,7,106,27,5,138,317,42,497
4104105,3,0,3,69,32,3,104,213,21,338
4104106,0,4,4,90,49,5,144,334,28,506
4104107,3,0,3,58,28,4,90,180,0,270
4104108,3,3,6,62,7,3,72,163,27,262
4104109,6,3,9,50,5,4,59,162,21,242
4104110,3,0,3,65,32,3,100,255,29,384
4104111,5,0,5,87,16,0,103,208,35,346
4104112,3,3,6,68,29,3,100,225,14,339
4104113,0,0,0,33,32,9,74,181,12,267
4104114,0,0,0,64,39,3,106,247,22,375
4104115,0,0,0,43,21,3,67,122,18,207
4104116,0,3,3,70,17,3,90,156,23,269
4104117,8,3,11,90,34,0,124,269,32,425
4104118,9,0,9,60,31,6,97,266,44,407
4104119,4,5,9,61,30,0,91,209,22,322
4104120,0,3,3,80,33,6,119,212,21,352
4104121,25,3,28,63,30,3,96,274,21,391
4104122,0,0,0,61,29,3,93,187,16,296
4104123,4,0,4,48,36,5,89,236,43,368
4104124,0,0,0,116,11,7,134,242,9,385
4104125,0,0,0,78,23,3,104,229,21,354
4104126,7,0,7,69,32,0,101,196,13,310
4104127,0,0,0,87,24,3,114,179,12,305
4104128,0,0,0,35,27,3,65,146,3,214
4104129,6,3,9,62,38,3,103,183,24,310
4104130,4,0,4,83,44,0,127,253,18,398
4104131,0,0,0,73,23,3,99,162,16,277
4104132,0,0,0,33,9,3,45,127,13,185
4104133,3,0,3,33,20,0,53,173,19,245
4104134,0,0,0,39,12,3,54,127,3,184
4104135,0,0,0,0,0,0,0,0,0,0
4104136,0,0,0,50,29,4,83,126,18,227
4104137,0,0,0,0,0,0,0,3,0,3
4104138,5,0,5,74,23,3,100,197,30,327
4104201,0,0,0,0,0,0,0,77,0,77
4104301,0,0,0,113,44,6,163,266,12,441
4104302,0,0,0,125,40,7,172,293,18,483
4104303,54,0,54,21,8,0,29,180,24,233
4104304,0,0,0,69,36,3,108,250,19,377
4104305,33,4,37,22,12,0,34,196,27,257
4104306,3,0,3,64,24,0,88,198,22,308
4104307,8,0,8,26,13,0,39,178,19,236
4104308,3,0,3,56,12,0,68,191,18,277
4104309,10,0,10,58,28,4,90,231,26,347
4104310,6,0,6,80,24,5,109,272,28,409
4104311,0,0,0,63,34,6,103,199,21,323
4104312,0,0,0,79,26,4,109,188,17,314
4104313,0,0,0,86,27,0,113,244,21,378
4104314,4,0,4,71,21,0,92,175,24,291
4104315,6,0,6,60,24,0,84,242,21,347
4104316,0,0,0,123,33,6,162,227,11,400
4104317,3,0,3,47,24,4,75,168,9,252
4104318,3,3,6,66,21,0,87,189,33,309
4104319,4,0,4,53,23,0,76,189,13,278
4104320,0,0,0,59,37,0,96,206,18,320
4104321,5,0,5,84,44,3,131,281,27,439
4104322,0,0,0,148,56,6,210,456,35,701
4104323,0,0,0,145,43,8,196,286,16,498
4104324,0,0,0,54,21,3,78,186,26,290
4104325,0,0,0,33,18,0,51,115,30,196
4104326,3,0,3,46,16,4,66,191,22,279
4104327,6,0,6,27,31,0,58,201,24,283
4104328,0,3,3,36,12,3,51,141,15,207
4104329,9,6,15,68,29,0,97,337,49,483
4104330,6,0,6,57,7,0,64,169,15,248
4104331,0,0,0,119,35,0,154,252,13,419
4104332,0,0,0,100,13,0,113,222,25,360
4104333,0,0,0,69,24,0,93,196,17,306
4104334,0,0,0,36,9,0,45,106,18,169
4104335,3,0,3,45,31,0,76,195,17,288
4104336,0,0,0,40,17,3,60,143,4,207
4104337,0,0,0,86,25,9,120,161,0,281
4104401,0,0,0,130,30,4,164,263,26,453
4104402,0,0,0,84,42,0,126,242,16,384
4104403,0,0,0,86,11,0,97,151,7,255
4104404,0,0,0,100,35,0,135,258,36,429
4104405,0,0,0,59,32,9,100,247,21,368
4104406,3,0,3,70,29,6,105,199,15,319
4104407,0,0,0,96,33,7,136,191,42,369
4104408,0,0,0,39,19,0,58,124,24,206
4104409,0,0,0,89,28,3,120,162,20,302
4104410,6,0,6,71,24,0,95,199,30,324
4104411,0,0,0,105,18,0,123,181,29,333
4104412,0,0,0,39,23,0,62,209,20,291
4104413,0,0,0,52,26,3,81,187,19,287
4104414,0,0,0,66,17,3,86,185,27,298
4104415,0,0,0,12,13,0,25,136,18,179
4104416,0,0,0,82,31,0,113,176,21,310
4104417,6,0,6,87,32,4,123,256,28,407
4104418,0,0,0,152,31,15,198,303,28,529
4104419,0,0,0,119,49,6,174,264,19,457
4104420,0,0,0,45,27,0,72,159,11,242
4104421,0,3,3,76,27,7,110,252,26,388
4104422,0,0,0,85,19,7,111,219,30,360
4104423,5,0,5,106,13,6,125,239,18,382
4104424,0,0,0,114,46,4,164,233,25,422
4104425,3,3,6,86,14,0,100,168,18,286
4104426,0,0,0,77,33,0,110,130,15,255
4104427,0,0,0,70,33,0,103,205,27,335
4104428,3,0,3,85,32,0,117,246,20,383
4104429,0,0,0,78,26,10,114,239,19,372
4104430,3,0,3,61,24,6,91,160,18,269
4104431,0,0,0,95,33,3,131,153,13,297
4104432,0,0,0,69,30,9,108,149,9,266
4104433,0,0,0,56,28,0,84,108,24,216
4104434,6,3,9,77,24,4,105,182,16,303
4104435,0,0,0,60,13,0,73,78,28,179
4104436,4,0,4,85,10,3,98,167,22,287
4104437,0,0,0,80,37,4,121,140,11,272
4104438,0,0,0,72,25,6,103,141,21,265
4104501,31,0,31,87,44,6,137,402,50,589
4104502,14,0,14,51,25,3,79,242,10,331
4104503,5,0,5,88,51,6,145,309,38,492
4104504,8,0,8,53,23,0,76,207,38,321
4104505,0,0,0,63,37,0,100,213,27,340
4104506,3,6,9,52,29,0,81,184,65,330
4104507,7,0,7,44,16,0,60,152,51,263
4104508,3,0,3,49,33,0,82,261,27,370
4104509,0,0,0,31,21,3,55,171,21,247
4104510,3,0,3,103,48,3,154,261,16,431
4104511,0,0,0,64,16,3,83,234,22,339
4104512,6,0,6,63,25,4,92,267,21,380
4104513,0,0,0,61,24,6,91,146,10,247
4104514,0,0,0,54,22,3,79,162,27,268
4104515,6,0,6,54,32,0,86,218,18,322
4104516,0,0,0,0,0,0,0,3,0,3
4104517,0,0,0,121,19,7,147,223,15,385
4104518,6,0,6,60,32,0,92,185,23,300
4104519,0,0,0,0,0,0,0,6,0,6
4104520,0,0,3,213,52,9,274,616,50,940
4104521,6,0,6,85,32,3,120,555,170,845
4104522,0,0,0,107,19,0,126,244,14,384
4104523,3,0,3,77,22,0,99,172,8,279
4104524,0,0,0,104,25,6,135,274,15,424
4104525,0,0,0,113,33,6,152,277,9,438
4104526,0,0,0,118,33,9,160,225,16,401
4104527,3,0,3,36,22,0,58,122,24,204
4104528,0,0,0,0,0,0,0,0,0,0
4104529,0,0,0,256,46,0,302,550,64,916
4104530,3,0,3,105,18,7,130,399,15,544
4104531,0,0,0,56,18,0,74,177,6,257
4104532,0,0,0,86,34,12,132,240,39,411
4104533,0,0,0,328,74,4,406,769,53,1228
4104534,0,0,0,156,29,11,196,381,39,616
4104535,7,3,10,40,12,0,52,197,6,255
4104536,6,52,58,36,18,9,63,148,96,307
4104537,0,0,0,106,25,6,137,253,19,409
4104601,10,0,10,59,34,4,97,240,15,352
4104602,13,28,41,55,26,6,87,313,121,521
4104603,6,0,6,100,22,3,125,312,54,491
4104604,10,0,10,82,28,0,110,263,39,412
4104605,13,0,13,80,38,0,118,302,29,449
4104606,9,0,9,61,23,5,89,236,26,351
4104607,7,0,7,82,32,0,114,258,31,403
4104608,3,0,6,19,24,3,46,127,24,197
4104609,45,0,45,90,24,0,114,347,31,492
4104610,6,0,6,93,40,0,133,271,59,463
4104611,0,0,0,87,42,0,129,294,20,443
4104612,3,0,3,68,21,3,92,249,21,362
4104613,29,11,40,48,26,3,77,210,40,327
4104614,9,3,12,73,31,3,107,231,30,368
4104615,9,3,12,68,39,0,107,204,18,329
4104616,10,0,10,21,20,0,41,134,12,187
4104617,7,3,10,84,26,0,110,311,61,482
4104618,9,0,9,57,18,0,75,286,38,399
4104619,10,0,10,80,42,5,127,354,27,508
4104620,4,0,4,54,24,6,84,201,27,312
4104621,4,0,4,62,30,0,92,209,32,333
4104622,10,0,10,72,40,3,115,290,41,446
4104623,7,3,10,84,42,7,133,352,63,548
4104624,8,3,11,95,29,3,127,305,42,474
4104625,11,0,11,39,9,0,48,174,20,242
4104626,8,0,8,60,35,0,95,238,19,352
4104627,0,0,0,62,31,6,99,291,23,413
4104628,37,3,40,58,31,0,89,357,37,483
4104629,3,0,3,50,28,0,78,181,17,276
4104630,0,0,0,0,0,0,0,0,0,0
4104631,3,3,6,68,42,3,113,383,42,538
4104632,7,0,7,66,26,0,92,284,27,403
4104633,0,0,0,46,21,3,70,191,15,276
4104634,11,0,11,103,38,0,141,337,47,525
4104701,6,3,9,39,27,6,72,140,23,235
4104702,21,3,24,24,18,0,42,157,10,209
4104703,0,0,0,63,34,6,103,165,3,271
4104704,6,0,6,89,21,6,116,226,13,355
4104705,0,0,0,65,36,3,104,223,3,330
4104706,0,0,0,79,11,8,98,160,14,272
4104707,3,0,3,73,48,9,130,248,39,417
4104708,0,0,0,88,33,6,127,235,46,408
4104709,3,3,6,63,29,4,96,185,12,293
4104710,0,0,0,38,29,6,73,140,10,223
4104711,4,0,4,77,29,0,106,229,6,341
4104712,3,3,6,75,19,0,94,252,34,380
4104713,0,3,3,68,18,3,89,149,25,263
4104714,6,0,6,73,36,6,115,295,12,422
4104715,0,0,0,43,16,0,59,139,10,208
4104716,0,0,0,0,0,0,0,0,0,0
4104717,0,3,7,51,37,7,95,195,18,308
4104718,7,0,7,65,34,6,105,221,34,360
4104719,5,0,5,42,19,0,61,193,29,283
4104720,6,0,6,44,20,0,64,302,12,378
4104721,0,0,0,47,24,0,71,216,0,287
4104722,0,0,0,80,54,0,134,261,23,418
4104723,9,0,9,71,23,0,94,218,19,331
4104724,3,0,3,100,26,3,129,303,23,455
4104725,6,4,10,49,25,0,74,170,18,262
4104726,4,0,4,34,17,4,55,159,24,238
4104727,0,0,0,56,13,6,75,130,14,219
4104728,10,4,14,66,48,0,114,281,33,428
4104729,6,0,6,61,23,3,87,188,18,293
4104730,6,0,6,40,13,4,57,166,15,238
4104731,3,0,3,43,23,6,72,159,19,250
4104732,4,0,4,95,54,0,149,275,27,451
4104733,5,0,5,69,33,3,105,331,20,456
4104734,4,0,4,55,24,5,84,138,21,243
4104735,4,0,4,39,31,3,73,176,12,261
4104736,0,0,0,62,25,4,91,173,15,279
4104737,50,7,57,47,61,0,108,367,31,506
4104738,0,3,3,71,31,10,112,248,24,384
4104739,6,0,6,91,43,8,142,313,26,481
4104740,3,0,3,37,25,9,71,162,22,255
4104741,3,0,3,112,27,3,142,215,25,382
4104742,0,0,0,38,24,3,65,148,18,231
4104743,0,0,0,61,30,0,91,227,24,342
4104744,3,0,3,80,23,9,112,209,10,331
4104801,3,3,6,65,13,3,81,194,34,309
4104802,0,0,0,4,0,0,4,183,4,191
4104803,6,0,6,42,12,6,60,170,26,256
4104804,39,0,39,99,11,0,110,273,29,412
4104805,0,3,3,37,10,0,47,130,23,200
4104806,0,3,3,77,28,5,110,266,35,411
4104807,8,0,8,70,15,3,88,314,51,453
4104808,0,6,6,57,31,0,88,217,57,362
4104809,6,0,6,98,40,0,138,291,22,451
4104810,0,0,0,107,42,3,152,335,27,514
4104811,0,0,0,138,30,0,168,197,28,393
4104812,3,0,3,98,47,6,151,243,29,423
4104813,3,0,3,93,34,3,130,251,21,402
4104814,0,0,0,70,37,3,110,198,12,320
4104815,0,0,0,59,27,9,95,230,32,357
4104816,3,0,3,46,20,0,66,158,22,246
4104817,0,0,0,47,16,6,69,111,22,202
4104818,0,0,0,102,42,3,147,345,27,519
4104819,13,37,50,102,42,7,151,354,106,611
4104820,0,0,0,99,16,7,122,270,24,416
4104821,0,0,0,127,27,9,163,223,32,418
4104822,0,0,0,72,20,0,92,176,18,286
4104823,3,0,3,34,9,3,46,115,12,173
4104824,3,0,3,70,24,6,100,251,46,397
4104825,5,0,5,56,25,0,81,204,16,301
4104826,0,0,0,62,22,3,87,243,59,389
4104827,0,0,0,36,15,0,51,107,3,161
4104828,0,0,0,270,50,12,332,442,46,820
4104829,3,0,3,56,17,3,76,119,21,216
4104830,0,0,0,45,10,3,58,114,6,178
4104831,0,0,0,152,27,12,191,278,42,511
4104832,0,0,0,94,14,0,108,157,35,300
4104833,0,0,0,65,9,0,74,126,18,218
4104834,0,0,0,63,25,6,94,122,21,237
4104901,0,0,0,65,32,3,100,124,3,227
4104902,0,0,0,35,12,3,50,105,9,164
4104903,0,4,4,38,17,4,59,178,10,247
4104904,3,0,3,97,22,0,119,253,19,391
4104905,0,0,0,64,49,4,117,249,12,378
4104906,0,0,0,53,24,0,77,168,9,254
4104907,0,3,3,62,30,4,96,182,33,311
4104908,6,0,6,42,27,0,69,200,17,286
4104909,3,0,3,82,12,6,100,131,3,234
4104910,0,0,0,57,27,0,84,178,10,272
4104911,0,0,0,71,30,6,107,182,12,301
4104912,3,0,3,87,20,0,107,154,0,261
4104913,0,0,0,44,9,6,59,168,20,247
4104914,0,0,0,0,0,0,0,0,0,0
4104915,3,0,3,57,23,0,80,277,17,374
4104916,0,0,0,75,32,18,125,325,3,453
4104917,0,0,0,97,31,3,131,271,15,417
4104918,0,0,0,73,38,9,120,177,9,306
4104919,3,0,3,61,22,0,83,141,14,238
4104920,8,0,8,45,25,6,76,209,24,309
4104921,0,0,0,84,29,6,119,195,25,339
4104922,6,0,6,52,21,0,73,110,13,196
4104923,29,0,29,168,112,0,280,615,25,920
4104924,7,0,7,34,21,6,61,159,8,228
4104925,0,0,0,53,25,0,78,194,6,278
4105001,3,3,6,36,21,6,63,143,15,221
4105002,3,0,3,108,43,4,155,227,6,388
4105003,0,0,0,61,16,0,77,161,12,250
4105004,0,0,0,64,36,12,112,222,11,345
4105005,0,0,0,88,21,5,114,174,7,295
4105006,0,0,0,66,29,4,99,142,10,251
4105007,3,0,3,56,7,0,63,144,8,215
4105008,3,3,6,94,37,8,139,260,14,413
4105009,6,0,6,108,34,0,142,227,15,384
4105010,0,0,0,80,19,5,104,159,27,290
4105011,3,0,3,118,20,10,148,178,4,330
4105012,0,0,0,89,34,0,123,252,12,387
4105013,0,3,3,76,11,4,91,119,10,220
4105014,0,0,0,60,22,3,85,138,16,239
4105015,0,0,0,102,23,12,137,203,0,340
4105016,3,3,6,128,37,11,176,280,17,473
4105017,0,0,0,97,35,6,138,224,0,362
4105018,6,0,6,83,23,3,109,178,3,290
4105019,0,0,0,58,36,6,100,187,18,305
4105020,0,0,0,78,27,5,110,254,6,370
4105021,0,3,3,69,16,3,88,134,12,234
4105022,6,3,9,47,3,0,50,103,9,162
4105023,3,0,3,64,19,0,83,111,4,198
4105101,0,0,0,65,37,6,108,192,24,324
4105102,0,0,0,44,6,3,53,108,6,167
4105103,3,0,3,54,24,6,84,138,3,225
4105104,5,0,5,93,57,12,162,325,30,517
4105105,7,0,7,65,44,4,113,179,8,300
4105106,0,0,0,86,28,3,117,260,37,414
4105107,0,0,0,9,12,0,21,9,0,30
4105108,0,0,0,84,28,3,115,199,17,331
4105109,3,0,3,62,31,4,97,217,12,326
4105110,4,0,4,59,22,3,84,149,10,243
4105111,8,0,8,66,35,0,101,229,23,353
4105112,0,0,0,50,30,6,86,160,12,258
4105113,0,0,0,55,9,0,64,90,12,166
4105114,3,0,3,41,18,0,59,123,3,185
4105115,3,0,3,92,34,7,133,195,0,328
4105116,0,0,0,74,34,4,112,200,15,327
4105117,3,0,3,49,26,3,78,146,15,239
4105118,6,0,6,74,22,0,96,220,16,332
4105119,0,0,0,53,31,3,87,154,7,248
4105120,3,0,3,58,35,0,93,162,15,270
4105121,3,0,3,81,52,4,137,251,15,403
4105122,0,0,0,46,34,0,80,216,3,299
4105123,25,5,30,43,40,0,83,200,14,297
4105124,4,0,4,38,16,0,54,133,0,187
4105125,6,0,6,44,34,0,78,174,26,278
4105126,9,3,12,68,37,0,105,197,30,332
4105127,0,3,3,69,39,0,108,266,18,392
4105128,6,0,6,63,37,6,106,181,5,292
4105129,6,0,6,66,36,9,111,278,16,405
4105201,5,4,9,48,36,0,84,280,18,382
4105202,6,0,6,59,29,0,88,245,23,356
4105203,84,84,168,14,24,0,38,394,144,576
4105204,0,0,0,40,31,6,77,188,18,283
4105205,71,0,71,70,32,9,111,364,12,487
4105206,3,0,3,65,36,6,107,219,9,335
4105207,0,0,0,46,21,6,73,153,19,245
4105208,85,0,85,103,50,0,153,421,12,586
4105209,3,3,6,98,43,12,153,298,21,472
4105210,3,0,3,61,29,0,90,243,12,345
4105211,0,0,0,0,0,0,0,0,0,0
4105212,0,0,0,68,53,0,121,327,41,489
4105213,31,0,31,63,20,4,87,369,21,477
4105214,3,0,3,81,36,6,123,232,21,376
4105215,3,0,3,68,37,3,108,375,45,528
4105216,3,0,3,110,53,3,166,309,27,502
4105217,6,0,6,66,45,6,117,237,21,375
4105218,9,6,15,89,38,7,134,293,31,458
4105219,10,0,10,47,18,0,65,248,27,340
4105220,0,6,9,70,27,3,100,243,27,370
4105221,3,3,6,53,28,0,81,155,27,263
4105222,0,0,0,0,3,0,3,0,0,3
4105223,7,0,7,45,23,0,68,231,10,309
4105224,0,0,0,0,0,0,0,0,0,0
4105225,7,0,7,76,40,9,125,305,31,461
4105226,9,0,9,23,13,0,36,262,7,305
4105227,6,3,9,63,27,7,97,226,32,355
4105228,3,0,3,48,35,9,92,190,9,291
4105229,36,9,45,21,26,0,47,227,29,303
4105230,169,20,189,0,17,0,17,386,46,449
4105231,8,0,8,68,31,8,107,253,20,380
4105232,5,0,5,54,18,3,75,213,15,303
4105233,6,0,9,74,32,3,109,219,19,347
4105234,6,0,6,50,22,3,75,187,3,265
4105235,3,6,9,52,48,3,103,199,24,326
4105236,6,0,6,71,36,9,116,279,23,418
4105237,4,3,7,70,41,4,115,276,18,409
4105238,3,3,6,34,12,6,52,147,15,214
4105301,3,0,6,77,44,0,121,257,27,405
4105302,0,0,0,54,22,6,82,149,17,248
4105303,0,0,0,45,41,4,90,191,3,284
4105304,3,0,3,96,50,6,152,269,6,427
4105305,0,0,0,50,31,0,81,195,18,294
4105306,0,0,0,71,28,6,105,241,24,370
4105307,4,0,4,81,35,7,123,254,0,377
4105308,6,0,6,37,15,3,55,209,12,276
4105309,0,0,0,61,41,5,107,182,21,310
4105310,6,0,6,74,20,3,97,200,32,329
4105311,0,0,0,68,32,8,108,175,12,295
4105312,3,3,6,67,40,5,112,228,18,358
4105313,0,0,0,58,18,3,79,183,13,275
4105314,0,0,0,85,37,5,127,202,16,345
4105315,0,0,0,53,18,0,71,203,14,288
4105316,3,0,3,38,20,9,67,137,0,204
4105317,5,0,5,86,48,13,147,354,30,531
4105318,3,0,3,68,42,4,114,297,24,435
4105319,3,0,3,68,39,0,107,237,9,353
4105320,6,0,6,85,42,0,127,187,12,326
4105321,3,0,3,62,24,3,89,158,11,258
4105322,0,0,0,81,30,4,115,214,3,332
4105323,7,0,7,66,31,0,97,195,12,304
4105324,3,0,3,106,56,12,174,358,21,553
4105325,3,0,3,43,32,6,81,185,9,275
4105326,4,0,4,47,19,3,69,147,8,224
4105327,0,0,0,66,37,0,103,203,9,315
4105328,7,0,7,72,27,0,99,234,20,353
4105329,0,0,0,34,17,0,51,136,6,193
4105330,0,0,0,44,32,11,87,186,7,280
4105331,6,0,6,53,34,0,87,208,11,306
4105332,3,0,3,68,35,0,103,230,26,359
4105333,3,0,3,78,39,4,121,283,12,416
4105334,0,0,0,73,30,0,103,262,7,372
4105335,0,0,0,42,18,3,63,132,6,201
4105336,0,0,0,91,30,6,127,188,6,321
4105337,8,3,11,74,39,0,113,264,25,402
4105338,3,0,3,61,42,0,103,209,17,329
4105339,6,0,6,45,9,3,57,177,0,234
4105340,0,0,0,70,36,0,106,268,11,385
4105341,0,0,0,44,29,3,76,221,41,338
4105342,0,0,0,52,31,3,86,134,24,244
4105343,3,0,3,32,20,3,55,152,6,213
4105344,0,0,0,88,40,4,132,227,22,381
4105345,3,0,3,40,7,7,54,114,3,171
4105346,8,10,18,34,31,4,69,212,13,294
4105347,0,0,0,62,34,3,99,211,13,323
4105348,7,0,10,50,30,3,83,192,12,287
4105349,0,0,0,36,18,0,54,155,9,218
4105401,6,0,6,97,41,7,145,284,9,438
4105402,3,0,3,76,41,3,120,220,21,361
4105403,0,0,0,56,29,3,88,165,18,271
4105404,4,0,4,85,43,0,128,209,12,349
4105405,6,0,6,62,46,0,108,147,12,267
4105406,10,0,10,90,50,4,144,329,25,498
4105407,4,0,4,76,43,3,122,182,24,328
4105408,8,0,8,71,68,3,142,262,12,416
4105409,3,4,7,55,19,0,74,153,8,235
4105410,11,0,11,85,68,7,160,319,12,491
4105411,0,0,0,79,50,7,136,267,7,410
4105412,6,3,9,45,30,9,84,195,12,291
4105413,0,0,0,101,45,4,150,297,13,460
4105414,3,0,3,101,31,9,141,320,31,492
4105415,4,0,4,76,22,7,105,187,10,302
4105416,3,0,3,63,16,4,83,184,35,302
4105417,0,0,0,0,0,0,0,0,0,0
4105418,3,0,3,96,42,0,138,287,12,437
4105419,3,0,3,93,50,15,158,252,24,434
4105420,7,0,7,90,34,9,133,263,7,403
4105421,4,0,4,29,21,3,53,115,3,171
4105422,6,0,6,91,42,4,137,282,25,444
4105423,0,0,0,101,57,6,164,356,32,552
4105424,0,0,0,105,53,9,167,330,40,537
4105425,0,0,0,42,19,0,61,112,9,182
4105426,0,0,0,80,27,9,116,196,18,330
4105427,6,0,6,93,37,4,134,252,10,396
4105428,0,0,0,47,9,3,59,138,9,206
4105429,0,0,0,50,21,0,71,124,15,210
4105430,0,0,0,106,53,9,168,282,12,462
4105431,3,0,3,48,35,0,83,145,3,231
4105432,3,0,3,88,37,6,131,224,16,371
4105433,6,0,6,86,34,6,126,324,16,466
4105434,0,5,5,72,34,0,106,167,16,289
4105435,3,0,3,67,50,0,117,205,14,336
4105436,6,0,6,108,69,6,183,293,38,514
4105501,4,3,7,42,26,0,68,165,15,248
4105502,6,3,9,89,41,0,130,287,27,444
4105503,11,3,14,62,37,0,99,254,21,374
4105504,3,3,6,46,46,3,95,258,22,375
4105505,6,3,9,38,36,0,74,200,11,285
4105506,4,0,4,55,32,5,92,204,15,311
4105507,3,0,3,51,28,3,82,195,3,280
4105508,0,0,0,0,3,0,3,18,0,21
4105509,0,0,0,92,50,15,157,247,25,429
4105510,3,0,3,51,55,6,112,248,25,385
4105511,4,0,4,92,59,3,154,299,23,476
4105512,40,8,48,34,46,0,80,318,31,429
4105513,51,29,80,79,36,0,115,347,69,531
4105514,8,0,8,105,44,0,149,323,29,501
4105515,6,3,9,112,44,7,163,226,19,408
4105516,7,0,7,77,38,7,122,164,11,297
4105517,8,0,8,53,36,4,93,172,9,274
4105518,3,0,3,70,27,3,100,201,12,313
4105519,8,3,11,62,40,0,102,336,25,463
4105520,9,0,9,96,19,0,115,266,6,387
4105521,4,4,8,54,26,7,87,232,9,328
4105522,0,0,0,59,34,0,93,204,12,309
4105523,0,0,0,63,20,9,92,155,15,262
4105524,0,0,0,6,9,0,15,46,0,61
4105525,3,0,3,67,23,0,90,186,6,282
4105526,0,0,0,42,29,0,71,243,9,323
4105527,64,0,64,46,19,3,68,287,13,368
4105528,10,0,10,49,30,3,82,149,6,237
4105529,6,0,6,79,28,3,110,151,9,270
4105530,11,0,11,88,41,3,132,295,24,451
4105601,8,0,8,62,17,9,88,163,11,262
4105602,12,0,12,58,22,6,86,170,20,276
4105603,12,0,12,82,31,6,119,202,12,333
4105604,7,0,7,47,22,3,72,114,0,186
4105605,14,0,14,31,32,0,63,381,9,453
4105606,10,0,10,58,41,3,102,170,12,284
4105607,85,5,90,64,35,4,103,314,19,436
4105608,24,4,28,55,25,3,83,300,31,414
4105609,14,4,18,44,27,6,77,201,17,295
4105610,22,3,25,47,16,3,66,142,24,232
4105611,17,0,17,42,29,0,71,254,22,347
4105612,12,3,15,59,31,0,90,239,27,356
4105613,14,0,14,55,45,3,103,351,28,482
4105614,21,0,21,65,23,0,88,252,30,370
4105615,8,4,12,39,26,6,71,262,20,353
4105616,22,4,26,45,24,0,69,161,14,244
4105617,42,6,48,71,38,6,115,357,32,504
4105618,15,0,15,63,18,0,81,291,19,391
4105619,10,0,10,65,37,6,108,251,15,374
4105620,14,6,20,61,39,4,104,248,32,384
4105621,6,3,12,50,24,0,74,181,12,267
4105622,3,0,3,61,30,5,96,142,18,256
4105623,11,0,11,77,53,6,136,345,36,517
4105624,9,4,13,80,34,6,120,229,22,371
4105625,8,3,11,42,38,0,80,172,6,258
4105626,46,0,46,50,19,0,69,270,31,370
4105627,17,3,20,71,42,0,113,286,24,423
4105628,17,0,17,56,34,3,93,329,53,475
4105629,9,0,9,87,37,3,127,260,37,424
4105630,12,0,12,53,31,12,96,237,12,345
4105631,56,13,69,62,44,0,106,298,22,426
4105632,21,0,21,38,62,0,100,303,15,418
4105701,18,0,18,63,33,3,99,338,22,459
4105702,4,0,4,25,20,0,45,162,13,220
4105703,11,0,11,55,18,8,81,165,13,259
4105704,7,3,10,56,9,3,68,189,15,272
4105705,6,0,6,29,21,9,59,168,9,236
4105706,5,3,8,32,17,3,52,138,21,211
4105707,11,0,11,71,55,4,130,286,16,432
4105708,91,25,116,69,48,6,123,467,61,651
4105709,15,6,21,89,35,9,133,340,22,495
4105710,4,0,4,53,53,6,112,259,14,385
4105711,8,0,8,68,26,3,97,269,27,393
4105712,11,0,11,77,42,0,119,307,9,435
4105713,17,7,24,41,25,0,66,201,23,290
4105714,94,21,115,22,15,0,37,288,48,373
4105715,14,0,14,51,22,9,82,178,24,284
4105716,6,0,6,41,5,3,49,116,17,182
4105717,6,3,9,37,18,3,58,187,22,267
4105718,9,3,12,39,36,3,78,198,29,305
4105719,15,0,15,43,27,0,70,231,11,312
4105720,8,3,11,48,17,0,65,177,15,257
4105721,8,0,8,20,23,0,43,224,20,287
4105722,8,3,11,53,29,8,90,265,40,395
4105723,10,6,16,35,36,0,71,243,21,335
4105724,3,3,6,72,38,0,110,269,25,404
4105725,6,3,9,28,23,0,51,182,22,255
4105726,7,4,17,10,40,0,50,206,78,334
4105727,11,3,14,69,33,7,109,343,15,467
4105728,24,0,24,71,30,3,104,350,24,478
4105729,23,8,31,57,32,0,89,389,36,514
4105730,7,0,7,43,22,4,69,284,31,384
4105731,7,3,10,22,25,3,50,260,30,340
4105732,9,3,12,27,25,0,52,278,141,471
4105733,26,7,33,41,34,0,75,333,78,486
4105734,61,0,61,60,47,0,107,386,30,523
4105735,13,7,20,40,22,0,62,218,31,311
4105736,3,4,7,32,43,0,75,258,17,350
4105737,5,0,5,40,23,6,69,193,15,277
4105738,108,6,114,35,17,0,52,339,15,406
4105739,16,7,23,66,52,3,121,358,32,511
4105740,8,3,11,85,30,6,121,299,21,441
4105741,6,3,9,33,16,6,55,181,18,254
4105742,11,3,14,63,19,9,91,201,21,313
4105743,15,3,18,31,21,0,52,255,47,354
4105744,7,6,13,25,12,0,37,174,38,249
4105745,3,0,3,49,33,0,82,233,21,336
4105746,13,3,16,31,34,0,65,128,10,203
4105747,20,14,34,42,46,0,88,366,39,493
4105748,9,3,12,50,43,0,93,176,9,278
4105749,10,3,13,20,16,4,40,177,17,234
4105801,20,3,23,106,44,3,153,361,13,527
4105802,10,5,15,76,39,3,118,279,13,410
4105803,9,0,9,81,22,3,106,385,37,528
4105804,6,3,9,32,21,0,53,277,27,357
4105805,3,5,8,58,23,0,81,201,15,297
4105806,6,0,6,48,13,9,70,224,13,307
4105807,9,3,12,38,24,3,65,211,22,298
4105808,53,13,66,66,24,4,94,264,38,396
4105809,7,0,7,57,26,3,86,177,12,275
4105810,12,0,12,44,13,6,63,210,4,277
4105811,9,0,9,35,11,3,49,169,10,228
4105812,12,6,18,56,21,3,80,199,21,300
4105813,7,0,7,71,34,0,105,286,20,411
4105814,5,0,5,100,49,3,152,342,24,518
4105815,15,3,18,77,15,0,92,360,32,484
4105816,4,0,4,55,20,3,78,238,8,324
4105817,10,3,13,48,24,0,72,290,32,394
4105818,8,3,11,58,43,0,101,358,28,487
4105819,15,3,18,84,39,6,129,362,29,520
4105820,0,0,0,3,0,0,3,6,0,9
4105821,14,0,14,39,12,0,51,237,10,298
4105822,10,0,10,60,11,3,74,201,16,291
4105823,6,0,6,44,10,0,54,189,19,262
4105824,7,0,7,93,35,9,137,246,18,401
4105825,11,0,11,91,20,7,118,273,29,420
4105826,0,0,0,0,0,0,0,0,0,0
4105827,4,0,4,42,24,0,66,161,6,233
4105828,15,4,19,57,27,6,90,239,24,353
4105829,4,7,11,68,25,3,96,215,15,326
4105830,4,5,9,44,17,3,64,165,20,249
4105831,16,0,16,32,18,6,56,210,25,291
4105832,3,3,6,34,13,4,51,180,19,250
4105833,0,0,0,0,0,0,0,0,0,0
4105901,0,0,0,88,27,3,118,235,21,374
4105902,0,0,0,44,20,0,64,123,6,193
4105903,0,0,0,64,32,6,102,236,20,358
4105904,3,0,3,72,26,3,101,272,16,389
4105905,8,0,8,63,32,0,95,244,29,368
4105906,0,0,0,70,20,9,99,247,9,355
4105907,0,0,0,47,27,3,77,198,6,281
4105908,6,0,6,54,36,3,93,231,10,334
4105909,0,0,0,160,29,6,195,258,6,459
4105910,3,0,6,81,33,3,117,263,15,395
4105911,0,0,0,0,0,0,0,0,0,0
4105912,4,0,4,43,20,9,72,148,4,224
4105913,6,0,6,65,30,7,102,199,16,317
4105914,4,0,4,81,53,0,134,268,22,424
4105915,7,0,7,74,28,9,111,212,9,332
4105916,0,0,0,64,28,0,92,248,11,351
4105917,0,0,0,25,12,0,37,111,9,157
4105918,0,0,0,71,17,0,88,198,18,304
4105919,0,3,3,99,23,6,128,267,21,416
4105920,0,3,3,72,36,6,114,175,12,301
4105921,6,3,9,51,49,6,106,248,27,381
4105922,0,0,0,36,18,0,54,112,6,172
4105923,6,0,6,47,21,5,73,221,21,315
4105924,0,0,0,55,6,3,64,102,7,173
4105925,0,0,0,29,12,9,50,139,12,201
4105926,6,0,6,45,14,9,68,190,7,265
4105927,4,0,4,44,24,0,68,166,18,252
4105928,4,0,4,78,34,4,116,262,10,388
4105929,0,0,0,99,26,0,125,270,27,422
4105930,6,0,6,79,33,7,119,266,8,393
4105931,4,0,4,68,19,0,87,238,10,335
4105932,0,0,0,0,0,0,0,0,0,0
4105933,0,0,0,37,20,0,57,123,3,183
4105934,15,0,15,46,24,0,70,150,13,233
4106001,12,0,12,37,29,0,66,235,16,317
4106002,8,3,11,70,37,12,119,211,13,343
4106003,7,0,7,92,65,6,163,299,30,492
4106004,11,0,11,76,49,6,131,247,15,393
4106005,0,0,0,52,28,4,84,153,6,243
4106006,0,3,3,63,35,0,98,193,24,315
4106007,9,4,13,80,41,3,124,254,26,404
4106008,0,3,3,84,33,14,131,205,21,357
4106009,6,0,6,61,28,3,92,227,9,328
4106010,6,3,9,24,25,0,49,136,16,201
4106011,3,3,6,72,58,5,135,314,15,464
4106012,4,0,4,107,42,0,149,302,24,475
4106013,0,0,0,0,0,0,0,4,0,4
4106014,6,0,6,67,41,0,108,289,15,412
4106015,14,0,14,62,22,0,84,231,13,328
4106016,0,0,0,58,47,3,108,211,9,328
4106017,0,0,0,0,0,0,0,0,0,0
4106018,13,0,13,88,36,8,132,258,21,411
4106019,7,6,13,54,39,3,96,223,18,337
4106020,7,6,13,111,65,4,180,360,19,559
4106021,0,0,0,16,12,0,28,37,0,65
4106022,7,3,10,36,22,0,58,137,12,207
4106023,6,6,12,46,16,3,65,226,12,303
4106024,0,0,0,0,3,0,3,3,0,6
4106025,0,0,0,60,27,3,90,192,6,288
4106101,5,0,5,37,28,6,71,171,14,256
4106102,0,0,0,0,0,0,0,0,0,0
4106103,7,3,10,67,23,0,90,147,15,252
4106104,8,0,8,47,22,0,69,204,18,291
4106105,8,3,11,130,42,0,172,362,33,567
4106106,17,5,22,67,36,0,103,254,33,390
4106107,7,3,10,46,23,0,69,204,22,295
4106108,10,6,16,73,28,0,101,278,19,398
4106109,8,3,11,48,47,8,103,287,28,418
4106110,0,0,0,53,12,0,65,210,27,302
4106111,3,0,6,69,40,3,112,227,26,365
4106112,6,0,6,36,8,0,44,131,20,195
4106113,9,0,9,67,32,6,105,284,29,418
4106114,8,0,8,53,59,0,112,283,27,422
4106115,5,3,8,42,12,0,54,186,27,267
4106116,5,0,5,28,14,3,45,152,16,213
4106117,3,3,6,69,41,4,114,270,29,413
4106118,9,0,9,73,23,4,100,261,33,394
4106119,22,0,22,61,35,0,96,324,43,463
4106120,4,0,4,61,31,0,92,185,17,294
4106121,3,3,6,66,23,0,89,202,13,304
4106122,6,3,9,60,42,0,102,260,33,395
4106123,4,3,7,45,14,3,62,214,56,332
4106124,3,0,3,33,16,0,49,252,76,377
4106125,11,0,11,59,19,0,78,223,32,333
4106126,26,3,29,47,52,3,102,302,21,425
4106127,3,3,6,67,24,3,94,186,28,308
4106128,51,5,56,50,46,0,96,434,48,578
4106129,3,0,3,65,54,10,129,295,29,453
4106130,0,0,0,45,10,3,58,143,11,212
4106131,4,0,4,62,29,3,94,178,11,283
4106132,13,7,20,46,24,3,73,164,17,254
4106133,126,5,131,39,40,3,82,371,27,480
4106134,6,5,11,46,27,0,73,221,47,341
4106135,8,0,8,70,21,0,91,251,18,360
4106136,0,0,0,0,0,0,0,3,0,3
4106137,0,0,0,0,0,0,0,0,0,0
4106201,19,3,22,84,36,3,123,288,23,434
4106202,13,0,13,45,12,3,60,194,6,260
4106203,10,0,10,50,28,5,83,171,4,258
4106204,11,0,11,61,18,0,79,134,13,226
4106205,4,0,4,60,13,0,73,185,22,280
4106206,8,6,14,39,18,3,60,89,9,158
4106207,5,0,5,56,29,6,91,161,24,276
4106208,9,3,16,64,32,3,99,169,16,284
4106209,8,3,11,47,36,6,89,272,14,375
4106210,0,5,5,30,7,0,37,197,32,266
4106211,3,0,3,23,7,3,33,207,25,265
4106212,85,13,98,31,9,0,40,216,22,278
4106213,6,6,12,35,13,0,48,186,27,261
4106214,15,0,15,58,23,0,81,326,40,447
4106215,33,63,96,58,24,6,88,204,93,385
4106216,44,11,55,16,16,3,35,219,25,279
4106217,14,3,17,40,30,0,70,155,15,240
4106218,6,4,10,62,17,6,85,133,4,222
4106219,13,0,13,50,20,14,84,212,13,309
4106220,9,0,9,33,14,10,57,127,10,194
4106221,13,3,19,57,31,6,94,251,27,372
4106222,3,0,3,76,44,3,123,289,15,427
4106223,11,6,17,59,20,7,86,250,24,360
4106224,3,0,3,24,20,0,44,125,12,181
4106225,12,6,18,64,30,3,97,239,45,381
4106226,24,3,27,107,41,9,157,389,36,582
4106227,11,3,14,49,16,5,70,340,33,443
4106228,10,0,10,49,26,3,78,322,34,434
4106229,15,7,22,57,33,7,97,377,54,528
4106230,0,3,3,56,14,0,70,186,16,272
4106231,0,0,0,0,0,0,0,0,0,0
4106232,11,3,14,50,21,0,71,139,24,234
4106233,12,0,12,59,34,12,105,201,21,327
4106234,62,7,69,11,7,0,18,273,31,322
4106235,18,0,18,42,15,0,57,216,20,293
4106236,7,3,10,73,17,0,90,284,35,409
4106237,4,5,9,33,10,3,46,224,20,290
4106301,3,0,3,46,35,3,84,172,9,265
4106302,0,0,0,85,30,3,118,276,9,403
4106303,3,0,3,91,27,5,123,233,7,363
4106304,0,0,0,81,24,0,105,194,12,311
4106305,3,0,3,43,18,3,64,195,3,262
4106306,0,0,0,58,25,7,90,156,20,266
4106307,0,0,0,170,34,8,212,244,15,471
4106308,0,0,0,210,38,6,254,309,17,580
4106309,0,0,0,112,21,0,133,184,20,337
4106310,3,0,3,106,19,6,131,141,4,276
4106311,0,0,0,73,13,3,89,111,15,215
4106312,0,0,0,58,12,3,73,143,3,219
4106313,0,0,0,68,19,7,94,155,15,264
4106314,0,0,0,0,0,0,0,0,0,0
4106315,68,0,68,80,21,6,107,291,3,401
4106316,0,0,0,68,20,0,88,177,12,277
4106317,0,0,0,61,15,0,76,196,0,272
4106318,3,0,3,35,23,0,58,132,16,206
4106319,6,3,9,92,20,3,115,207,18,340
4106320,4,0,4,83,23,3,109,294,6,409
4106321,0,0,0,54,15,9,78,103,10,191
4106322,0,3,3,65,25,3,93,120,6,219
4106323,0,0,0,84,29,0,113,245,3,361
4106324,0,0,0,49,23,3,75,156,3,234
4106325,3,0,3,122,20,4,146,177,9,332
4106401,3,0,3,27,19,0,46,194,12,252
4106402,29,6,35,78,44,7,129,397,48,574
4106403,61,7,68,35,25,6,66,303,30,399
4106404,54,4,58,28,11,0,39,309,17,365
4106405,6,0,6,33,25,14,72,173,7,252
4106406,11,0,11,39,31,0,70,327,19,416
4106407,13,6,19,54,20,0,74,233,9,316
4106408,23,6,29,68,25,0,93,250,25,368
4106409,7,3,10,47,18,4,69,192,17,278
4106410,10,4,14,76,30,4,110,272,16,398
4106411,12,0,12,59,21,0,80,231,15,326
4106412,14,7,21,54,33,0,87,219,39,345
4106413,3,4,7,31,15,0,46,179,19,244
4106414,11,3,14,42,28,6,76,160,21,257
4106415,0,0,0,0,0,0,0,0,0,0
4106416,16,6,22,88,41,10,139,304,27,470
4106417,8,3,11,59,39,9,107,227,25,359
4106418,8,0,8,79,21,6,106,233,26,365
4106419,11,5,16,81,28,10,119,382,29,530
4106420,15,3,18,17,19,6,42,161,19,222
4106421,6,6,12,38,30,7,75,174,21,270
4106422,12,0,12,39,24,3,66,236,27,329
4106423,44,6,50,26,13,0,39,264,37,340
4106424,13,0,13,54,32,6,92,245,27,364
4106425,5,3,8,81,27,3,111,341,26,478
4106426,14,0,14,96,41,0,137,377,64,578
4106427,8,0,8,91,38,3,132,325,23,480
4106428,9,0,9,78,35,3,116,371,30,517
4106429,7,0,7,24,17,0,41,142,17,200
4106430,3,0,3,93,58,4,155,401,30,586
4106431,0,0,0,0,0,0,0,0,0,0
4106432,0,0,0,0,0,0,0,0,0,0
4106433,9,3,15,44,36,0,80,243,30,353
4106501,0,0,0,35,3,0,38,79,7,124
4106502,3,0,3,60,38,6,104,246,6,356
4106503,8,0,8,81,38,7,126,240,15,381
4106504,0,0,0,73,40,0,113,187,0,300
4106505,14,0,14,56,38,3,97,219,21,337
4106506,7,0,7,57,31,6,94,205,6,305
4106507,112,9,121,59,18,10,87,321,27,435
4106508,0,0,0,45,21,0,66,151,24,241
4106509,14,0,14,48,23,13,84,204,22,310
4106510,0,0,0,57,24,6,87,162,7,256
4106511,4,0,4,92,51,7,150,280,32,462
4106512,6,0,6,50,16,6,72,165,14,251
4106513,0,0,0,3,3,0,6,21,0,27
4106601,4,0,4,68,40,3,111,286,26,423
4106602,6,3,9,76,18,3,97,357,28,482
4106603,0,0,0,27,24,0,51,208,12,271
4106604,3,0,3,9,17,0,26,414,43,483
4106605,3,0,3,66,39,6,111,216,17,344
4106606,5,3,8,74,36,10,120,192,9,321
4106607,3,0,3,45,13,6,64,156,3,223
4106608,8,3,11,64,25,0,89,208,15,312
4106609,0,0,0,59,30,0,89,160,18,267
4106610,0,0,0,71,34,6,111,224,8,343
4106611,7,6,13,45,29,8,82,150,21,253
4106612,11,0,11,64,29,0,93,280,15,388
4106613,14,0,14,38,29,0,67,251,11,329
4106614,6,0,6,62,27,0,89,230,18,337
4106615,12,0,12,57,42,9,108,236,3,347
4106616,7,0,7,35,28,3,66,156,3,225
4106617,6,0,6,68,28,4,100,167,3,270
4106618,0,0,0,28,42,3,73,123,12,208
4106619,0,0,0,0,0,0,0,0,0,0
4106620,99,11,110,22,35,0,57,336,33,426
4106701,3,0,3,76,39,16,131,222,20,373
4106702,3,0,3,103,51,4,158,297,7,462
4106703,4,0,4,42,18,3,63,132,0,195
4106704,25,3,28,42,44,0,86,206,10,302
4106705,9,0,9,67,37,3,107,218,8,333
4106706,8,0,8,72,55,9,136,237,13,386
4106707,0,0,0,57,40,3,100,181,3,284
4106708,6,3,9,64,38,13,115,237,11,363
4106709,0,0,0,88,34,11,133,198,7,338
4106710,3,0,3,97,60,8,165,279,12,456
4106711,4,0,4,84,39,10,133,283,13,429
4106712,4,3,7,70,30,5,105,237,15,357
4106713,3,3,6,98,48,6,152,223,9,384
4106714,0,0,0,135,58,7,200,339,7,546
4106715,0,0,0,137,41,8,186,269,13,468
4106716,9,0,9,126,52,16,194,331,16,541
4106717,3,0,3,91,30,5,126,254,16,396
4106718,28,6,34,39,48,3,90,282,28,400
4106719,11,3,14,70,44,3,117,268,21,406
4106720,8,0,8,57,28,0,85,169,20,274
4106721,3,0,3,101,42,6,149,214,10,373
4106722,6,0,6,129,42,10,181,312,17,510
4106723,0,0,0,56,27,0,83,108,3,194
4106724,0,0,0,119,13,3,135,154,9,298
4106725,0,0,0,0,0,0,0,0,0,0
4106801,3,3,6,53,21,10,84,237,6,327
4106802,4,3,7,30,20,0,50,133,12,195
4106803,5,10,15,126,40,10,176,287,23,486
4106804,62,10,72,57,17,9,83,344,38,465
4106805,4,7,11,22,15,0,37,169,22,228
4106806,0,0,0,0,6,0,6,9,3,18
4106807,9,0,9,60,22,0,82,165,10,257
4106808,0,0,0,38,15,0,53,150,12,215
4106809,9,0,9,81,20,0,101,172,17,290
4106810,14,4,18,78,35,4,117,379,22,518
4106811,8,0,8,118,23,4,145,253,21,419
4106812,3,0,3,78,24,14,116,131,9,256
4106813,14,7,21,109,37,8,154,340,22,516
4106814,34,0,34,47,16,4,67,220,33,320
4106815,8,3,11,72,26,3,101,222,27,350
4106816,0,0,0,59,19,3,81,146,6,233
4106817,9,3,12,82,26,3,111,220,21,352
4106818,7,0,7,133,48,7,188,248,12,448
4106819,6,0,6,72,17,6,95,163,15,273
4106820,12,6,18,58,16,5,79,214,15,308
4106821,6,3,9,95,25,3,123,238,11,372
4106822,6,3,9,91,12,9,112,230,12,354
4106823,7,3,10,69,15,3,87,179,19,285
4106824,9,0,12,104,29,6,139,309,15,463
4106825,7,0,7,81,30,9,120,265,22,407
4106826,18,3,21,58,25,0,83,240,21,344
4106827,11,0,11,132,20,3,155,265,16,436
4106828,7,0,7,99,25,5,129,236,14,379
4106829,10,4,14,98,27,14,139,248,27,414
4106830,6,0,6,175,36,7,218,307,14,539
4106831,8,0,8,90,48,3,141,290,25,456
4106832,0,0,0,59,27,7,93,154,10,257
4106833,11,0,11,49,24,9,82,185,12,279
4106834,6,8,14,91,36,12,139,191,14,344
4106835,104,6,110,46,21,0,67,232,12,311
4106901,0,0,0,19,28,0,47,127,9,183
4106902,7,0,7,79,32,0,111,185,12,308
4106903,12,0,12,67,20,6,93,188,6,287
4106904,6,0,6,84,31,9,124,245,17,386
4106905,70,3,73,21,10,0,31,227,18,276
4106906,8,0,11,92,27,6,125,240,18,383
4106907,20,0,23,74,30,4,108,228,15,351
4106908,7,0,7,56,31,4,91,166,6,263
4106909,16,6,22,44,16,4,64,215,24,303
4106910,17,5,22,62,39,9,110,276,18,404
4106911,3,0,3,66,29,0,95,188,5,288
4106912,12,0,12,70,18,6,94,276,21,391
4106913,4,0,4,37,38,0,75,159,13,247
4106914,34,4,41,91,37,5,133,287,23,443
4106915,9,0,9,49,20,11,80,186,4,270
4106916,11,0,11,55,19,3,77,187,11,275
4106917,58,3,61,63,45,3,111,314,21,446
4106918,13,5,18,84,31,0,115,305,25,445
4106919,14,4,18,83,30,12,125,289,25,439
4106920,4,3,7,48,13,6,67,168,16,251
4106921,5,3,8,78,22,0,100,176,12,288
4106922,9,3,12,77,41,6,124,296,15,435
4106923,16,3,19,77,60,6,143,341,33,517
4106924,3,0,3,45,11,6,62,175,6,243
4106925,8,3,17,96,63,3,162,261,25,448
4106926,3,3,6,67,30,0,97,232,6,335
4106927,14,3,17,100,24,7,131,203,16,350
4106928,7,6,13,52,23,0,75,167,18,260
4106929,9,6,15,101,29,8,138,347,18,503
4106930,5,6,11,60,23,3,86,197,30,313
4106931,14,3,17,88,50,3,141,345,45,531
4106932,0,0,0,0,0,0,0,3,0,3
4106933,8,0,8,41,24,6,71,150,12,233
4106934,12,4,16,52,39,4,95,274,13,382
4106935,6,0,6,36,15,3,54,163,9,226
4106936,7,0,7,52,27,5,84,259,17,360
4106937,9,6,15,64,43,3,110,293,10,413
4106938,4,0,4,35,29,0,64,196,15,275
4106939,10,0,10,58,33,0,91,222,15,328
4107001,3,6,9,66,27,3,96,228,35,359
4107002,4,0,4,48,45,4,97,214,14,325
4107003,9,0,9,59,24,3,86,180,25,291
4107004,12,0,12,58,18,0,76,217,21,314
4107005,0,0,0,30,32,3,65,228,18,311
4107006,9,3,12,71,45,0,116,316,20,452
4107007,7,0,7,65,53,5,123,269,24,416
4107008,49,4,53,28,17,0,45,216,28,289
4107009,7,0,7,78,51,4,133,304,21,458
4107010,13,3,19,113,37,6,156,305,24,485
4107011,13,6,19,55,45,3,103,213,21,337
4107012,8,3,11,69,39,3,111,272,27,410
4107013,6,6,12,52,15,0,67,189,24,280
4107014,13,3,16,51,31,0,82,260,19,361
4107015,22,3,25,50,27,0,77,270,18,365
4107016,6,3,9,35,24,0,59,123,21,203
4107017,3,3,6,80,19,5,104,216,23,343
4107018,9,0,9,52,16,0,68,196,19,283
4107019,45,10,55,35,34,4,73,290,22,385
4107101,0,0,0,55,31,3,89,187,6,282
4107102,3,0,3,91,25,9,125,243,9,377
4107103,14,6,20,40,15,0,55,209,13,277
4107104,0,0,0,60,21,9,90,155,12,257
4107105,3,3,6,92,27,9,128,283,9,420
4107106,5,0,5,76,29,6,111,196,14,321
4107107,0,0,0,75,31,12,118,220,7,345
4107108,0,3,3,72,26,8,106,180,9,295
4107109,0,0,0,114,29,12,155,182,7,344
4107110,0,0,0,91,35,7,133,303,11,447
4107111,4,0,4,38,29,0,67,146,4,217
4107112,0,0,0,78,37,3,118,234,9,361
4107113,0,0,0,89,28,0,117,236,6,359
4107114,3,0,3,97,17,8,122,233,12,367
4107115,62,7,69,55,27,0,82,298,25,405
4107116,7,0,7,68,30,3,101,250,3,354
4107117,3,6,9,40,10,3,53,171,9,233
4107118,3,0,3,68,27,9,104,180,12,296
4107119,3,3,6,86,21,6,113,194,15,322
4107120,3,0,3,70,39,4,113,219,7,339
4107121,6,0,6,73,27,0,100,203,9,312
4107122,0,0,0,118,37,6,161,262,12,435
4107123,4,0,4,103,39,6,148,313,12,473
4107124,3,0,3,60,47,5,112,226,12,350
4107125,56,3,59,29,6,6,41,160,3,204
4107126,3,0,3,81,29,0,110,194,6,310
4107127,3,0,3,32,11,3,46,81,3,130
4107128,3,0,3,74,20,4,98,177,6,281
4107129,0,0,0,17,21,0,38,92,6,136
4107130,0,0,0,0,0,0,0,0,0,0
4107131,4,0,4,67,34,9,110,162,4,276
4107201,9,0,9,116,26,6,148,306,52,506
4107202,3,0,3,97,30,18,145,257,18,420
4107203,54,3,57,198,36,16,250,337,24,611
4107204,3,3,6,102,58,12,172,322,62,556
4107205,4,0,4,53,24,3,80,139,6,225
4107206,12,0,12,275,68,0,343,581,60,984
4107207,0,0,0,275,65,11,351,452,79,882
4107208,3,3,6,148,53,9,210,482,31,723
4107209,3,3,6,91,27,9,127,207,23,357
4107210,6,3,9,59,42,9,110,237,26,373
4107211,0,0,0,57,38,0,95,173,24,292
4107212,3,0,3,39,16,4,59,158,30,247
4107213,4,0,4,85,16,6,107,220,26,353
4107214,0,0,0,128,51,8,187,354,19,560
4107215,3,3,6,96,36,3,135,245,39,419
4107216,0,0,0,56,15,3,74,75,3,152
4107217,0,0,0,90,37,9,136,211,19,366
4107218,0,0,0,72,13,6,91,179,13,283
4107219,4,0,4,105,23,14,142,193,25,360
4107220,3,3,6,105,39,11,155,282,33,470
4107221,5,3,8,98,45,10,153,252,35,440
4107222,3,0,3,128,10,8,146,155,27,328
4107223,3,0,3,78,22,9,109,97,0,206
4107224,4,0,4,74,31,0,105,213,13,331
4107225,3,0,3,49,21,6,76,120,10,206
4107226,6,0,6,39,11,3,53,109,16,178
4107301,0,0,0,101,40,6,147,230,8,385
4107302,0,3,3,60,16,0,76,167,22,265
4107303,4,0,4,39,21,0,60,204,29,293
4107304,72,5,77,55,9,0,64,299,28,391
4107305,0,0,0,65,39,5,109,234,24,367
4107306,3,3,6,51,27,6,84,194,46,324
4107307,3,4,7,36,29,3,68,147,25,240
4107308,3,6,9,44,26,6,76,198,21,295
4107309,8,0,8,47,27,3,77,215,15,307
4107310,6,0,6,119,45,7,171,334,29,534
4107311,6,0,6,33,18,0,51,163,15,229
4107312,0,0,0,0,0,0,0,4,0,4
4107313,0,0,0,66,33,8,107,221,6,334
4107314,3,0,3,52,16,5,73,142,14,229
4107315,0,0,0,168,38,9,215,331,10,556
4107316,3,0,3,53,28,0,81,229,20,330
4107317,3,0,6,91,46,0,137,309,46,492
4107318,3,3,6,47,30,6,83,202,19,304
4107319,11,5,16,59,36,4,99,264,55,418
4107320,6,0,9,70,38,6,114,225,29,368
4107321,4,0,4,15,4,0,19,74,3,96
4107322,0,0,0,0,0,0,0,0,0,0
4107323,0,0,0,44,15,3,62,156,7,225
4107401,0,0,0,0,0,0,0,0,0,0
4107402,7,0,7,53,22,4,79,186,28,293
4107403,10,3,13,68,34,0,102,206,29,337
4107404,3,0,3,52,26,3,81,195,17,293
4107405,11,3,14,66,26,4,96,231,53,380
4107406,8,0,8,56,9,6,71,202,34,307
4107407,7,0,7,35,21,3,59,150,11,220
4107408,6,3,9,64,19,9,92,231,24,347
4107409,7,3,10,59,34,4,97,202,29,328
4107410,7,0,7,77,48,6,131,242,24,397
4107411,0,0,0,60,28,4,92,187,13,292
4107412,0,0,0,0,0,0,0,0,0,0
4107413,0,0,0,82,40,9,131,192,24,347
4107414,6,0,6,57,35,3,95,183,7,285
4107415,3,6,9,44,38,0,82,227,17,326
4107416,3,5,8,34,28,4,66,157,20,243
4107417,4,0,4,44,23,3,70,166,26,262
4107418,0,0,0,57,32,6,95,193,13,301
4107419,3,6,9,49,22,0,71,161,26,258
4107420,6,3,9,43,26,6,75,213,33,321
4107421,9,0,9,51,21,3,75,198,16,289
4107422,4,0,4,66,25,7,98,183,24,305
4107423,5,0,5,63,27,0,90,213,20,323
4107424,10,3,13,66,34,6,106,273,29,408
4107425,3,3,6,62,28,9,99,220,22,341
4107426,80,3,83,76,45,7,128,404,24,556
4107427,40,12,52,51,34,0,85,265,53,403
4107501,0,0,0,38,30,4,72,183,9,264
4107502,3,0,3,76,38,0,114,226,6,346
4107503,0,0,0,37,3,10,50,96,0,146
4107504,0,0,0,67,35,3,105,197,6,308
4107505,0,0,0,32,16,0,48,132,9,189
4107506,4,0,4,59,30,3,92,215,16,323
4107507,0,0,0,36,10,0,46,114,0,160
4107508,7,0,7,74,35,0,109,300,12,421
4107601,5,0,5,112,47,9,168,298,3,469
4107602,4,0,4,93,37,9,139,181,12,332
4107603,6,0,6,87,27,3,117,135,0,252
4107604,0,0,0,107,54,9,170,285,9,464
4107605,0,0,0,128,38,11,177,254,7,438
4107606,0,0,0,101,32,14,147,141,9,297
4107607,6,0,6,62,24,4,90,179,13,282
4107608,3,3,6,65,20,6,91,166,6,263
4107609,0,0,0,73,40,5,118,164,6,288
4107610,3,0,3,61,23,0,84,165,12,261
4107701,3,0,3,58,25,3,86,176,10,272
4107702,3,0,3,120,47,3,170,339,22,531
4107703,0,4,4,90,51,0,141,302,7,450
4107704,3,0,3,51,30,6,87,172,13,272
4107705,3,0,3,85,38,9,132,225,4,361
4107706,0,3,3,68,19,3,90,191,24,305
4107707,0,0,0,84,28,6,118,152,15,285
4107708,4,0,4,55,24,3,82,202,4,288
4107709,3,0,7,64,40,8,112,207,3,322
4107710,4,0,4,95,50,7,152,330,10,492
4107711,3,0,3,76,47,7,130,277,30,437
4107712,0,0,0,0,0,0,0,0,0,0
4107713,3,0,3,132,53,4,189,284,23,496
4107714,3,0,3,39,27,0,66,125,3,194
4107715,0,0,0,67,27,6,100,151,0,251
4107716,6,62,68,44,34,3,81,216,97,394
4107717,3,0,3,32,28,0,60,163,18,241
4107718,6,0,6,87,54,7,148,253,15,416
4107719,0,0,0,103,49,12,164,291,4,459
4107720,3,0,3,99,57,0,156,349,6,511
4107721,0,0,0,85,37,0,122,243,7,372
4107722,0,0,0,49,18,4,71,140,3,214
4107723,0,0,0,33,43,9,85,160,12,257
4107724,0,0,0,0,0,0,0,0,0,0
4107725,0,0,0,0,0,0,0,3,0,3
4107726,0,0,0,113,30,3,146,236,9,391
4107727,3,0,3,62,18,0,80,187,11,278
4107801,3,0,3,50,21,0,71,131,4,206
4107802,0,0,0,31,24,6,61,105,12,178
4107803,0,5,5,87,46,14,147,273,37,457
4107804,10,3,13,60,43,3,106,256,25,387
4107805,0,0,0,87,33,3,123,253,24,400
4107806,0,0,0,70,29,5,104,236,15,355
4107807,4,0,4,30,30,4,64,121,14,199
4107808,3,0,3,65,23,3,91,173,25,289
4107809,95,9,104,58,21,0,79,339,28,446
4107810,6,0,6,78,40,11,129,223,21,373
4107811,0,0,0,54,22,7,83,125,9,217
4107812,0,0,0,63,28,9,100,212,22,334
4107813,0,0,0,73,33,6,112,189,6,307
4107814,0,0,0,105,49,9,163,204,11,378
4107815,0,0,0,54,15,4,73,100,7,180
4107816,0,0,0,0,0,0,0,0,0,0
4107817,6,0,6,47,27,0,74,134,27,235
4107818,3,0,3,35,33,5,73,127,11,211
4107901,0,0,0,29,18,0,47,136,12,195
4107902,3,0,3,62,29,3,94,277,16,387
4107903,7,0,7,50,28,0,78,201,27,306
4107904,3,3,6,55,24,7,86,204,33,323
4107905,5,0,5,38,36,3,77,234,33,344
4107906,0,0,0,67,20,0,87,276,24,387
4107907,5,0,5,23,24,3,50,132,3,185
4107908,3,0,3,27,19,0,46,148,21,215
4107909,4,0,7,60,49,0,109,239,28,376
4107910,64,0,64,43,15,9,67,205,10,282
4107911,4,0,4,103,42,9,154,231,18,403
4107912,4,6,10,69,26,0,95,255,39,389
4107913,0,0,0,59,7,6,72,131,27,230
4107914,0,0,0,52,21,0,73,121,18,212
4107915,6,0,6,73,36,17,126,277,24,427
4107916,6,0,6,77,38,0,115,282,13,410
4107917,0,0,0,95,36,8,139,257,15,411
4107918,0,0,0,104,24,3,131,157,6,294
4107919,3,0,3,69,27,6,102,115,4,221
4108001,0,0,0,83,43,9,135,205,18,358
4108002,0,0,0,13,5,0,18,59,3,80
4108003,0,0,0,35,28,4,67,209,16,292
4108004,3,0,3,90,59,6,155,267,23,445
4108005,3,0,3,89,34,6,129,185,9,323
4108006,0,0,0,70,45,16,131,242,22,395
4108007,3,0,3,60,33,7,100,249,10,359
4108008,0,0,0,56,22,3,81,113,7,201
4108009,9,0,9,86,49,0,135,315,10,460
4108010,3,0,3,40,33,5,78,204,0,282
4108011,0,0,3,66,21,6,93,177,4,274
4108012,3,0,3,67,26,3,96,157,21,274
4108013,3,0,3,82,43,9,134,231,9,374
4108014,0,0,0,90,22,3,115,164,3,282
4108015,0,6,6,35,25,5,65,221,12,298
4108016,6,0,6,65,41,4,110,211,9,330
4108017,3,3,6,62,20,3,85,169,6,260
4108018,0,0,0,53,10,6,69,166,9,244
4108019,0,3,3,74,32,3,109,234,13,356
4108020,0,0,0,124,33,3,160,316,10,486
4108021,0,0,0,117,59,11,187,252,19,458
4108022,7,3,10,101,58,6,165,357,17,539
4108023,0,0,0,69,40,0,109,193,15,317
4108024,8,0,8,78,36,6,120,279,22,421
4108025,25,65,90,28,48,0,76,385,116,577
4108026,3,0,3,76,28,3,107,191,9,307
4108027,0,0,0,36,16,4,56,134,0,190
4108028,0,0,0,94,30,4,128,227,6,361
4108029,47,9,56,63,40,0,103,361,43,507
4108030,0,0,0,72,22,4,98,181,6,285
4108031,0,0,0,56,11,0,67,101,3,171
4108032,3,0,3,49,27,13,89,169,6,264
4108033,3,0,3,96,31,6,133,231,6,370
4108101,0,0,0,0,0,0,0,0,0,0
4108201,0,0,0,0,3,0,3,21,0,24
4108301,0,0,0,40,24,0,64,126,12,202
4108302,9,5,14,97,51,0,148,284,12,444
4108303,11,6,17,31,22,0,53,152,21,226
4108304,4,6,13,103,51,4,158,302,30,490
4108305,75,12,87,73,35,6,114,407,28,549
4108306,0,0,0,14,9,0,23,36,4,63
4108307,0,0,0,132,35,0,167,143,12,322
4108308,3,0,3,158,36,9,203,187,19,409
4108309,3,0,3,72,47,3,122,222,9,353
4108310,0,0,0,32,15,3,50,110,6,166
4108311,0,3,3,50,26,0,76,157,12,245
4108312,31,4,35,87,36,3,126,266,23,415
4108313,0,0,0,45,13,0,58,167,3,228
4108314,7,3,10,34,23,0,57,163,10,230
4108315,0,0,0,60,31,0,91,189,4,284
4108401,6,7,13,43,31,0,74,194,13,281
4108402,0,0,0,29,7,6,42,143,3,188
4108403,3,3,6,70,31,6,107,230,35,372
4108404,0,3,3,57,49,6,112,203,41,356
4108405,6,0,6,31,18,3,52,128,6,186
4108406,3,0,3,60,44,9,113,233,13,359
4108407,3,0,3,64,29,7,100,149,9,258
4108408,0,0,0,58,38,4,100,218,10,328
4108409,3,6,12,85,43,9,137,267,19,423
4108410,7,3,10,81,38,3,122,306,27,455
4108411,3,0,6,52,33,0,85,199,3,287
4108412,3,0,3,81,17,4,102,155,7,264
4108413,3,0,9,77,35,12,124,298,35,457
4108414,3,0,3,90,32,6,128,231,12,371
4108415,0,0,0,56,22,3,81,211,9,301
4108416,80,8,88,7,21,0,28,231,28,287
4108417,45,6,51,75,44,0,119,344,20,483
4108418,4,0,4,87,40,0,127,235,23,385
4108419,7,5,12,95,56,0,151,336,34,521
4108420,4,0,4,103,44,3,150,260,22,432
4108421,6,3,9,93,43,11,147,317,30,494
4108422,0,0,0,67,26,0,93,223,22,338
4108423,6,3,9,82,42,6,130,208,12,350
4108424,3,0,3,106,44,0,150,323,34,507
4108425,0,0,0,51,27,3,81,115,12,208
4108426,5,0,5,56,23,3,82,149,15,246
4108427,0,0,0,62,29,3,94,182,13,289
4108428,0,0,0,70,49,7,126,268,12,406
4108429,0,0,0,57,41,0,98,132,15,245
4108430,0,0,0,52,35,3,90,155,21,266
4108431,3,3,6,42,11,0,53,175,10,238
4108432,0,0,0,0,0,0,0,0,0,0
4108433,0,0,0,66,13,0,79,185,12,276
4108434,0,0,0,31,13,0,44,115,16,175
4108501,0,0,0,38,26,0,64,132,14,210
4108502,6,0,6,43,29,5,77,141,16,234
4108503,0,0,0,26,26,9,61,157,33,251
4108504,0,0,0,62,25,6,93,286,42,421
4108505,3,6,9,53,25,0,78,188,21,287
4108506,3,0,3,65,65,11,141,283,30,454
4108507,3,0,3,37,14,0,51,111,11,173
4108508,0,0,0,57,36,3,96,201,12,309
4108509,0,0,0,74,43,5,122,244,33,399
4108510,3,0,3,64,24,9,97,256,41,394
4108511,0,3,3,83,35,3,121,260,41,422
4108512,3,0,3,80,56,9,145,257,26,428
4108513,8,0,8,61,20,0,81,225,59,365
4108514,6,0,6,40,13,0,53,178,28,259
4108515,7,0,7,36,33,3,72,239,21,332
4108516,8,0,8,49,25,3,77,213,9,299
4108517,0,0,0,52,40,0,92,174,11,277
4108518,13,0,13,44,43,0,87,220,21,328
4108519,14,3,17,79,43,0,122,324,22,468
4108520,0,0,0,44,26,3,73,164,27,264
4108521,7,0,7,71,32,3,106,180,10,296
4108522,5,0,5,63,60,6,129,286,29,444
4108523,6,0,6,38,10,0,48,185,13,246
4108601,0,0,0,71,31,0,102,216,12,330
4108602,52,6,61,96,37,0,133,407,29,569
4108603,3,0,3,81,60,8,149,282,22,453
4108604,0,0,0,60,22,6,88,223,4,315
4108605,3,0,3,61,33,6,100,236,12,348
4108606,0,0,0,43,14,6,63,98,13,174
4108607,5,3,11,93,49,9,151,281,23,455
4108608,4,0,4,90,39,0,129,239,17,385
4108609,3,0,3,95,31,3,129,297,41,467
4108610,6,0,6,59,38,3,100,212,15,327
4108611,6,0,6,73,30,4,107,334,38,479
4108612,6,3,9,59,24,9,92,226,14,332
4108613,3,3,6,69,34,9,112,233,33,378
4108614,3,0,3,60,41,10,111,254,26,391
4108615,69,14,86,82,43,11,136,420,52,608
4108616,0,0,0,64,18,0,82,161,9,252
4108617,3,0,3,128,25,3,156,244,10,410
4108618,7,0,7,76,28,9,113,249,12,374
4108619,0,0,0,90,26,6,122,209,21,352
4108620,3,0,3,42,28,0,70,191,21,282
4108621,0,0,0,0,0,0,0,0,0,0
4108622,0,0,0,75,41,6,122,207,22,351
4108701,0,0,0,67,29,4,100,184,35,319
4108702,4,0,4,100,37,6,143,217,21,381
4108703,3,0,3,147,36,9,192,190,14,396
4108704,4,0,4,79,36,8,123,275,46,444
4108705,4,0,4,83,37,3,123,230,30,383
4108706,4,0,4,72,32,4,108,239,12,359
4108707,3,0,3,70,25,9,104,209,53,366
4108708,0,0,0,65,41,9,115,212,22,349
4108709,0,0,0,96,19,4,119,267,25,411
4108710,88,7,95,57,39,3,99,420,70,589
4108711,5,0,5,79,43,6,128,290,23,441
4108712,4,3,7,74,27,6,107,184,16,307
4108713,6,0,6,80,29,4,113,194,33,340
4108714,18,13,31,55,35,0,90,257,37,384
4108715,8,0,8,80,48,5,133,301,21,455
4108716,12,0,12,58,33,3,94,286,22,402
4108717,0,0,0,200,45,0,245,320,40,605
4108718,3,3,6,80,36,15,131,216,42,389
4108719,0,0,0,68,25,0,93,169,29,291
4108720,0,0,0,36,11,0,47,122,9,178
4108721,4,0,4,106,55,9,170,293,39,502
4108722,3,0,3,41,27,6,74,197,12,283
4108723,6,0,6,130,37,9,176,312,14,502
4108724,0,0,0,84,50,5,139,317,35,491
4108725,9,3,12,56,29,0,85,217,19,321
4108726,6,0,6,45,24,4,73,206,19,298
4108727,9,0,9,59,15,4,78,160,23,261
4108728,9,0,9,62,22,12,96,162,11,269
4108729,5,0,5,80,25,0,105,190,21,316
4108730,6,0,6,87,46,3,136,253,28,417
4108731,3,0,3,56,20,7,83,146,21,250
4108732,6,3,9,55,41,3,99,221,28,348
4108733,6,3,9,68,42,6,116,205,25,346
4108734,4,0,4,87,37,3,127,248,22,397
4108735,0,6,6,81,31,0,112,262,21,395
4108736,7,0,7,72,62,10,144,323,16,483
4108737,0,0,0,331,94,18,443,632,115,1190
4108738,0,0,0,44,22,0,66,106,9,181
4108801,6,0,6,63,33,9,105,210,12,327
4108802,3,3,6,73,26,11,110,154,16,280
4108803,0,6,6,70,24,6,100,215,11,326
4108804,11,0,11,99,39,12,150,214,9,373
4108805,6,0,6,35,24,9,68,128,6,202
4108806,0,0,0,27,18,0,45,82,3,130
4108807,0,0,0,45,25,3,73,193,7,273
4108808,0,0,0,54,29,7,90,206,13,309
4108809,0,0,0,38,13,3,54,136,0,190
4108810,3,0,3,27,23,0,50,176,12,238
4108901,0,0,0,0,0,0,0,0,0,0
4108902,0,0,0,117,42,15,174,263,6,443
4108903,23,7,30,89,38,4,131,344,28,503
4108904,12,0,12,63,52,6,121,265,35,421
4108905,4,3,10,86,29,10,125,193,3,321
4108906,0,0,0,99,23,0,122,167,3,292
4108907,6,0,9,64,35,0,99,196,8,303
4108908,0,0,0,74,27,3,104,270,12,386
4108909,0,0,0,74,23,0,97,171,21,289
4108910,0,0,0,46,15,3,64,98,3,165
4108911,0,0,0,88,31,4,123,200,12,335
4108912,0,0,0,81,21,4,106,175,13,294
4108913,0,3,3,94,28,0,122,165,11,298
4108914,0,0,0,83,10,8,101,151,0,252
4108915,0,0,0,98,24,10,132,167,15,314
4108916,0,0,0,114,29,0,143,231,19,393
4108917,0,0,0,95,27,7,129,248,15,392
4108918,0,0,0,36,26,3,65,120,0,185
4108919,0,0,0,95,46,6,147,176,6,329
4108920,3,3,6,146,50,0,196,373,28,597
4108921,0,0,0,56,24,4,84,160,0,244
4108922,64,0,64,61,18,8,87,320,6,413
4108923,6,3,9,117,36,6,159,263,15,437
4108924,3,0,3,58,24,3,85,142,3,230
4108925,3,0,3,69,29,10,108,170,5,283
4108926,8,0,8,66,36,9,111,180,10,301
4108927,4,0,4,54,29,3,86,147,0,233
4108928,0,0,0,0,0,0,0,0,0,0
4109001,3,0,3,45,7,0,52,147,17,216
4109002,7,0,7,62,15,0,77,193,10,280
4109003,17,3,20,93,26,3,122,283,22,427
4109004,14,3,17,85,25,9,119,221,16,356
4109005,12,3,15,73,33,0,106,214,9,329
4109006,0,3,3,51,20,0,71,114,18,203
4109007,4,3,7,50,10,3,63,238,22,323
4109008,8,3,11,80,17,0,97,252,35,384
4109009,16,6,22,63,23,0,86,236,23,345
4109010,16,3,19,95,26,3,124,234,16,374
4109011,5,0,5,51,9,6,66,162,0,228
4109012,11,3,14,57,7,6,70,227,24,321
4109013,21,42,63,69,28,6,103,261,95,459
4109014,9,0,9,83,20,6,109,269,18,396
4109015,10,6,16,59,12,0,71,228,34,333
4109016,0,0,0,59,21,0,80,237,22,339
4109017,3,3,6,45,11,0,56,133,12,201
4109018,47,3,50,29,0,0,29,140,15,184
4109019,7,0,7,41,24,0,65,168,21,254
4109101,10,0,10,51,30,3,84,261,20,365
4109102,12,3,15,52,30,0,82,264,32,378
4109103,10,0,13,61,39,3,103,320,14,437
4109104,6,0,6,58,57,0,115,241,9,365
4109105,8,0,8,44,28,0,72,230,8,310
4109106,9,3,12,71,37,0,108,276,19,403
4109107,4,3,7,37,49,6,92,209,12,313
4109108,0,0,0,40,37,0,77,197,18,292
4109109,6,0,6,33,28,0,61,206,15,282
4109110,7,3,10,45,19,0,64,185,15,264
4109111,9,3,12,75,27,3,105,235,21,361
4109112,13,7,20,62,13,9,84,249,16,349
4109113,25,0,25,104,36,14,154,364,33,551
4109114,8,0,8,66,16,3,85,217,12,314
4109115,10,5,15,97,37,0,134,279,9,422
4109116,6,0,6,50,23,3,76,172,18,266
4109117,9,0,9,95,73,3,171,333,26,530
4109118,9,0,9,83,51,8,142,334,9,485
4109119,27,11,38,95,33,6,134,378,67,579
4109120,4,0,4,41,27,0,68,174,19,261
4109121,8,0,8,72,17,0,89,232,12,333
4109122,16,0,16,95,38,0,133,332,52,517
4109123,14,5,19,71,27,0,98,336,116,550
4109124,10,0,10,49,6,0,55,171,9,235
4109125,11,4,15,59,25,0,84,239,13,336
4109126,17,3,20,73,33,6,112,322,65,499
4109127,19,0,19,37,18,0,55,277,58,390
4109128,8,6,14,61,25,0,86,236,50,372
4109129,4,0,4,72,25,9,106,212,41,359
4109130,10,26,36,61,25,3,89,208,85,382
4109201,8,3,11,114,30,8,152,311,30,493
4109202,3,0,3,75,31,0,106,232,18,356
4109203,10,7,17,29,9,3,41,129,10,180
4109204,15,0,15,73,22,5,100,217,9,326
4109205,7,0,7,76,16,9,101,155,12,268
4109206,9,0,9,52,35,0,87,287,20,394
4109207,3,0,3,41,39,0,80,244,4,328
4109208,4,0,4,38,39,0,77,201,5,283
4109209,11,3,14,53,44,0,97,293,29,419
4109210,11,0,11,110,65,0,175,369,14,558
4109211,0,0,0,52,21,0,73,201,20,294
4109212,5,0,5,56,35,0,91,140,5,236
4109213,8,0,8,77,35,3,115,196,17,328
4109214,9,6,15,76,18,3,97,255,32,384
4109215,13,3,16,54,39,0,93,239,23,355
4109216,7,0,7,81,28,0,109,188,13,310
4109217,7,0,7,28,34,3,65,183,12,260
4109218,4,0,4,116,53,4,173,298,21,492
4109219,9,0,9,60,37,3,100,275,21,396
4109220,14,3,17,101,37,6,144,326,29,499
4109221,6,0,6,70,52,3,125,278,24,427
4109222,7,3,10,87,54,4,145,345,33,523
4109223,3,6,9,40,4,3,47,153,15,215
4109224,0,0,0,62,23,8,93,194,18,305
4109225,15,0,15,69,25,4,98,257,22,377
4109226,0,4,4,47,34,3,84,175,19,278
4109227,3,3,6,51,10,4,65,175,12,252
4109228,9,3,12,37,25,0,62,113,6,181
4109229,0,0,0,45,29,3,77,200,31,308
4109230,9,0,9,39,36,3,78,186,12,276
4109231,14,3,17,41,36,0,77,210,22,309
4109232,7,0,7,42,31,0,73,243,6,322
4109233,3,3,6,67,15,4,86,255,49,390
4109234,7,0,7,91,30,3,124,219,43,386
4109301,6,0,6,83,36,3,122,257,12,391
4109302,11,0,11,96,27,3,126,321,25,472
4109303,0,0,0,21,6,0,27,96,16,139
4109304,0,0,0,50,21,6,77,220,10,307
4109305,16,0,16,107,43,0,150,408,43,601
4109306,3,3,9,65,28,12,105,214,16,335
4109307,10,0,10,90,19,0,109,261,30,400
4109308,10,0,10,37,12,0,49,219,27,295
4109309,9,3,12,48,24,0,72,240,41,353
4109310,12,3,15,37,20,0,57,219,27,303
4109311,5,0,5,52,12,6,70,319,47,436
4109312,4,0,4,47,12,3,62,190,14,266
4109313,3,0,3,49,16,0,65,193,3,261
4109314,0,3,3,33,16,0,49,249,25,323
4109315,4,0,4,39,19,3,61,217,23,301
4109316,3,0,3,89,21,3,113,282,32,427
4109317,3,3,6,50,17,13,80,225,24,329
4109318,3,0,3,16,15,0,31,175,15,221
4109319,0,3,3,23,15,3,41,224,59,324
4109320,0,26,26,43,17,0,60,224,50,334
4109321,29,0,29,51,17,0,68,315,41,424
4109322,0,0,0,35,15,3,53,211,28,292
4109323,3,0,3,75,24,4,103,296,14,413
4109324,10,0,10,64,24,6,94,219,6,319
4109325,3,0,3,56,19,0,75,177,3,255
4109326,6,0,6,36,19,6,61,141,3,205
4109327,6,3,9,80,21,3,104,341,18,463
4109328,13,0,13,75,20,3,98,225,3,326
4109329,6,6,12,57,14,0,71,187,18,276
4109330,3,0,3,35,8,0,43,141,10,194
4109331,0,0,0,48,15,0,63,148,14,225
4109332,3,0,3,51,21,0,72,160,21,253
4109333,7,0,7,47,19,6,72,200,18,290
4109334,7,3,10,66,18,3,87,183,18,288
4109335,10,0,10,87,15,12,114,281,29,424
4109336,0,0,0,44,13,6,63,138,15,216
4109337,0,28,28,65,25,0,90,184,52,326
4109338,3,3,6,61,10,5,76,161,19,256
4109339,4,0,4,59,28,3,90,188,15,293
4109340,0,0,0,60,32,0,92,209,6,307
4109341,4,0,4,57,27,0,84,157,13,254
4109342,8,0,8,50,21,0,71,185,22,278
4109343,0,0,0,56,27,0,83,149,24,256
4109344,28,31,59,62,10,3,75,191,83,349
4109401,10,3,13,72,31,4,107,291,44,442
4109402,10,0,13,67,30,0,97,205,13,315
4109403,10,0,16,55,33,4,92,218,26,336
4109404,12,0,12,95,40,0,135,320,36,491
4109405,6,4,10,66,13,0,79,280,33,392
4109406,16,3,19,56,29,0,85,277,36,398
4109407,13,3,16,80,25,3,108,396,34,538
4109408,92,4,100,96,33,8,137,443,48,628
4109409,0,0,0,0,0,0,0,0,0,0
4109410,0,0,0,0,0,0,0,0,0,0
4109411,11,0,11,85,22,3,110,272,18,400
4109412,10,0,10,45,20,6,71,174,19,264
4109413,4,3,7,69,18,0,87,135,15,237
4109414,5,0,5,60,27,0,87,173,11,271
4109501,0,0,0,0,0,0,0,0,0,0
4109502,8,7,15,51,48,0,99,209,15,323
4109503,9,0,9,102,46,3,151,281,12,444
4109504,10,0,10,36,24,0,60,282,23,365
4109505,17,6,23,70,43,0,113,351,21,485
4109506,13,32,45,49,17,0,66,263,70,399
4109507,5,0,5,36,12,0,48,171,6,225
4109508,16,7,23,38,27,0,65,229,26,320
4109509,12,3,15,75,32,0,107,326,50,483
4109510,5,5,10,45,27,3,75,210,35,320
4109511,70,0,70,82,27,10,119,398,16,533
4109512,20,3,23,84,30,6,120,264,23,407
4109513,9,6,15,59,24,0,83,201,12,296
4109514,8,0,8,42,13,0,55,169,17,241
4109515,12,0,12,51,21,3,75,219,21,315
4109516,3,3,6,83,24,4,111,248,32,391
4109517,0,0,0,0,0,0,0,0,0,0
4109518,30,3,33,9,22,0,31,170,21,222
4109519,7,3,13,55,34,0,89,274,38,401
4109520,0,0,0,47,24,6,77,200,15,292
4109521,8,0,8,78,38,6,122,255,27,404
4109522,11,6,17,59,43,0,102,235,22,359
4109523,11,4,15,79,32,0,111,263,29,403
4109524,6,0,6,61,29,4,94,287,14,395
4109525,7,7,14,66,29,3,98,304,40,442
4109526,5,3,8,49,21,0,70,164,16,250
4109527,5,0,5,43,26,6,75,188,8,271
4109528,15,0,15,68,14,4,86,176,12,274
4109529,4,0,4,56,45,9,110,230,19,359
4109530,97,0,97,58,37,3,98,379,9,486
4109531,34,7,41,58,32,0,90,293,22,405
4109532,3,0,3,59,28,6,93,305,27,425
4109533,9,0,9,61,30,6,97,216,15,328
4109534,5,0,5,45,12,3,60,100,3,163
4109535,12,0,12,81,43,3,127,233,9,369
4109536,3,0,3,40,20,6,66,167,4,237
4109537,3,0,3,80,26,5,111,170,8,289
4109538,103,0,103,22,15,0,37,209,10,256
4109539,6,0,6,30,52,3,85,209,12,306
4109540,0,0,0,36,23,3,62,130,24,216
4109541,4,3,7,45,9,0,54,141,10,205
4109601,16,4,20,50,44,3,97,259,19,375
4109602,0,0,0,44,39,9,92,239,17,348
4109603,12,0,12,33,24,0,57,241,24,322
4109604,13,3,16,39,34,6,79,235,34,348
4109605,20,8,28,65,41,0,106,431,58,595
4109606,13,7,20,51,39,0,90,378,19,487
4109607,6,3,9,28,34,0,62,161,24,247
4109608,32,3,35,22,22,0,44,244,24,312
4109609,11,75,86,62,15,3,80,248,137,465
4109610,15,0,15,68,47,0,115,303,43,461
4109611,3,0,3,23,35,0,58,152,12,222
4109612,23,11,34,29,41,0,70,234,33,337
4109613,0,0,0,25,26,0,51,213,32,296
4109614,6,0,6,54,26,6,86,231,29,346
4109615,0,0,0,27,31,9,67,198,8,273
4109616,6,0,6,29,32,4,65,167,0,232
4109617,20,3,23,49,38,4,91,300,17,408
4109618,12,0,12,46,16,4,66,211,18,295
4109619,7,0,7,63,73,0,136,317,19,472
4109620,8,0,8,52,37,9,98,301,13,412
4109621,15,4,19,70,60,0,130,319,20,469
4109622,5,0,5,80,50,6,136,289,23,448
4109623,9,4,13,53,25,6,84,247,22,353
4109624,7,3,10,73,56,3,132,309,19,460
4109625,14,4,18,68,75,0,143,344,27,514
4109626,32,7,39,45,53,6,104,331,20,455
4109627,5,0,5,45,23,0,68,147,6,221
4109628,3,0,3,34,35,0,69,188,3,260
4109629,4,3,7,32,33,0,65,245,21,331
4109630,7,0,7,40,35,0,75,183,15,273
4109631,3,3,6,53,44,3,100,216,18,334
4109632,15,0,15,53,17,0,70,203,4,277
4109633,3,0,3,29,21,4,54,219,19,292
4109634,9,0,9,82,34,0,116,223,26,365
4109701,40,10,50,30,9,0,39,200,39,278
4109702,5,0,5,62,21,9,92,244,21,357
4109703,7,4,11,53,10,6,69,195,60,324
4109704,53,7,60,67,18,0,85,292,41,418
4109705,11,0,11,78,20,3,101,250,26,377
4109706,8,0,8,66,21,0,87,195,28,310
4109707,36,5,41,46,23,3,72,298,31,401
4109708,3,0,3,49,15,0,64,125,15,204
4109709,3,0,3,74,16,3,93,260,46,399
4109710,3,0,3,49,24,3,76,177,21,274
4109711,0,0,0,23,0,0,23,51,9,83
4109712,14,3,17,71,15,9,95,355,19,469
4109713,6,0,6,87,20,0,107,203,8,318
4109714,6,0,6,49,19,3,71,167,6,244
4109715,17,0,17,77,32,3,112,296,35,443
4109716,8,3,11,43,26,0,69,230,9,308
4109717,4,3,7,60,33,6,99,206,31,336
4109718,0,0,0,137,22,6,165,337,49,551
4109719,10,0,10,61,20,5,86,229,21,336
4109720,11,0,11,83,3,3,89,229,61,379
4109721,3,6,9,111,26,3,140,331,50,521
4109722,3,3,6,46,27,4,77,163,9,249
4109723,22,3,25,104,31,3,138,371,42,551
4109724,14,9,23,50,24,0,74,204,20,298
4109725,8,0,8,51,25,0,76,208,10,294
4109726,32,4,36,59,25,0,84,288,30,402
4109727,3,0,3,54,15,0,69,187,13,269
4109728,4,0,4,62,20,7,89,211,9,309
4109729,5,0,5,85,27,0,112,240,34,386
4109730,9,3,12,71,24,0,95,246,40,381
4109731,9,0,9,102,31,0,133,277,49,459
4109732,6,3,9,64,16,0,80,200,18,298
4109733,3,0,3,67,8,0,75,169,9,253
4109734,0,0,0,57,21,3,81,152,7,240
4109735,4,4,8,35,19,0,54,159,4,217
4109736,3,0,3,68,17,0,85,164,27,276
4109737,3,0,3,45,17,0,62,197,7,266
4109801,0,0,0,0,0,0,0,0,0,0
4109901,0,0,0,32,15,3,50,220,55,325
4109902,93,12,105,15,15,6,36,255,30,321
4109903,6,0,6,50,25,4,79,190,22,291
4109904,5,3,8,67,28,7,102,204,18,324
4109905,6,0,6,78,26,12,116,285,33,434
4109906,6,0,6,53,17,0,70,134,19,223
4109907,3,0,6,81,35,0,116,196,27,339
4109908,17,3,23,76,31,0,107,243,11,361
4109909,10,0,10,70,31,5,106,185,17,308
4109910,3,0,3,66,34,4,104,203,21,328
4109911,12,0,12,101,39,0,140,283,21,444
4109912,15,0,15,87,44,0,131,285,24,440
4109913,22,0,22,60,43,3,106,344,36,486
4109914,10,0,10,84,44,18,146,314,23,483
4109915,3,0,3,78,26,4,108,286,32,426
4109916,6,0,6,49,29,3,81,156,7,244
4109917,0,0,0,66,24,9,99,187,13,299
4109918,7,0,7,65,30,3,98,200,14,312
4109919,9,3,12,84,33,12,129,334,32,495
4109920,7,0,7,59,15,6,80,192,27,299
4109921,9,0,9,58,37,10,105,219,15,339
4109922,0,0,0,0,0,0,0,0,0,0
4109923,0,0,0,24,18,0,42,134,63,239
4109924,4,0,4,48,19,0,67,170,26,263
4109925,3,0,3,61,27,4,92,341,48,481
4109926,4,0,4,62,36,6,104,292,31,427
4109927,3,4,7,40,16,0,56,159,22,237
4109928,6,3,9,89,29,0,118,281,33,432
4109929,4,3,7,35,18,3,56,162,29,247
4109930,4,25,29,48,17,4,69,167,50,286
4109931,6,0,6,42,21,5,68,203,43,314
4109932,8,0,8,80,24,6,110,213,28,351
4109933,9,6,15,62,31,6,99,258,63,420
4109934,6,0,6,80,35,3,118,282,46,446
4109935,5,0,5,56,30,0,86,188,37,311
4109936,0,0,0,0,0,0,0,0,0,0
4109937,9,0,9,39,19,6,64,104,12,180
4110001,8,5,13,45,14,6,65,160,19,244
4110002,7,0,7,26,15,3,44,239,24,307
4110003,0,0,0,56,27,3,86,199,15,300
4110004,8,3,11,32,11,0,43,178,25,246
4110005,4,0,4,37,42,0,79,168,12,259
4110006,0,0,0,53,20,0,73,132,4,209
4110007,4,0,4,75,38,9,122,201,16,339
4110008,13,5,18,78,32,3,113,236,15,364
4110009,13,0,13,65,24,3,92,225,13,330
4110010,21,7,28,73,48,3,124,249,19,392
4110011,7,3,10,71,32,9,112,251,20,383
4110012,6,0,6,49,19,0,68,207,10,285
4110013,0,0,0,80,23,4,107,219,7,333
4110014,0,0,0,39,21,3,63,176,9,248
4110015,0,4,4,91,29,0,120,243,16,379
4110016,5,0,5,66,26,0,92,162,15,269
4110017,3,4,7,35,20,6,61,155,20,236
4110018,7,5,12,45,16,0,61,194,14,269
4110019,4,3,7,76,37,11,124,201,15,340
4110020,0,0,0,60,29,7,96,218,33,347
4110021,4,3,7,55,48,0,103,272,31,406
4110022,0,0,0,3,0,0,3,19,0,22
4110023,3,0,3,67,29,0,96,286,23,405
4110024,4,0,7,74,54,0,128,270,12,410
4110025,9,0,9,72,32,12,116,276,38,430
4110026,5,3,8,54,25,0,79,299,44,422
4110027,75,9,84,87,41,4,132,500,50,682
4110028,0,0,0,0,0,0,0,0,0,0
4110029,3,0,3,35,24,3,62,220,16,298
4110030,6,0,6,69,29,0,98,226,19,343
4110031,0,0,0,54,27,7,88,153,9,250
4110032,3,0,3,24,30,3,57,154,15,226
4110033,9,0,9,47,60,3,110,278,24,412
4110034,18,19,37,47,24,0,71,197,53,321
4110035,18,0,18,17,31,0,48,188,21,257
4110036,0,0,0,71,19,3,93,193,18,304
4110037,0,0,0,20,34,0,54,167,15,236
4110038,0,0,0,46,23,3,72,157,15,244
4110101,4,0,4,44,18,0,62,206,20,288
4110102,9,0,9,63,13,5,81,232,32,345
4110103,7,0,7,26,8,4,38,122,11,171
4110104,10,0,10,56,30,0,86,249,32,367
4110105,6,0,6,83,18,0,101,340,18,459
4110106,10,0,10,28,20,0,48,167,30,245
4110107,6,0,6,80,40,9,129,304,35,468
4110108,9,3,12,81,30,3,114,284,31,429
4110109,9,0,9,50,19,5,74,166,18,258
4110110,4,0,4,53,13,6,72,197,26,295
4110111,13,0,13,66,28,0,94,265,19,378
4110112,14,3,17,26,25,0,51,209,36,296
4110113,16,3,19,42,14,3,59,252,13,324
4110114,6,6,12,65,28,0,93,256,28,377
4110115,7,0,7,62,24,0,86,223,24,333
4110116,3,0,3,18,14,0,32,113,8,153
4110117,12,0,12,81,38,9,128,313,35,476
4110118,10,3,13,79,48,0,127,328,36,491
4110119,7,0,7,29,26,0,55,178,17,250
4110120,12,0,12,60,31,6,97,298,38,433
4110121,7,0,7,113,49,0,162,305,39,506
4110122,0,0,0,3,0,0,3,0,0,3
4110123,9,3,12,68,24,0,92,222,32,346
4110124,7,4,11,39,18,0,57,157,13,227
4110125,4,0,4,73,19,0,92,277,44,413
4110126,7,0,7,86,30,6,122,300,36,458
4110127,3,0,3,36,15,0,51,190,21,262
4110201,0,0,0,58,6,0,64,139,17,220
4110202,3,0,3,0,0,0,0,3,0,3
4110203,0,4,4,16,6,0,22,79,15,116
4110204,7,0,7,56,6,4,66,175,31,272
4110205,5,0,5,63,21,3,87,185,40,312
4110206,4,0,4,82,15,0,97,181,37,315
4110207,10,3,13,61,25,0,86,284,23,393
4110208,5,3,8,50,10,0,60,223,25,308
4110209,3,0,3,77,10,0,87,210,27,324
4110210,6,3,9,47,27,6,80,258,42,380
4110211,81,5,86,233,50,0,283,808,108,1199
4110212,3,0,3,48,16,0,64,171,44,279
4110213,7,0,7,62,23,0,85,269,39,393
4110214,13,3,16,38,7,3,48,220,20,288
4110215,13,0,13,69,24,4,97,290,40,427
4110216,12,0,12,44,19,0,63,262,69,394
4110217,30,6,36,63,23,0,86,364,30,480
4110218,36,0,36,3,3,0,6,158,6,170
4110219,0,0,0,0,0,0,0,0,0,0
4110220,6,3,9,199,48,4,251,543,50,844
4110221,0,0,0,0,3,0,3,5,0,8
4110222,16,0,16,66,21,3,90,306,38,434
4110223,4,0,4,55,9,0,64,217,30,311
4110224,0,0,0,0,0,0,0,3,0,3
4110225,17,3,20,64,30,0,94,330,43,467
4110226,8,0,8,42,13,3,58,198,24,280
4110227,8,0,8,93,21,0,114,306,25,445
4110228,13,3,16,75,25,6,106,279,22,407
4110229,9,0,9,53,13,8,74,252,30,356
4110230,0,0,0,0,0,0,0,0,0,0
4110231,14,0,14,62,17,0,79,232,30,341
4110232,3,0,3,51,14,0,65,247,26,338
4110233,9,3,12,51,28,0,79,249,17,345
4110234,15,0,15,85,12,0,97,262,27,386
4110235,13,3,16,54,19,0,73,267,38,378
4110236,18,6,24,37,19,9,65,253,6,324
4110237,12,0,12,54,30,3,87,239,20,346
4110238,8,3,11,97,13,0,110,374,74,558
4110239,8,4,12,57,7,0,64,198,35,297
4110240,10,0,10,93,10,0,103,274,31,408
4110241,4,0,4,54,15,3,72,192,19,283
4110242,7,3,10,59,13,0,72,166,29,267
4110301,0,0,0,0,0,0,0,12,0,12
4110401,0,0,0,0,0,0,0,0,0,0
4110501,0,0,0,26,18,3,47,101,6,154
4110502,7,5,12,45,34,6,85,239,14,338
4110503,18,3,21,83,37,3,123,341,16,480
4110504,50,14,64,41,21,0,62,253,31,346
4110505,44,10,54,73,35,0,108,235,24,367
4110506,9,3,12,65,30,6,101,203,24,328
4110507,10,3,13,44,15,0,59,134,9,202
4110601,36,3,39,72,25,6,103,342,32,477
4110602,14,3,20,67,37,3,107,292,26,425
4110603,14,6,20,52,24,0,76,250,48,374
4110604,11,7,18,47,18,0,65,290,19,374
4110605,0,3,3,59,16,0,75,249,37,361
4110606,0,3,3,55,30,3,88,254,53,395
4110607,12,0,12,73,35,0,108,266,17,391
4110608,12,3,15,73,29,6,108,372,71,551
4110609,9,0,9,69,20,0,89,217,7,313
4110610,15,8,23,48,25,0,73,279,38,390
4110611,3,0,3,35,33,3,71,232,18,321
4110612,6,0,6,59,24,6,89,209,11,309
4110613,15,3,18,67,36,6,109,249,9,367
4110614,6,0,6,37,18,0,55,142,24,221
4110615,0,0,0,47,24,0,71,178,10,259
4110616,6,0,6,63,24,0,87,248,12,347
4110617,11,0,11,65,30,4,99,295,15,409
4110618,3,0,3,111,19,0,130,207,23,360
4110619,6,3,9,80,23,3,106,173,30,309
4110620,9,3,12,97,24,0,121,277,23,421
4110621,9,0,9,51,21,0,72,161,15,248
4110622,10,6,16,79,36,0,115,238,12,365
4110623,46,6,52,67,29,0,96,351,21,468
4110624,0,0,0,44,30,0,74,131,25,230
4110625,3,6,9,73,35,0,108,186,19,313
4110626,10,0,10,83,38,7,128,252,21,401
4110627,12,4,16,84,26,0,110,289,21,420
4110628,3,0,3,45,23,0,68,122,0,190
4110629,12,3,15,37,9,0,46,235,12,293
4110701,0,0,0,0,0,0,0,0,0,0
4110702,7,0,7,70,12,0,82,296,21,399
4110703,6,0,6,74,27,0,101,197,15,313
4110704,107,4,111,51,21,0,72,380,22,474
4110705,3,0,3,20,15,0,35,96,9,140
4110706,6,0,6,33,11,4,48,101,15,164
4110707,3,3,9,73,15,4,92,116,22,230
4110708,10,3,13,92,48,12,152,341,23,516
4110709,5,3,8,63,39,0,102,211,24,337
4110710,7,6,13,43,33,0,76,281,30,387
4110711,8,3,11,49,53,0,102,259,21,382
4110712,0,0,0,0,0,0,0,0,0,0
4110713,10,0,10,40,23,4,67,257,29,353
4110714,7,3,10,55,11,3,69,173,18,260
4110715,8,7,15,82,42,0,124,320,30,474
4110716,10,3,13,45,30,0,75,229,16,320
4110717,11,76,90,75,38,6,119,318,129,566
4110718,8,0,8,95,28,0,123,360,40,523
4110719,7,0,7,115,27,3,145,288,27,460
4110720,0,0,0,31,22,0,53,171,11,235
4110721,7,0,7,67,33,0,100,335,16,451
4110722,16,3,19,115,44,4,163,355,29,547
4110723,10,3,13,83,23,3,109,314,38,461
4110724,5,3,8,86,33,0,119,324,29,472
4110725,4,4,8,49,18,6,73,198,26,297
4110726,18,0,18,15,15,0,30,185,15,230
4110727,7,3,10,62,31,3,96,277,17,390
4110728,0,5,5,62,27,9,98,315,35,448
4110729,15,0,20,82,37,0,119,345,25,489
4110730,13,0,13,88,26,5,119,377,35,531
4110731,12,0,12,79,24,4,107,303,36,446
4110732,4,3,7,37,16,0,53,198,15,266
4110733,3,3,6,72,18,0,90,373,32,495
4110734,8,0,8,50,20,0,70,211,11,292
4110735,19,0,19,52,25,0,77,333,38,448
4110736,3,0,3,90,32,0,122,430,25,577
4110737,20,3,23,83,33,8,124,322,28,474
4110738,12,0,12,59,30,12,101,332,22,455
4110739,0,0,0,0,0,0,0,4,0,4
4110740,8,0,11,34,23,0,57,280,25,362
4110741,7,0,7,66,35,11,112,251,21,384
4110742,3,0,3,59,28,0,87,269,9,365
4110743,12,0,12,60,33,3,96,225,21,342
4110744,13,0,13,55,20,3,78,215,25,318
4110745,63,96,159,22,7,0,29,186,167,382
4110746,10,0,10,51,24,6,81,202,16,299
4110747,8,0,8,58,24,0,82,252,11,345
4110748,5,0,5,70,19,3,92,139,18,249
4110749,7,3,10,74,41,0,115,228,13,356
4110750,23,3,26,47,15,0,62,214,24,300
4110751,7,0,7,61,46,3,110,250,18,378
4110752,37,6,43,45,31,6,82,337,39,458
4110753,8,3,11,62,21,4,87,172,13,272
4110754,0,0,0,34,12,0,46,132,21,199
4110755,8,0,8,36,9,0,45,141,6,192
4110801,6,0,6,45,26,3,74,289,32,395
4110802,6,0,6,44,16,0,60,281,43,384
4110803,5,0,5,62,11,0,73,238,31,342
4110804,18,4,22,62,23,3,88,300,44,432
4110805,6,0,6,60,27,0,87,250,39,376
4110806,6,0,6,47,18,0,65,258,6,329
4110807,0,0,0,36,21,3,60,216,12,288
4110808,8,0,8,72,49,6,127,283,23,433
4110809,0,0,0,0,0,0,0,0,0,0
4110810,4,0,4,73,23,0,96,228,18,342
4110811,12,4,16,78,12,0,90,307,38,435
4110812,11,0,11,56,17,6,79,312,30,421
4110813,9,3,12,78,24,3,105,312,26,443
4110814,8,0,8,72,20,0,92,253,15,360
4110815,5,0,5,72,25,4,101,334,26,461
4110816,56,3,59,47,12,6,65,282,21,368
4110817,5,4,9,72,23,0,95,196,23,314
4110818,10,0,10,102,23,8,133,336,37,506
4110819,8,0,8,114,40,3,157,360,30,547
4110820,10,0,10,76,48,3,127,381,37,545
4110821,6,3,9,59,30,0,89,302,33,424
4110822,14,0,14,114,25,3,142,377,24,543
4110823,3,3,6,20,24,0,44,234,21,299
4110824,8,6,14,65,21,3,89,202,28,319
4110825,8,0,8,78,52,0,130,327,22,479
4110826,6,0,6,57,18,0,75,252,15,342
4110827,3,0,3,49,12,3,64,210,12,286
4110828,9,0,9,72,22,0,94,248,18,360
4110829,29,3,32,53,38,3,94,401,37,532
4110830,0,3,3,48,15,3,66,256,32,354
4110831,12,0,12,54,12,0,66,196,27,289
4110832,3,3,6,28,18,6,52,172,15,239
4110833,3,4,7,34,13,0,47,162,13,222
4110834,6,0,6,36,24,6,66,200,7,273
4110835,6,0,6,34,15,0,49,178,18,245
4110836,7,0,7,54,21,0,75,229,16,320
4110837,3,5,8,44,19,0,63,233,5,301
4110901,7,4,11,60,36,6,102,148,18,268
4110902,11,6,17,55,33,3,91,296,24,411
4110903,11,3,14,32,9,0,41,125,12,178
4110904,4,3,7,38,27,0,65,192,23,280
4110905,0,0,0,0,0,0,0,0,0,0
4110906,5,0,5,51,28,0,79,268,31,378
4110907,5,0,5,60,52,0,112,295,7,414
4110908,77,0,77,45,27,3,75,248,15,338
4110909,6,0,6,80,39,3,122,188,12,322
4110910,6,6,12,80,39,3,122,215,21,358
4110911,0,0,0,59,27,0,86,208,7,301
4110912,0,0,0,0,0,0,0,8,0,8
4110913,10,0,10,45,43,6,94,207,30,331
4110914,10,0,10,32,13,0,45,153,15,213
4111001,3,0,3,65,27,4,96,209,4,309
4111002,13,0,13,71,42,9,122,239,20,381
4111003,3,3,6,40,28,3,71,195,39,305
4111004,0,3,3,52,39,6,97,193,38,328
4111005,0,0,0,33,8,3,44,90,18,152
4111006,4,3,7,54,28,0,82,143,3,228
4111007,0,0,0,36,19,0,55,107,18,180
4111008,3,0,3,72,18,0,90,158,18,266
4111009,4,0,4,70,26,3,99,222,14,335
4111010,15,3,18,50,13,0,63,147,18,228
4111011,7,0,7,56,17,0,73,176,3,252
4111012,0,3,3,44,25,3,72,188,69,329
4111013,4,0,4,58,28,0,86,203,17,306
4111014,6,3,9,56,24,7,87,169,25,281
4111015,7,3,10,67,37,3,107,190,17,314
4111016,0,0,0,58,24,4,86,149,9,244
4111017,0,0,0,122,22,4,148,171,9,328
4111101,7,3,10,34,21,4,59,180,24,263
4111102,5,0,5,55,28,0,83,147,14,244
4111103,8,0,8,60,27,10,97,217,9,323
4111104,6,3,9,41,38,3,82,149,6,237
4111105,32,3,35,35,13,0,48,149,3,200
4111106,4,3,7,43,18,0,61,129,12,202
4111107,0,0,0,33,4,0,37,102,0,139
4111108,6,0,6,83,28,0,111,287,29,427
4111109,0,0,0,75,31,9,115,160,14,289
4111110,0,0,0,49,15,0,64,145,4,213
4111111,3,0,3,55,31,0,86,208,6,300
4111112,3,3,6,63,18,9,90,169,18,277
4111113,4,0,4,37,8,0,45,143,10,198
4111114,0,0,0,93,16,11,120,173,15,308
4111115,0,5,5,50,16,6,72,87,10,169
4111116,0,0,0,75,24,6,105,176,18,299
4111117,0,0,0,38,34,0,72,140,8,220
4111118,0,0,0,85,34,9,128,219,21,368
4111119,0,0,0,33,10,0,43,129,14,186
4111120,28,0,28,46,14,5,65,144,19,228
4111121,6,4,10,54,20,6,80,171,19,270
4111122,9,3,12,48,22,3,73,198,30,301
4111123,0,0,0,53,24,3,80,240,29,349
4111124,6,0,6,47,19,9,75,112,18,205
4111125,0,0,0,61,15,6,82,171,9,262
4111201,0,0,0,61,3,0,64,106,4,174
4111202,8,0,8,59,27,0,86,129,15,230
4111203,0,0,0,27,18,3,48,93,0,141
4111204,0,0,0,92,17,3,112,207,15,334
4111205,0,0,0,53,17,3,73,106,7,186
4111206,5,0,5,79,36,0,115,276,14,405
4111207,0,3,3,74,26,6,106,199,21,326
4111208,3,0,3,54,13,0,67,141,15,223
4111209,0,0,0,26,15,0,41,98,0,139
4111210,0,0,0,41,13,0,54,154,21,229
4111211,3,3,6,53,18,0,71,125,6,202
4111212,0,0,0,93,27,9,129,210,15,354
4111213,3,0,3,57,18,6,81,153,9,243
4111214,6,3,9,134,47,6,187,274,13,474
4111215,21,0,21,48,23,3,74,219,9,302
4111216,0,0,0,98,32,7,137,162,6,305
4111217,0,0,0,47,7,6,60,68,6,134
4111301,6,0,6,70,19,7,96,175,12,283
4111302,35,0,35,43,27,4,74,248,14,336
4111303,0,0,0,56,19,0,75,148,9,232
4111304,0,0,0,46,15,3,64,123,0,187
4111305,0,0,0,49,19,6,74,172,46,292
4111306,3,0,3,55,11,0,66,196,16,278
4111307,0,0,0,41,17,0,58,186,31,275
4111308,3,0,3,75,32,0,107,180,9,296
4111309,0,0,0,36,3,0,39,123,3,165
4111310,3,0,3,18,8,5,31,120,18,169
4111401,4,0,4,43,14,0,57,146,6,209
4111402,3,0,3,60,17,0,77,164,20,261
4111403,3,0,3,9,14,0,23,118,4,145
4111404,11,0,11,64,17,3,84,197,12,293
4111405,15,0,15,38,17,3,58,220,22,300
4111406,3,0,3,70,35,3,108,193,3,304
4111407,6,0,6,50,39,3,92,242,18,352
4111408,13,0,13,27,28,0,55,138,12,205
4111409,4,0,4,208,67,10,285,398,8,691
4111410,47,3,50,67,24,3,94,301,15,410
4111411,6,3,9,59,30,0,89,216,9,314
4111412,6,3,9,104,37,13,154,242,26,422
4111413,17,5,22,43,24,4,71,220,15,306
4111414,23,11,37,26,29,0,55,183,22,260
4111415,14,0,14,84,21,9,114,206,27,347
4111501,12,4,16,72,35,7,114,201,7,322
4111502,100,7,107,60,19,0,79,382,40,501
4111503,3,4,7,140,47,14,201,350,23,574
4111504,6,6,12,112,42,6,160,351,28,539
4111505,0,0,0,32,13,6,51,105,6,162
4111506,7,0,7,83,42,3,128,207,17,352
4111507,12,10,22,90,31,0,121,225,22,368
4111508,7,3,10,53,22,6,81,246,18,345
4111509,12,0,12,55,16,3,74,169,13,256
4111510,0,3,3,33,23,0,56,128,15,199
4111601,4,0,4,28,23,0,51,138,6,195
4111602,4,0,4,60,16,0,76,196,18,290
4111603,4,3,7,30,15,6,51,104,6,161
4111604,25,0,25,38,23,3,64,169,14,247
4111605,0,3,3,63,28,3,94,165,19,278
4111606,45,5,50,63,43,9,115,369,31,515
4111607,0,0,0,58,22,3,83,141,7,231
4111608,0,0,0,44,5,0,49,124,12,185
4111609,0,0,0,62,23,6,91,175,15,281
4111610,3,3,6,46,30,3,79,163,20,262
4111611,9,0,9,96,46,0,142,334,32,508
4111701,0,0,0,65,15,4,84,205,7,296
4111702,3,0,3,54,6,0,60,77,3,140
4111703,3,0,3,94,37,4,135,206,17,358
4111704,0,0,0,33,13,3,49,107,7,163
4111705,6,3,9,19,20,0,39,84,10,133
4111706,3,0,3,34,12,4,50,104,0,154
4111707,0,0,0,33,25,6,64,129,9,202
4111708,3,3,6,54,37,7,98,182,18,298
4111709,21,3,24,44,24,0,68,203,7,278
4111710,10,0,10,33,17,0,50,155,12,217
4111711,6,15,21,19,10,0,29,132,35,196
4111712,7,0,7,45,21,3,69,225,30,324
4111713,3,0,3,43,21,0,64,244,25,333
4111714,6,0,6,38,12,3,53,124,9,186
4111715,4,0,4,51,20,0,71,150,14,235
4111716,0,0,0,58,12,7,77,233,21,331
4111801,6,0,6,32,13,0,45,195,15,255
4111802,7,0,7,33,24,3,60,129,11,200
4111803,6,3,9,60,19,3,82,206,29,317
4111804,5,0,5,80,27,0,107,230,17,354
4111805,5,0,5,38,15,6,59,205,21,285
4111806,0,0,0,27,12,3,42,74,6,122
4111807,6,0,6,109,29,6,144,206,18,368
4111808,9,6,15,41,30,4,75,208,24,307
4111809,3,3,6,32,7,0,39,127,22,188
4111810,0,0,0,37,18,0,55,129,12,196
4111811,25,4,29,38,23,0,61,188,20,269
4111812,15,3,18,39,24,6,69,172,18,259
4111813,0,0,0,0,0,0,0,0,0,0
4111814,21,3,24,49,22,6,77,201,18,296
4111901,21,0,21,50,23,3,76,237,9,322
4111902,0,0,0,27,7,0,34,113,9,156
4111903,0,0,0,45,22,0,67,101,7,175
4111904,6,3,9,60,22,9,91,168,30,289
4111905,0,0,0,87,19,6,112,205,36,353
4111906,3,0,3,61,30,0,91,178,20,289
4111907,13,0,13,54,27,10,91,210,15,316
4111908,20,3,23,51,25,0,76,257,30,363
4111909,47,0,47,111,27,4,142,359,34,535
4111910,12,3,15,56,31,0,87,293,71,451
4111911,18,3,21,57,28,9,94,203,27,324
4111912,0,0,0,53,19,3,75,149,19,243
4111913,0,0,0,41,25,3,69,129,18,216
4111914,0,0,0,67,25,9,101,151,18,270
4111915,0,3,6,54,24,0,78,119,16,213
4111916,20,0,20,44,28,0,72,208,9,289
4111917,9,3,12,31,21,5,57,155,6,218
4111918,3,3,6,38,18,0,56,199,16,271
4111919,0,0,0,40,0,6,46,92,15,153
4111920,3,0,3,38,6,0,44,62,6,112
4111921,3,3,6,82,23,0,105,230,19,354
4111922,0,0,0,3,6,0,9,97,19,125
4111923,55,6,61,58,27,0,85,408,27,520
4111924,10,0,10,32,28,3,63,259,35,357
4111925,3,0,3,38,24,0,62,108,3,173
4111926,0,0,0,50,18,0,68,111,3,182
4111927,0,0,0,37,9,5,51,122,12,185
4112001,3,0,3,43,28,3,74,156,16,246
4112002,0,0,0,30,19,3,52,81,3,136
4112003,3,0,3,33,12,0,45,98,3,146
4112004,9,0,9,78,19,0,97,140,3,240
4112005,0,0,0,44,13,0,57,87,4,148
4112006,6,0,6,32,17,0,49,121,0,170
4112007,6,3,9,28,16,0,44,189,18,251
4112008,0,0,0,32,13,3,48,115,15,178
4112009,16,0,16,60,34,3,97,209,23,329
4112010,33,3,36,42,21,0,63,185,12,260
4112011,6,0,6,30,6,0,36,106,11,153
4112012,0,0,0,74,37,4,115,361,26,502
4112013,26,3,29,64,29,3,96,307,24,427
4112014,0,0,0,36,3,3,42,131,15,188
4112015,0,0,0,49,15,0,64,125,15,204
4112016,0,0,0,37,18,3,58,71,6,135
4112101,14,6,20,48,23,0,71,182,20,273
4112102,4,0,4,26,9,3,38,129,15,182
4112103,8,3,11,30,19,0,49,151,30,230
4112104,7,0,7,63,27,0,90,257,30,377
4112105,3,3,6,41,16,0,57,129,18,204
4112106,5,0,5,65,28,9,102,245,50,397
4112107,6,0,6,53,18,0,71,171,9,251
4112108,3,3,6,26,12,0,38,135,24,197
4112109,0,0,0,30,13,0,43,183,30,256
4112110,0,0,0,11,22,3,36,159,10,205
4112111,7,3,10,36,23,0,59,197,12,268
4112112,4,0,4,40,20,5,65,185,21,271
4112113,4,6,10,64,20,5,89,210,25,324
4112114,41,5,46,33,29,0,62,184,28,274
4112115,0,0,0,51,9,3,63,140,9,212
4112116,8,3,11,27,6,0,33,132,19,184
4112117,9,3,12,31,13,6,50,174,36,260
4112118,7,3,10,22,12,0,34,128,18,180
4112201,3,0,3,35,23,3,61,143,23,227
4112202,0,0,0,0,0,0,0,0,0,0
4112203,54,6,60,12,4,0,16,196,16,228
4112204,4,0,4,50,30,6,86,160,24,270
4112205,12,6,18,72,33,5,110,288,38,436
4112206,0,0,0,0,3,0,3,3,0,6
4112207,0,0,0,68,29,9,106,190,29,325
4112208,10,0,10,100,35,3,138,248,22,408
4112209,9,3,12,78,39,3,120,224,20,364
4112210,9,0,9,65,8,0,73,164,14,251
4112211,0,0,0,50,18,3,71,174,27,272
4112212,6,0,6,34,14,0,48,152,14,214
4112213,4,0,4,46,14,0,60,91,10,161
4112214,0,0,0,62,33,3,98,160,14,272
4112215,5,0,5,75,29,0,104,249,20,373
4112216,3,3,6,85,34,0,119,216,25,360
4112217,0,0,0,60,10,0,70,144,3,217
4112218,0,0,0,0,0,0,0,0,0,0
4112219,6,0,6,95,38,4,137,254,20,411
4112220,3,0,3,26,16,0,42,102,12,156
4112221,0,5,5,30,5,3,38,126,12,176
4112222,0,0,0,38,24,6,68,176,6,250
4112223,0,0,0,54,15,3,72,158,24,254
4112224,12,3,15,62,26,0,88,282,35,405
4112225,11,4,15,64,18,4,86,201,35,322
4112226,55,0,55,69,24,3,96,308,24,428
4112227,8,3,11,111,39,6,156,338,66,560
4112228,3,3,6,44,23,0,67,133,18,218
4112229,8,0,8,102,32,8,142,274,29,445
4112230,6,3,9,43,10,0,53,155,21,229
4112231,0,0,0,24,24,3,51,140,0,191
4112232,3,3,6,33,22,6,61,157,6,224
4112233,4,0,4,44,28,13,85,268,17,370
4112234,8,0,8,65,22,0,87,215,34,336
4112235,0,0,0,33,8,3,44,139,22,205
4112236,3,0,3,47,22,4,73,181,15,269
4112237,3,0,3,34,7,0,41,116,4,161
4112238,0,0,0,38,12,6,56,129,30,215
4112239,0,3,3,39,17,3,59,113,15,187
4112240,0,0,0,0,0,0,0,0,0,0
4112241,7,0,7,26,31,0,57,144,12,213
4112242,6,0,6,22,12,3,37,109,16,162
4112243,0,4,4,34,21,5,60,130,26,216
4112244,15,0,15,39,16,4,59,166,3,228
4112301,12,0,12,40,18,6,64,196,21,281
4112302,13,5,18,33,22,3,58,172,14,244
4112303,23,6,29,86,33,0,119,382,38,539
4112304,6,0,6,63,22,10,95,187,8,290
4112305,0,0,0,40,13,4,57,104,3,164
4112306,0,0,0,24,13,0,37,112,13,162
4112307,3,3,6,53,20,9,82,176,12,270
4112308,6,0,6,59,19,0,78,143,6,227
4112309,0,0,0,67,36,0,103,161,12,276
4112310,6,0,6,23,19,0,42,99,0,141
4112401,0,0,0,0,0,0,0,0,0,0
4112402,0,0,0,12,3,0,15,47,6,68
4112403,3,0,3,109,31,8,148,247,17,412
4112404,0,0,3,59,26,3,88,113,15,216
4112405,0,0,0,59,28,0,87,176,8,271
4112406,29,8,37,66,29,0,95,322,41,458
4112407,8,3,11,87,38,0,125,187,21,333
4112408,16,0,16,29,24,9,62,181,17,260
4112409,22,5,27,40,29,4,73,207,22,302
4112410,8,0,8,61,34,4,99,248,21,368
4112411,0,3,3,40,25,0,65,201,18,284
4112412,4,0,4,91,25,14,130,187,10,327
4112413,6,0,6,72,25,3,100,219,24,343
4112414,3,0,3,98,32,9,139,232,20,391
4112501,11,3,14,13,21,0,34,153,17,204
4112502,33,6,39,43,21,3,67,399,28,494
4112503,11,0,11,49,18,3,70,207,15,292
4112504,3,0,3,69,41,0,110,244,20,374
4112505,7,0,7,48,19,6,73,128,12,213
4112506,9,0,9,87,52,7,146,389,23,558
4112507,19,0,19,28,24,0,52,219,12,283
4112508,3,0,3,48,13,3,64,217,21,302
4112509,0,0,0,43,20,0,63,212,14,289
4112510,0,0,0,34,10,4,48,133,3,184
4112511,5,3,8,23,15,6,44,179,13,236
4112512,5,3,8,17,12,0,29,112,21,162
4112601,3,3,6,32,14,0,46,134,27,207
4112602,0,0,0,29,21,0,50,197,32,279
4112603,3,0,3,36,37,0,73,261,24,358
4112604,3,0,3,35,31,6,72,214,9,295
4112605,6,0,6,25,11,0,36,185,12,233
4112606,3,0,3,83,20,0,103,292,38,433
4112607,5,4,9,42,26,3,71,227,14,312
4112608,46,0,46,37,19,3,59,245,32,336
4112609,0,6,6,79,31,0,110,262,21,393
4112610,0,0,0,6,6,0,12,18,3,33
4112611,3,6,9,30,25,4,59,174,27,260
4112701,8,0,8,25,6,0,31,142,16,189
4112702,0,0,0,48,0,0,48,160,10,218
4112703,44,0,48,35,20,0,55,241,38,334
4112704,4,5,9,52,21,5,78,197,20,295
4112705,18,3,21,37,26,3,66,348,34,448
4112706,39,0,42,33,24,3,60,251,23,334
4112707,3,0,3,30,20,0,50,230,26,306
4112708,10,0,10,78,52,6,136,367,27,530
4112709,14,3,17,30,20,3,53,190,20,263
4112710,27,0,27,31,17,0,48,192,9,249
4112711,0,3,3,12,18,0,30,141,9,180
4112712,6,3,9,67,35,4,106,250,19,375
4112713,7,0,7,38,13,0,51,246,17,314
4112714,3,0,3,93,14,0,107,179,0,286
4112715,3,0,3,71,20,0,91,135,9,235
4112716,6,0,6,35,8,7,50,197,21,268
4112717,4,0,4,67,21,6,94,252,10,356
4112718,8,0,8,82,52,0,134,273,18,425
4112719,0,0,0,8,21,3,32,136,10,178
4112720,0,0,0,0,4,0,4,54,3,61
4112721,0,0,0,13,3,0,16,57,3,76
4112801,0,0,0,38,6,0,44,135,15,194
4112802,3,0,3,73,32,12,117,257,21,395
4112803,3,3,6,23,15,0,38,123,12,173
4112804,3,6,9,24,16,0,40,172,12,224
4112805,0,3,3,30,18,0,48,127,15,190
4112806,7,3,10,49,23,0,72,167,15,254
4112807,14,0,14,50,13,3,66,224,22,312
4112808,37,0,37,48,37,3,88,366,21,475
4112809,0,0,0,0,0,0,0,0,0,0
4112810,0,0,0,10,3,0,13,88,9,110
4112811,7,6,13,46,11,0,57,333,25,415
4112812,5,0,5,79,44,0,123,374,27,524
4112813,0,0,0,23,8,0,31,107,0,138
4112901,0,0,0,62,20,18,100,146,5,251
4112902,0,3,3,76,34,9,119,229,33,381
4112903,26,6,32,51,13,0,64,273,27,364
4112904,6,0,6,70,56,0,126,310,34,470
4112905,3,0,3,66,29,0,95,243,41,379
4112906,0,0,0,47,23,9,79,143,4,226
4112907,0,0,0,0,0,0,0,0,0,0
4113001,3,3,6,33,14,3,50,164,19,233
4113002,15,0,15,33,15,3,51,110,4,165
4113003,3,0,3,46,28,0,74,140,11,225
4113004,0,0,0,58,18,3,79,79,3,161
4113005,0,0,0,76,13,12,101,105,3,209
4113006,0,3,3,37,21,6,64,94,15,173
4113007,3,0,3,37,12,0,49,109,6,164
4113008,0,0,0,74,23,12,109,253,17,379
4113009,0,5,5,6,10,0,16,104,8,128
4113010,6,0,6,51,19,6,76,166,12,254
4113011,3,0,3,55,29,3,87,215,17,319
4113012,16,3,19,55,45,3,103,249,30,382
4113013,3,0,3,57,25,6,88,160,13,261
4113014,0,0,0,0,0,0,0,0,0,0
4113015,0,0,0,0,0,0,0,0,0,0
4113016,3,7,10,76,30,0,106,222,17,345
4113017,0,0,0,33,8,0,41,99,0,140
4113018,38,5,43,39,19,3,61,202,26,289
4113019,8,3,11,32,26,6,64,178,17,259
4113020,0,0,0,58,22,3,83,179,5,267
4113021,0,0,0,62,31,0,93,129,6,228
4113022,4,0,4,43,28,0,71,228,9,308
4113023,0,0,0,38,22,6,66,112,10,188
4113101,3,0,3,136,12,0,148,191,4,343
4113102,4,0,4,30,9,0,39,134,11,184
4113103,0,0,0,58,15,0,73,114,6,193
4113104,8,6,14,62,35,8,105,258,78,441
4113105,6,3,9,55,38,6,99,214,18,331
4113106,0,0,0,32,15,3,50,127,0,177
4113107,19,11,30,68,44,9,121,293,27,441
4113108,9,0,9,30,17,3,50,128,9,187
4113109,7,10,17,26,17,3,46,170,31,247
4113110,9,3,12,57,25,3,85,216,24,325
4113111,0,0,0,56,12,3,71,111,6,188
4113112,0,0,0,54,5,0,59,168,13,240
4113113,0,0,0,22,12,0,34,64,3,101
4113201,26,8,34,95,43,6,144,272,26,442
4113202,5,0,5,71,16,8,95,166,9,270
4113203,0,0,0,46,18,3,67,192,15,274
4113204,0,0,0,87,23,0,110,204,16,330
4113205,4,0,4,57,12,6,75,141,9,225
4113206,11,0,11,48,18,0,66,171,9,246
4113301,6,3,9,79,32,6,117,180,18,315
4113302,60,6,66,91,22,3,116,255,27,398
4113303,3,0,3,79,28,6,113,163,12,288
4113304,0,0,0,63,32,3,98,247,17,362
4113305,6,0,6,85,34,6,125,244,22,391
4113306,20,5,25,41,18,0,59,175,19,253
4113307,0,0,0,66,36,4,106,209,22,337
4113308,4,3,7,41,12,3,56,183,19,258
4113309,6,0,6,44,22,6,72,138,12,222
4113310,6,0,6,91,26,17,134,252,27,413
4113311,3,0,3,88,62,6,156,215,43,414
4113312,3,4,7,105,48,4,157,311,31,499
4113313,0,0,0,45,21,0,66,139,29,234
4113314,8,7,15,28,10,3,41,186,27,254
4113315,0,0,0,99,24,6,129,246,35,410
4113316,8,3,11,92,38,0,130,225,33,388
4113317,0,0,0,53,36,6,95,213,35,343
4113318,7,3,10,36,18,3,57,143,15,215
4113319,5,4,9,27,22,0,49,186,28,263
4113320,3,0,3,65,25,3,93,174,6,273
4113321,40,16,56,51,20,0,71,183,40,294
4113322,12,4,16,72,24,3,99,198,33,330
4113323,4,0,4,40,18,0,58,131,7,196
4113324,6,3,9,53,26,4,83,185,27,295
4113325,0,0,0,113,32,9,154,172,12,338
4113326,6,0,6,21,12,6,39,98,12,149
4113327,3,0,3,52,5,3,60,141,3,204
4113328,0,0,0,29,16,0,45,125,13,183
4113329,0,0,0,34,19,6,59,117,15,191
4113330,3,6,9,55,19,3,77,157,24,258
4113331,0,0,0,30,10,0,40,75,129,244
4113332,0,3,3,59,29,5,93,162,10,265
4113333,3,0,3,87,31,7,125,213,8,346
4113334,0,0,0,48,28,0,76,129,18,223
4113335,0,0,0,0,0,0,0,0,0,0
4113336,0,0,0,24,12,0,36,71,6,113
4113337,0,0,0,131,35,3,169,188,15,372
4113338,0,0,0,47,28,0,75,179,31,285
4113339,3,0,3,39,25,7,71,118,27,216
4113340,42,3,45,83,21,0,104,301,22,427
4113341,6,6,12,64,25,7,96,186,21,303
4113342,3,0,3,50,28,9,87,228,25,340
4113401,4,0,4,51,15,6,72,177,24,273
4113402,28,3,31,27,15,3,45,205,38,288
4113403,13,0,13,49,21,6,76,155,29,260
4113404,0,0,0,111,25,8,144,299,27,470
4113405,0,3,3,71,19,3,93,255,27,375
4113406,0,0,0,16,21,3,40,126,9,175
4113407,3,0,3,95,19,7,121,243,23,387
4113408,0,0,0,23,12,0,35,46,0,81
4113409,0,0,0,44,11,6,61,158,58,277
4113410,0,0,0,14,18,3,35,53,118,206
4113501,0,0,0,9,15,6,30,27,3,60
4113502,0,0,0,10,0,0,10,21,3,34
4113601,3,0,3,56,22,0,78,194,28,300
4113602,5,0,5,42,24,0,66,133,21,220
4113603,0,0,0,124,42,3,169,314,10,493
4113604,6,0,6,82,46,0,128,276,28,432
4113605,4,0,4,57,10,5,72,164,20,256
4113606,0,0,0,72,31,6,109,212,9,330
4113607,3,0,3,80,16,0,96,217,24,337
4113608,3,0,3,63,42,0,105,251,47,403
4113609,3,3,6,57,23,6,86,187,28,301
4113610,0,0,0,0,0,0,0,3,0,3
4113611,3,3,6,71,16,0,87,121,34,242
4113612,0,0,0,56,33,0,89,241,31,361
4113613,8,0,8,53,39,0,92,259,15,366
4113614,11,0,11,93,41,3,137,322,47,506
4113615,0,0,0,148,28,0,176,163,3,342
4113616,3,0,3,155,59,0,214,459,35,708
4113617,0,0,0,0,0,0,0,0,0,0
4113618,7,0,7,41,27,0,68,155,28,251
4113619,53,6,59,78,22,3,103,305,21,429
4113620,0,0,0,67,35,6,108,179,30,317
4113621,7,6,13,27,9,3,39,169,48,256
4113622,0,0,0,37,18,9,64,118,21,203
4113623,0,0,0,71,18,3,92,208,24,324
4113624,0,0,0,52,18,0,70,178,25,273
4113625,3,0,3,38,12,6,56,178,26,260
4113626,0,0,0,45,25,7,77,201,28,306
4113627,3,3,6,55,40,0,95,199,42,336
4113628,4,0,4,40,15,3,58,206,35,299
4113629,16,6,22,68,23,3,94,198,33,325
4113630,3,0,3,101,23,3,127,283,43,453
4113631,3,0,3,47,31,6,84,187,21,292
4113632,6,0,6,48,35,0,83,207,37,327
4113633,0,3,3,57,12,3,72,139,31,242
4113634,0,0,0,39,20,0,59,189,22,270
4113635,0,3,3,33,16,9,58,123,29,210
4113636,3,0,3,35,9,5,49,151,22,222
4113637,3,3,6,82,29,7,118,233,28,379
4113638,0,0,0,71,34,3,108,270,43,421
4113639,16,0,16,72,32,7,111,205,22,338
4113640,5,0,5,74,30,0,104,149,19,272
4113641,3,4,7,55,19,0,74,205,20,299
4113642,3,3,6,63,24,5,92,186,18,296
4113643,0,0,0,104,38,9,151,291,28,470
4113644,0,0,0,87,31,3,121,232,19,372
4113645,5,0,5,54,19,3,76,191,31,298
4113646,0,3,3,61,23,0,84,156,31,271
4113647,0,0,0,11,0,0,11,26,6,43
4113648,3,0,3,78,43,3,124,227,32,383
4113649,0,0,0,0,0,0,0,11,5,16
4113650,0,0,0,0,0,0,0,0,0,0
4113651,3,0,3,57,8,7,72,171,23,266
4113652,0,0,0,31,24,3,58,137,8,203
4113653,3,3,6,61,34,6,101,167,28,296
4113654,0,0,0,3,0,0,3,3,0,6
4113655,5,0,5,62,24,4,90,158,25,273
4113656,0,0,0,22,13,0,35,109,16,160
4113657,6,0,6,58,22,7,87,188,11,286
4113658,21,3,24,63,22,0,85,220,25,330
4113659,0,4,4,55,16,0,71,208,50,329
4113660,5,0,5,66,26,6,98,228,24,350
4113701,0,0,0,0,0,0,0,0,0,0
4113801,0,0,0,0,15,0,15,38,0,53
4113802,0,0,0,0,0,0,0,0,0,0
4113803,0,0,0,9,9,0,18,47,13,78
4113804,0,0,0,0,0,0,0,7,0,7
4113805,0,0,0,0,0,0,0,0,0,0
4113806,0,0,0,18,9,0,27,42,0,69
4113807,0,0,0,6,30,7,43,48,8,99
4113808,0,0,0,0,0,0,0,0,0,0
4113809,0,0,0,4,6,0,10,51,3,64
4113810,0,0,0,0,0,0,0,15,0,15
4113811,3,0,3,12,18,6,36,50,3,89
4113812,3,0,6,84,35,4,123,203,19,345
4113813,4,0,4,57,105,47,209,143,13,365
4113814,0,0,0,50,3,0,53,87,9,149
4113815,0,0,0,60,46,8,114,92,6,212
4113816,0,0,0,53,44,31,128,80,15,223
4113817,0,0,0,3,20,0,23,4,0,27
4113901,0,0,0,18,10,0,28,145,13,186
4113902,0,0,0,0,0,0,0,21,0,21
4113903,0,0,0,33,10,4,47,138,61,246
4113904,0,0,0,45,15,0,60,182,47,289
4113905,0,0,0,16,7,0,23,115,27,165
4113906,3,0,3,18,9,0,27,54,12,93
4113907,6,0,6,20,9,3,32,154,27,213
4113908,0,0,0,29,3,0,32,150,11,193
4114001,0,0,0,0,0,6,6,35,0,41
4114002,0,0,0,20,3,0,23,28,9,60
4114003,10,0,10,57,24,0,81,148,21,250
4114004,19,0,19,52,25,0,77,238,22,337
4114005,0,0,0,21,19,0,40,166,33,239
4114006,6,0,6,67,30,0,97,246,39,382
4114007,8,3,11,23,13,0,36,170,13,219
4114008,3,0,3,33,6,3,42,140,15,197
4114009,0,0,0,12,6,0,18,102,24,144
4114101,6,3,9,88,24,6,118,270,85,473
4114102,0,0,0,18,6,0,24,61,26,111
4114103,0,0,0,14,0,0,14,30,0,44
4114104,0,0,0,15,0,0,15,46,16,77
4114105,0,0,0,106,32,4,142,241,0,383
4114106,0,0,0,99,16,0,115,409,80,604
4114107,0,0,0,97,19,3,119,395,53,567
4114108,3,0,3,61,31,0,92,264,70,426
4114109,0,0,0,26,12,0,38,98,35,171
4114201,6,5,11,57,29,8,94,203,40,337
4114202,6,3,9,41,26,0,67,173,45,285
4114203,0,0,0,36,19,4,59,226,32,317
4114204,0,0,0,105,37,7,149,233,19,401
4114205,4,0,4,36,21,0,57,92,9,158
4114206,0,0,0,70,29,3,102,146,17,265
4114207,0,0,0,14,0,0,14,59,375,448
4114208,3,3,6,62,25,0,87,158,18,263
4114209,3,3,6,87,45,9,141,271,59,471
4114210,0,0,0,15,3,6,24,51,6,81
4114211,18,0,18,30,16,6,52,161,22,235
4114212,0,0,0,78,43,9,130,207,33,370
4114213,3,0,3,53,21,3,77,167,18,262
4114214,0,3,3,76,48,9,133,263,55,451
4114215,5,0,5,33,23,0,56,188,33,277
4114216,0,0,0,54,19,3,76,156,22,254
4114217,0,0,0,11,0,0,11,24,3,38
4114218,6,0,6,57,30,0,87,208,24,319
4114219,4,0,4,50,30,3,83,178,89,350
4114220,3,0,3,70,41,6,117,251,22,390
4114221,0,0,0,56,21,0,77,130,65,272
4114222,3,0,3,85,44,4,133,265,65,463
4114223,5,0,5,41,11,0,52,165,51,268
4114224,0,0,0,40,22,0,62,127,45,234
4114225,6,40,46,66,29,13,108,234,102,444
4114226,6,6,12,39,28,3,70,187,21,278
4114227,10,0,10,63,36,6,105,213,56,374
4114228,0,0,0,57,29,0,86,221,49,356
4114229,0,0,0,14,13,0,27,101,6,134
4114230,6,3,9,71,19,0,90,199,24,313
4114231,3,3,6,44,24,5,73,209,64,346
4114232,6,3,9,47,21,6,74,228,78,380
4114233,5,0,5,32,9,3,44,117,21,182
4114234,11,4,15,76,51,4,131,315,52,498
4114235,0,0,0,0,0,0,0,3,0,3
4114236,0,0,0,97,29,7,133,192,18,343
4114301,0,0,0,110,15,3,128,237,36,401
4114302,0,0,0,95,16,3,114,234,24,372
4114303,0,0,0,40,11,0,51,175,101,327
4114304,0,0,0,76,9,0,85,147,9,241
4114305,0,0,0,42,6,3,51,117,9,177
4114306,0,0,0,210,35,13,258,320,41,619
4114307,0,0,0,138,16,4,158,218,19,395
4114308,3,0,3,52,9,0,61,197,187,445
4114309,0,0,0,0,0,3,3,8,5,16
4114310,0,0,0,246,25,13,284,316,43,643
4114401,6,0,6,43,15,0,58,132,28,218
4114402,3,3,6,59,10,3,72,148,21,241
4114403,4,4,8,36,30,0,66,207,32,305
4114404,0,0,0,18,5,0,23,85,10,118
4114405,6,0,6,42,37,15,94,254,24,372
4114406,6,0,6,45,17,3,65,165,14,244
4114407,7,0,7,17,18,0,35,116,9,160
4114408,8,0,8,46,26,3,75,255,22,352
4114409,14,3,17,29,34,3,66,289,27,382
4114410,6,0,6,41,24,6,71,129,12,212
4114411,14,0,14,20,14,3,37,229,24,290
4114412,22,10,35,28,24,0,52,247,43,342
4114413,6,0,6,40,34,3,77,165,28,270
4114414,6,0,6,87,29,0,116,246,22,384
4114415,10,0,10,58,42,4,104,266,15,385
4114416,5,6,11,61,35,3,99,271,27,397
4114417,6,3,9,27,16,0,43,161,21,225
4114418,15,0,15,44,37,3,84,321,39,444
4114419,0,0,0,46,26,0,72,155,4,231
4114420,7,0,7,50,15,0,65,144,21,230
4114421,0,0,0,37,24,4,65,159,29,253
4114422,0,0,0,70,44,0,114,233,32,379
4114423,0,0,0,97,55,7,159,380,32,571
4114424,13,5,18,27,44,6,77,394,22,493
4114425,5,0,5,27,18,4,49,114,7,170
4114426,6,3,9,33,19,0,52,175,25,252
4114427,49,5,54,24,20,0,44,264,30,338
4114428,65,4,69,40,34,3,77,342,25,444
4114429,7,0,7,46,19,4,69,186,10,265
4114430,0,0,0,0,3,0,3,0,3,6
4114501,3,0,3,38,13,0,51,101,6,158
4114502,6,4,10,36,18,4,58,160,21,239
4114503,0,3,3,65,23,9,97,184,49,330
4114504,6,0,6,31,13,3,47,137,14,198
4114505,7,3,10,75,30,7,112,240,25,377
4114506,18,9,27,29,26,0,55,175,25,255
4114507,20,0,20,36,18,3,57,186,11,254
4114508,8,0,8,46,19,0,65,164,9,238
4114509,6,0,6,96,23,5,124,230,12,366
4114510,0,0,0,48,12,7,67,121,22,210
4114511,0,0,0,23,9,0,32,69,9,110
4114512,6,3,9,104,43,8,155,264,14,433
4114513,3,3,6,51,18,3,72,178,29,279
4114514,3,0,3,22,12,0,34,136,15,185
4114601,3,0,3,61,29,0,90,153,3,246
4114602,6,0,6,79,18,4,101,162,10,273
4114603,3,0,3,51,22,12,85,144,12,241
4114604,6,3,9,104,27,4,135,357,26,518
4114605,7,0,7,72,37,13,122,236,18,376
4114606,45,5,50,42,20,0,62,231,11,304
4114607,19,0,19,126,58,10,194,369,18,581
4114608,15,3,18,25,22,9,56,182,17,255
4114609,6,0,6,98,39,3,140,272,11,423
4114610,36,3,39,47,37,0,84,240,19,343
4114611,7,0,7,67,49,0,116,266,12,394
4114612,4,0,4,77,45,11,133,286,19,438
4114613,0,0,0,37,32,0,69,131,15,215
4114614,0,0,0,112,49,10,171,298,21,490
4114615,0,0,0,27,13,0,40,118,3,161
4114701,4,0,4,39,15,0,54,193,9,256
4114702,6,0,6,48,28,3,79,179,26,284
4114703,3,0,3,84,25,5,114,191,19,324
4114704,5,0,5,93,43,4,140,223,16,379
4114705,0,3,3,83,38,0,121,210,16,347
4114706,3,0,3,31,10,0,41,102,3,146
4114707,0,0,0,9,12,6,27,77,12,116
4114708,4,0,4,169,60,0,229,275,31,535
4114709,3,0,3,70,30,6,106,202,13,321
4114710,0,0,3,20,18,0,38,167,15,220
4114711,3,0,3,40,14,3,57,140,5,202
4114712,0,0,0,63,25,0,88,200,12,300
4114713,3,0,3,100,22,0,122,231,8,361
4114714,3,0,3,77,22,0,99,219,8,326
4114715,4,0,4,91,42,5,138,292,22,452
4114716,0,0,0,49,14,3,66,146,24,236
4114717,6,0,6,68,33,0,101,177,15,293
4114718,3,0,3,71,18,3,92,139,8,239
4114801,7,0,7,20,36,0,56,117,14,187
4114802,22,0,22,43,31,0,74,296,31,401
4114803,8,3,11,29,25,3,57,216,16,289
4114804,81,9,90,35,19,3,57,412,51,520
4114805,15,4,19,57,38,6,101,290,31,422
4114806,6,3,9,62,42,6,110,222,24,356
4114807,19,6,25,36,28,3,67,256,52,375
4114808,18,6,24,48,35,0,83,263,35,381
4114809,7,3,10,27,21,5,53,172,32,257
4114810,10,3,13,58,41,0,99,307,26,432
4114811,0,0,0,51,12,0,63,195,27,285
4114812,10,4,14,42,34,0,76,131,54,261
4114813,21,17,38,39,48,6,93,361,141,595
4114814,41,3,44,44,28,6,78,350,79,507
4114815,13,0,13,54,31,3,88,257,24,369
4114816,11,10,21,53,52,6,111,357,30,498
4114817,8,0,8,69,41,0,110,171,9,290
4114818,0,3,3,67,24,7,98,218,40,356
4114819,18,0,18,65,45,0,110,451,57,618
4114820,3,0,3,33,16,0,49,138,7,194
4114821,7,0,7,95,42,3,140,381,27,548
4114822,20,7,27,35,56,4,95,424,60,579
4114823,52,28,80,25,21,0,46,373,65,484
4114824,6,3,9,90,35,4,129,266,37,432
4114825,4,0,4,55,13,9,77,169,15,261
4114826,6,0,6,52,29,11,92,200,12,304
4114827,58,7,65,15,15,0,30,324,32,386
4114828,6,3,9,52,34,4,90,274,23,387
4114829,55,11,66,0,13,0,13,411,49,473
4114830,7,3,10,34,7,3,44,164,12,220
4114901,6,3,9,46,34,3,83,165,12,260
4114902,0,0,0,22,15,3,40,125,15,180
4114903,3,0,3,53,23,6,82,145,20,247
4114904,0,0,0,39,35,9,83,208,19,310
4114905,6,3,9,22,24,3,49,203,6,258
4114906,10,5,15,58,35,0,93,261,17,371
4114907,8,3,11,26,35,6,67,242,23,332
4114908,6,0,6,82,39,0,121,331,21,473
4114909,7,6,13,15,20,6,41,176,18,235
4114910,42,8,50,68,24,3,95,285,21,401
4114911,3,0,3,90,32,0,122,193,18,333
4114912,5,0,5,62,45,0,107,285,33,425
4114913,0,0,0,42,13,0,55,111,4,170
4114914,0,4,4,42,22,0,64,158,15,237
4115001,0,0,0,33,12,6,51,164,28,243
4115002,3,5,8,45,26,0,71,219,34,324
4115003,0,0,0,65,24,0,89,97,6,192
4115004,6,0,6,90,33,0,123,163,3,289
4115005,6,3,9,49,18,0,67,164,16,247
4115006,0,0,0,68,24,0,92,141,11,244
4115007,0,0,0,53,21,3,77,190,33,300
4115008,3,0,3,42,21,0,63,111,15,189
4115009,0,0,0,89,29,0,118,223,188,529
4115010,0,0,0,68,29,3,100,165,10,275
4115011,0,0,0,89,25,0,114,114,11,239
4115012,0,6,6,48,13,0,61,111,18,190
4115013,0,0,0,12,0,0,12,21,3,36
4115014,0,23,23,84,22,7,113,185,56,354
4115015,0,0,0,25,14,0,39,90,14,143
4115016,0,0,0,16,16,0,32,121,15,168
4115017,3,0,3,50,12,3,65,69,3,137
4115018,0,0,0,58,13,0,71,138,3,212
4115101,25,0,25,55,19,0,74,236,16,326
4115102,0,0,0,59,22,5,86,192,16,294
4115103,0,0,0,10,13,3,26,126,17,169
4115104,6,3,9,51,15,3,69,195,23,287
4115105,3,0,3,40,6,0,46,111,12,169
4115106,13,0,13,40,17,0,57,188,13,258
4115107,3,0,3,28,15,6,49,110,6,165
4115108,0,0,0,58,13,0,71,146,7,224
4115109,8,0,8,67,25,0,92,209,22,323
4115110,0,0,0,9,3,0,12,50,9,71
4115111,0,0,0,12,12,0,24,82,3,109
4115112,6,0,9,65,29,12,106,225,29,360
4115113,0,0,0,44,17,0,61,116,29,206
4115114,7,0,7,12,13,6,31,93,10,134
4115201,3,3,6,39,10,0,49,131,14,194
4115202,7,0,7,42,29,4,75,216,11,302
4115203,8,0,8,52,14,3,69,139,12,220
4115204,33,0,33,36,12,0,48,161,20,229
4115205,49,8,57,22,15,6,43,221,20,284
4115206,6,0,6,40,18,3,61,144,16,221
4115207,5,0,5,20,10,6,36,97,3,136
4115208,6,3,9,85,23,7,115,284,39,438
4115209,0,0,0,58,17,0,75,157,26,258
4115210,0,0,0,98,28,3,129,206,25,360
4115211,7,0,7,44,16,0,60,135,7,202
4115212,3,0,3,42,21,3,66,142,0,208
4115213,3,0,3,87,26,9,122,218,6,346
4115214,0,0,0,58,15,3,76,172,6,254
4115215,10,6,16,54,27,4,85,196,20,301
4115216,5,0,5,60,27,0,87,187,14,288
4115301,0,0,0,32,20,6,58,117,39,214
4115302,0,0,0,43,26,0,69,184,25,278
4115303,0,0,0,14,0,0,14,7,0,21
4115304,39,13,52,72,50,13,135,441,72,648
4115305,0,0,0,45,16,9,70,128,9,207
4115306,3,0,3,81,40,10,131,220,20,371
4115307,0,0,0,39,14,3,56,141,14,211
4115308,4,3,7,59,34,0,93,176,23,292
4115309,3,0,6,60,29,4,93,148,17,258
4115310,22,4,26,60,34,3,97,330,28,455
4115311,3,0,3,80,44,3,127,159,3,289
4115312,0,0,0,156,19,9,184,165,9,358
4115313,3,0,3,74,36,6,116,213,16,345
4115314,3,0,3,97,31,8,136,163,9,308
4115315,3,0,3,94,32,9,135,228,17,380
4115316,4,0,4,90,47,0,137,262,32,431
4115317,0,0,0,76,51,3,130,258,25,413
4115318,12,0,12,98,44,8,150,392,34,576
4115319,5,4,9,107,54,0,161,289,19,469
4115320,3,0,3,75,27,12,114,192,13,319
4115321,4,0,4,58,43,0,101,150,7,258
4115322,4,0,4,40,27,9,76,182,8,266
4115323,13,0,13,91,49,6,146,261,33,440
4115324,8,3,11,75,46,0,121,307,27,455
4115325,10,0,10,82,40,3,125,271,17,413
4115326,0,0,0,85,31,0,116,206,24,346
4115327,6,0,6,82,46,3,131,207,20,358
4115328,0,6,6,82,25,8,115,270,31,416
4115329,3,0,3,58,26,6,90,237,27,354
4115330,9,5,14,86,31,6,123,274,33,430
4115331,3,3,6,94,43,7,144,255,33,432
4115332,48,7,55,23,15,0,38,197,23,258
4115333,13,3,16,66,42,9,117,337,21,475
4115334,11,3,14,60,39,0,99,244,12,355
4115335,3,0,3,155,53,12,220,276,4,500
4115336,5,0,5,85,33,4,122,183,14,319
4115337,0,0,0,56,26,4,86,148,6,240
4115338,9,0,9,44,20,9,73,167,6,246
4115339,3,6,9,123,51,7,181,271,21,473
4115340,8,0,8,79,31,3,113,264,20,397
4115341,6,0,6,79,40,3,122,259,20,401
4115342,39,4,43,57,20,3,80,159,25,264
4115343,6,0,6,87,16,6,109,200,16,325
4115344,6,0,6,61,43,4,108,223,12,343
4115345,0,0,0,68,49,5,122,257,6,385
4115346,0,0,0,33,21,3,57,132,18,207
4115347,56,11,67,32,12,0,44,206,38,288
4115348,3,6,9,94,39,9,142,214,24,380
4115349,0,0,0,55,26,0,81,157,21,259
4115350,3,0,3,26,25,3,54,118,8,180
4115351,4,0,4,58,13,4,75,121,4,200
4115352,7,0,7,89,47,6,142,299,22,463
4115353,6,3,9,87,51,4,142,243,21,406
4115354,3,3,6,53,19,0,72,110,6,188
4115355,13,0,13,84,40,3,127,303,16,446
4115356,12,3,15,66,21,5,92,219,19,330
4115357,12,0,12,37,13,0,50,163,11,224
4115358,7,4,11,65,27,14,106,325,34,465
4115359,3,0,3,45,24,0,69,108,15,192
4115360,0,0,0,75,31,0,106,194,15,315
4115361,0,0,0,86,23,3,112,100,0,212
4115362,0,0,0,120,32,3,155,146,9,310
4115363,0,0,0,85,18,0,103,95,0,198
4115364,0,0,0,54,23,4,81,146,9,236
4115365,0,0,0,42,26,7,75,136,15,226
4115366,8,0,8,37,28,0,65,147,10,222
4115401,4,4,8,50,26,3,79,174,14,267
4115402,4,0,4,75,21,5,101,204,34,339
4115403,6,0,6,41,18,6,65,122,11,198
4115404,3,3,6,63,35,0,98,244,26,368
4115405,0,0,0,0,0,0,0,0,0,0
4115406,0,0,0,0,0,0,0,0,0,0
4115407,51,6,57,47,19,0,66,253,18,337
4115408,11,4,15,49,22,6,77,171,22,270
4115409,5,0,5,55,30,7,92,180,19,291
4115410,7,0,7,26,11,3,40,161,22,223
4115411,27,6,33,47,19,3,69,147,21,237
4115412,0,0,0,95,35,6,136,243,14,393
4115413,6,3,9,52,37,0,89,209,19,317
4115414,9,3,12,57,29,0,86,195,23,304
4115415,4,0,4,62,6,0,68,171,20,259
4115416,5,0,5,55,12,3,70,144,12,226
4115417,3,3,6,52,18,3,73,173,12,258
4115418,7,0,7,69,28,0,97,201,32,330
4115501,0,0,0,135,35,6,176,309,22,507
4115502,0,0,0,82,35,0,117,160,18,295
4115503,5,0,5,69,22,0,91,171,12,274
4115504,0,0,0,58,17,3,78,106,0,184
4115505,6,3,13,34,14,0,48,140,18,206
4115506,0,0,0,102,28,3,133,251,27,411
4115601,0,3,3,43,3,0,46,144,25,215
4115602,0,0,3,71,33,7,111,264,34,409
4115603,17,0,20,48,12,3,63,165,18,246
4115604,0,0,0,76,21,3,100,171,18,289
4115605,3,0,3,54,21,3,78,132,12,222
4115606,4,19,23,57,22,4,83,188,56,327
4115607,0,3,3,67,14,0,81,167,18,266
4115608,0,0,0,72,24,3,99,182,10,291
4115609,0,0,0,45,10,0,55,131,15,201
4115701,0,0,0,21,9,0,30,70,6,106
4115702,38,0,38,67,15,0,82,231,4,317
4115703,3,0,3,59,15,0,74,124,9,207
4115704,0,0,0,138,24,6,168,230,13,411
4115705,3,0,3,45,6,4,55,91,4,150
4115706,8,0,8,55,26,0,81,180,9,270
4115707,0,0,0,50,15,7,72,111,3,186
4115708,31,0,31,26,15,0,41,156,7,204
4115709,0,0,0,40,14,4,58,123,12,193
4115710,0,0,0,55,8,0,63,122,18,203
4115711,0,0,0,48,18,0,66,133,3,202
4115712,0,0,0,45,19,9,73,136,11,220
4115713,4,3,7,56,25,0,81,182,30,293
4115714,6,0,6,51,27,0,78,156,15,249
4115715,3,0,3,58,15,7,80,131,9,220
4115716,33,0,33,76,14,0,90,281,8,379
4115717,3,0,3,25,9,3,37,86,5,128
4115718,7,0,7,56,16,3,75,194,20,289
4115719,4,0,4,76,32,6,114,234,15,363
4115720,7,0,7,57,13,3,73,224,5,302
4115721,6,3,9,43,22,0,65,173,24,262
4115801,0,3,3,108,43,9,160,360,21,541
4115802,3,0,3,39,14,0,53,96,3,152
4115803,3,0,3,58,33,0,91,178,18,287
4115804,7,3,10,37,31,6,74,240,16,330
4115805,3,0,3,29,15,3,47,159,8,214
4115806,0,0,0,44,9,0,53,145,10,208
4115807,0,0,0,55,22,0,77,117,9,203
4115808,0,0,0,48,29,0,77,186,10,273
4115809,3,3,6,90,21,7,118,252,21,391
4115901,3,0,3,22,9,0,31,84,3,118
4115902,0,0,0,14,3,0,17,41,0,58
4115903,0,0,0,0,0,0,0,0,0,0
4115904,0,0,0,27,14,0,41,99,6,146
4115905,0,0,0,22,9,3,34,88,0,122
4115906,0,0,0,30,3,0,33,67,12,112
4115907,7,7,14,32,8,0,40,208,35,283
4115908,9,0,9,30,15,0,45,163,28,236
4115909,29,3,32,36,24,3,63,271,52,386
4115910,43,0,43,52,21,7,80,235,22,337
4115911,3,6,9,64,23,0,87,201,39,327
4115912,4,0,4,43,12,0,55,128,4,187
4115913,4,3,7,42,26,0,68,180,16,264
4115914,3,3,6,30,25,3,58,117,9,184
4115915,0,0,0,30,22,6,58,108,10,176
4115916,3,0,3,56,21,6,83,147,18,248
4115917,0,0,0,83,24,5,112,180,34,326
4115918,0,0,0,38,19,0,57,82,12,151
4115919,0,0,0,0,0,0,0,9,0,9
4115920,6,0,6,50,36,0,86,165,17,268
4115921,3,0,3,43,20,0,63,120,25,208
4115922,7,0,7,75,26,0,101,217,22,340
4115923,4,0,4,40,12,3,55,155,5,215
4115924,3,0,3,82,18,6,106,207,25,338
4115925,3,0,3,36,12,3,51,158,9,218
4116001,3,3,6,68,22,3,93,207,38,338
4116002,3,0,3,62,24,4,90,222,48,360
4116003,0,0,0,74,16,3,93,184,27,304
4116004,18,7,25,15,9,0,24,236,38,298
4116005,4,0,4,52,29,0,81,238,37,356
4116006,3,0,3,69,32,7,108,241,30,379
4116007,3,0,3,106,37,0,143,248,14,405
4116008,0,39,44,54,22,0,76,157,71,304
4116009,7,4,11,39,20,0,59,131,9,199
4116010,3,0,3,58,24,4,86,210,19,315
4116101,0,3,3,33,12,3,48,115,16,179
4116102,23,3,26,75,28,12,115,303,26,444
4116103,0,0,0,37,19,6,62,123,12,197
4116104,9,0,9,48,11,0,59,140,7,206
4116105,25,4,29,41,27,3,71,206,18,295
4116106,17,3,20,48,13,0,61,193,15,269
4116107,0,0,0,28,13,4,45,130,21,196
4116108,0,0,0,27,9,0,36,77,18,131
4116109,0,0,0,70,16,4,90,144,4,238
4116110,0,0,0,68,24,3,95,206,18,319
4116111,0,0,0,0,0,0,0,0,0,0
4116201,0,0,0,24,4,0,28,70,8,106
4116202,35,3,38,27,22,6,55,204,9,268
4116203,0,0,0,27,18,0,45,92,9,146
4116204,9,0,9,155,61,11,227,405,34,666
4116205,3,0,3,89,29,3,121,285,28,434
4116206,0,3,3,50,12,3,65,195,22,282
4116207,53,8,61,58,37,0,95,385,35,515
4116208,11,3,14,43,44,7,94,201,31,326
4116209,9,0,9,77,30,3,110,219,23,352
4116210,8,3,11,71,31,9,111,283,16,410
4116211,7,3,10,64,33,5,102,186,25,313
4116212,8,9,17,61,32,7,100,165,21,286
4116213,19,3,22,11,23,4,38,128,15,181
4116301,0,0,0,19,0,0,19,62,12,93
4116302,0,3,3,31,9,0,40,105,18,163
4116303,6,0,6,88,41,3,132,354,34,520
4116304,6,0,6,16,0,4,20,75,6,101
4116305,0,0,0,22,9,0,31,57,0,88
4116306,4,0,4,41,12,0,53,148,17,218
4116307,0,0,0,11,9,0,20,27,0,47
4116308,0,0,0,35,11,0,46,70,12,128
4116309,0,0,0,8,3,0,11,24,3,38
4116401,3,0,3,31,16,9,56,168,19,243
4116402,8,0,8,33,28,0,61,183,18,262
4116403,6,0,6,68,49,4,121,245,28,394
4116404,0,0,0,88,37,6,131,327,45,503
4116405,8,0,8,33,24,3,60,220,15,295
4116406,6,0,6,20,14,6,40,138,12,190
4116407,3,0,3,94,36,6,136,276,24,436
4116408,3,0,3,63,24,3,90,261,36,387
4116409,35,10,45,45,19,6,70,257,43,370
4116410,3,3,6,30,28,9,67,268,30,365
4116411,6,0,6,28,13,0,41,187,14,242
4116412,0,0,0,16,6,0,22,141,30,193
4116413,3,0,3,104,43,11,158,279,42,479
4116414,3,0,3,9,0,0,9,183,20,212
4116415,0,0,0,14,3,0,17,33,9,59
4116416,0,3,3,39,22,3,64,182,39,285
4116501,25,4,29,84,27,0,111,371,77,559
4116502,6,3,9,36,18,3,57,158,21,236
4116503,9,3,12,65,23,0,88,228,24,340
4116504,3,0,3,35,12,3,50,160,19,229
4116505,3,3,6,76,34,6,116,244,15,375
4116506,4,0,4,102,57,7,166,283,26,475
4116507,0,0,0,58,25,0,83,155,13,251
4116508,5,0,5,32,4,8,44,131,12,187
4116509,15,3,18,49,40,3,92,279,28,399
4116510,0,6,6,63,39,5,107,283,21,411
4116511,0,0,0,35,9,6,50,110,48,208
4116512,7,4,11,41,13,0,54,164,21,239
4116513,3,6,9,80,34,5,119,264,34,417
4116514,39,6,45,62,19,0,81,327,33,441
4116515,0,6,6,49,20,9,78,241,54,373
4116516,8,0,8,53,37,4,94,211,21,326
4116517,0,0,0,68,22,0,90,144,24,258
4116518,6,0,6,48,22,0,70,192,12,274
4116519,14,3,17,84,33,9,126,340,44,510
4116520,3,0,6,59,27,11,97,214,7,318
4116521,6,0,6,75,28,0,103,236,16,355
4116522,3,3,6,55,26,9,90,199,54,343
4116523,6,0,6,60,30,3,93,213,23,329
4116524,0,0,0,41,25,4,70,197,47,314
4116525,0,0,0,0,0,0,0,0,0,0
4116526,16,7,23,55,13,3,71,231,45,347
4116527,3,0,3,83,25,4,112,164,15,291
4116528,8,0,8,47,15,3,65,142,19,226
4116529,10,3,13,58,24,3,85,290,30,405
4116530,8,0,8,65,47,7,119,302,25,446
4116531,6,0,6,78,26,9,113,307,35,455
4116532,6,0,6,45,21,6,72,285,29,386
4116533,9,0,9,68,29,0,97,250,30,377
4116534,0,0,0,28,18,3,49,110,25,184
4116535,5,0,5,52,6,0,58,118,9,185
4116536,4,3,7,68,35,3,106,184,16,306
4116537,0,0,0,0,0,0,0,0,323,323
4116538,23,3,26,92,30,3,125,282,34,441
4116539,11,3,14,90,43,3,136,339,35,510
4116540,45,12,57,18,5,0,23,172,47,242
4116541,5,0,5,52,14,3,69,170,12,251
4116601,0,0,0,12,17,0,29,102,10,141
4116602,0,3,3,81,32,5,118,324,26,468
4116603,0,0,0,6,15,0,21,23,0,44
4116604,4,0,4,36,22,0,58,155,15,228
4116605,0,0,0,102,39,6,147,242,25,414
4116606,7,0,7,125,58,0,183,335,25,543
4116607,0,0,0,64,25,0,89,160,33,282
4116608,3,0,3,72,29,9,110,243,22,375
4116609,0,0,0,48,5,5,58,84,3,145
4116610,3,0,3,6,4,0,10,48,0,58
4116701,0,3,3,40,18,6,64,187,27,278
4116702,6,0,6,59,20,0,79,224,50,353
4116703,14,5,19,51,13,0,64,205,24,293
4116704,6,6,12,32,0,3,35,110,23,168
4116705,24,0,24,27,6,3,36,172,5,213
4116706,3,0,3,23,3,0,26,80,3,109
4116707,6,0,6,44,28,3,75,192,36,303
4116708,6,3,9,34,20,0,54,152,16,222
4116709,0,0,0,88,18,9,115,232,66,413
4116710,13,7,20,65,38,4,107,347,59,513
4116711,0,0,0,0,0,0,0,0,0,0
4116712,5,3,8,47,23,3,73,204,9,286
4116713,9,40,49,51,19,0,70,253,128,451
4116801,7,0,7,61,38,3,102,217,28,347
4116802,0,0,0,65,15,9,89,173,8,270
4116803,0,0,3,27,18,3,48,164,9,221
4116804,0,0,0,27,10,0,37,100,10,147
4116805,0,6,6,42,18,0,60,185,30,275
4116806,4,3,7,103,36,6,145,293,36,474
4116807,0,0,0,3,0,0,3,0,3,6
4116808,0,0,0,43,24,0,67,172,15,254
4116809,3,0,3,55,25,0,80,163,15,258
4116810,0,0,0,115,31,0,146,329,25,500
4116811,3,0,3,100,52,4,156,322,33,511
4116812,0,0,0,61,21,0,82,192,15,289
4116813,0,0,0,78,16,5,99,208,28,335
4116901,0,0,0,12,17,3,32,79,3,114
4116902,23,3,26,38,23,0,61,245,67,373
4116903,6,0,6,51,13,3,67,130,3,200
4116904,0,0,0,34,15,0,49,118,15,182
4116905,4,7,11,51,19,0,70,181,24,275
4116906,9,0,9,47,20,0,67,159,14,240
4116907,0,3,3,45,9,0,54,132,22,208
4116908,9,3,12,25,19,0,44,137,24,205
4116909,3,0,3,46,9,0,55,107,6,168
4116910,8,0,8,136,43,0,179,249,22,450
4116911,0,0,0,17,18,0,35,30,0,65
4116912,0,3,3,48,19,0,67,146,33,246
4116913,0,0,0,62,20,0,82,157,15,254
4116914,14,6,20,55,40,4,99,222,84,405
4116915,8,0,8,45,12,4,61,149,20,230
4116916,4,0,4,40,27,0,67,162,18,247
4116917,3,0,3,65,27,6,98,200,24,322
4116918,0,0,0,67,25,6,98,183,24,305
4117001,3,3,6,15,18,6,39,126,24,189
4117002,0,0,0,29,23,0,52,143,197,392
4117003,3,0,3,71,22,3,96,245,12,353
4117004,0,0,0,64,20,3,87,227,17,331
4117005,3,3,6,65,28,3,96,357,38,491
4117006,0,0,0,44,20,3,67,160,18,245
4117007,3,0,3,54,12,0,66,138,15,219
4117008,3,0,3,65,17,6,88,193,13,294
4117009,0,3,3,69,14,0,83,144,15,242
4117010,0,0,3,69,21,6,96,183,21,300
4117011,0,0,0,72,31,3,106,177,22,305
4117012,3,0,3,41,9,0,50,140,17,207
4117013,10,0,10,37,17,0,54,215,19,288
4117014,6,0,9,71,22,12,105,239,12,356
4117015,21,0,21,45,28,4,77,181,18,276
4117016,3,0,7,36,9,0,45,135,15,195
4117017,8,0,8,20,18,0,38,166,10,214
4117018,59,6,65,31,9,3,43,243,28,314
4949999,59,11,76,297,154,9,460,1845,461,2766
4979991,0,0,0,0,0,0,0,0,0,0
4979992,0,0,0,0,0,0,0,0,0,0
4979993,0,0,0,0,0,0,0,6,0,6
5100101,6,3,9,50,21,3,74,168,33,275
5100102,3,0,3,87,8,3,98,112,26,236
5100103,32,8,40,44,29,5,78,298,27,403
5100104,19,5,24,33,25,0,58,219,29,306
5100105,7,3,10,23,13,4,40,152,13,205
5100106,0,0,0,0,0,0,0,0,0,0
5100107,6,3,9,42,25,4,71,209,27,307
5100108,0,0,0,0,0,0,0,6,3,9
5100109,6,0,6,51,28,3,82,225,42,349
5100110,4,0,4,28,16,3,47,153,13,213
5100111,0,3,3,46,18,6,70,169,46,285
5100112,0,0,0,73,15,4,92,144,26,262
5100113,0,0,0,47,15,0,62,146,16,224
5100114,0,0,0,126,21,9,156,157,15,328
5100115,3,0,3,54,13,0,67,190,16,273
5100116,0,0,0,0,0,0,0,0,0,0
5100201,0,0,0,20,12,6,38,87,0,125
5100202,13,4,17,19,19,0,38,229,15,282
5100203,4,0,4,78,27,3,108,128,6,242
5100204,3,3,6,74,33,3,110,202,39,351
5100205,0,0,0,65,18,4,87,187,10,284
5100206,14,6,20,53,24,3,80,246,45,371
5100207,6,3,9,32,17,0,49,150,30,229
5100208,53,3,56,152,32,6,190,369,32,591
5100209,19,0,19,47,27,6,80,262,45,387
5100210,28,7,35,72,39,0,111,409,56,576
5100211,17,10,27,85,24,0,109,371,40,520
5100212,3,0,3,288,68,17,373,437,41,851
5100213,8,4,12,56,11,0,67,180,36,283
5100214,0,0,0,127,25,4,156,173,26,355
5100215,11,6,17,110,33,3,146,381,53,580
5100216,7,0,7,70,28,0,98,238,25,361
5100217,6,0,6,37,20,0,57,183,11,251
5100218,0,0,0,40,12,0,52,131,19,202
5100219,7,6,13,60,22,3,85,259,24,368
5100220,17,0,20,44,23,0,67,282,37,386
5100221,4,3,7,122,42,0,164,309,50,523
5100222,0,0,0,63,26,4,93,200,8,301
5100223,0,0,0,46,18,3,67,177,19,263
5100224,3,0,3,63,17,0,80,175,14,269
5100225,3,0,3,203,35,7,245,360,33,638
5100226,6,0,6,64,15,0,79,191,23,293
5100227,0,0,0,6,0,0,6,6,0,12
5100228,9,3,12,119,34,3,156,326,35,517
5100229,0,0,0,88,11,0,99,167,23,289
5100230,100,4,104,21,11,0,32,265,19,316
5100231,0,0,0,110,19,4,133,161,7,301
5100232,0,0,0,50,9,0,59,106,6,171
5100233,8,0,8,57,20,0,77,221,14,312
5100234,9,0,9,34,27,3,64,152,21,237
5100235,6,3,9,86,43,0,129,257,41,427
5100236,0,4,4,96,35,7,138,193,36,367
5100237,7,0,7,47,28,3,78,212,26,316
5100238,11,3,14,68,24,0,92,171,20,283
5100239,8,0,8,25,21,0,46,108,10,164
5100240,0,0,0,53,11,3,67,160,17,244
5100241,6,0,6,82,24,0,106,168,17,291
5100242,4,3,7,74,30,6,110,278,45,433
5100243,0,3,3,101,24,7,132,186,23,341
5100244,3,0,3,109,27,9,145,177,16,338
5100245,3,0,3,160,38,14,212,237,35,484
5100246,0,0,0,38,9,0,47,134,0,181
5100247,5,0,5,39,28,3,70,244,15,329
5100248,0,0,0,67,28,3,98,231,28,357
5100249,14,0,14,29,12,0,41,131,16,188
5100250,4,3,7,50,16,0,66,151,17,234
5100251,7,0,7,36,15,6,57,131,21,209
5100301,0,0,0,29,12,3,44,103,8,155
5100302,0,5,5,55,11,5,71,108,9,188
5100303,0,0,0,39,18,3,60,152,18,230
5100304,3,0,3,49,24,3,76,104,19,199
5100305,3,0,3,44,15,4,63,156,8,227
5100306,0,0,0,64,27,3,94,179,21,294
5100307,0,0,0,65,20,0,85,112,16,213
5100308,0,0,0,66,15,0,81,137,9,227
5100309,0,0,0,171,38,6,215,284,34,533
5100310,6,0,6,44,23,3,70,172,9,251
5100311,3,0,3,48,13,0,61,104,12,177
5100312,9,0,9,65,24,0,89,178,16,283
5100313,5,0,5,29,12,9,50,128,22,200
5100314,0,0,0,47,16,4,67,114,14,195
5100315,0,0,0,79,27,6,112,187,23,322
5100316,0,3,3,53,28,12,93,123,12,228
5100317,0,0,0,83,13,4,100,139,4,243
5100318,0,0,0,46,13,8,67,201,18,286
5100319,9,0,9,46,33,3,82,169,21,272
5100320,7,0,7,113,34,12,159,240,16,415
5100321,0,0,0,95,11,9,115,123,19,257
5100322,6,0,6,11,24,0,35,65,12,112
5100323,3,0,3,53,15,0,68,117,9,194
5100324,0,0,0,61,21,5,87,145,18,250
5100325,0,0,0,107,24,0,131,192,10,333
5100326,0,0,0,63,11,4,78,122,19,219
5100401,0,3,3,95,17,11,123,192,38,353
5100402,0,0,0,151,31,6,188,209,45,442
5100403,3,0,3,133,34,17,184,239,39,462
5100404,0,0,0,143,34,5,182,244,31,457
5100405,0,0,0,88,11,8,107,138,16,261
5100406,6,7,13,78,32,3,113,192,57,362
5100407,37,5,42,35,14,7,56,202,52,310
5100408,3,0,3,44,18,9,71,126,18,215
5100409,0,0,0,121,18,6,145,158,14,317
5100410,0,0,0,93,9,10,112,130,3,245
5100411,8,0,8,32,9,0,41,136,15,192
5100412,4,0,4,57,7,0,64,207,16,287
5100413,3,3,6,91,24,12,127,219,50,396
5100414,0,0,0,75,25,0,100,196,27,323
5100415,4,0,4,41,4,4,49,90,24,163
5100416,0,0,0,91,24,6,121,207,37,365
5100417,0,0,0,62,19,9,90,217,22,329
5100418,3,0,3,30,10,0,40,81,19,140
5100501,0,0,0,158,33,7,198,231,10,439
5100502,0,0,0,77,18,3,98,71,28,197
5100503,0,0,0,205,35,14,254,262,38,554
5100504,6,0,6,30,25,3,58,133,17,208
5100505,0,0,0,0,0,0,0,0,0,0
5100506,0,0,0,11,3,0,14,50,8,72
5100507,0,0,0,0,0,0,0,0,0,0
5100508,11,6,17,48,19,3,70,204,27,301
5100509,0,0,0,154,40,4,198,223,31,452
5100510,0,0,0,128,12,9,149,146,18,313
5100511,4,0,4,51,22,3,76,152,19,247
5100512,0,3,3,41,8,4,53,119,9,181
5100513,0,0,0,75,28,3,106,178,12,296
5100514,0,0,0,119,20,7,146,126,40,312
5100515,0,0,0,0,0,0,0,0,0,0
5100516,0,0,0,43,27,4,74,154,15,243
5100517,16,7,23,25,27,0,52,159,34,245
5100518,7,0,7,85,39,6,130,309,21,460
5100519,3,0,3,118,28,6,152,264,17,433
5100520,0,0,0,57,21,0,78,152,14,244
5100521,3,0,3,70,25,7,102,203,17,322
5100522,4,0,4,56,23,5,84,142,25,251
5100523,0,0,0,80,11,3,94,167,21,282
5100524,0,0,0,79,23,0,102,144,39,285
5100525,0,0,0,51,15,0,66,157,21,244
5100526,3,0,3,40,5,6,51,119,19,189
5100527,3,3,6,63,22,6,91,182,10,283
5100528,8,4,12,29,24,0,53,142,7,202
5100529,0,0,0,50,24,4,78,160,9,247
5100530,3,3,6,110,47,6,163,259,24,446
5100531,3,0,3,82,16,3,101,204,21,326
5100532,0,0,0,38,34,3,75,248,34,357
5100533,0,0,0,123,11,4,138,139,12,289
5100534,3,0,3,133,25,9,167,196,27,390
5100535,0,0,0,170,21,11,202,216,14,432
5100536,0,0,0,68,9,6,83,120,20,223
5100537,0,0,0,39,30,0,69,172,15,256
5100538,3,0,3,58,23,5,86,212,15,313
5100539,0,0,0,50,14,4,68,143,11,222
5100540,0,0,0,88,27,0,115,212,18,345
5100541,0,0,0,14,5,0,19,37,0,56
5100542,0,0,0,29,3,5,37,39,3,79
5100601,0,0,0,71,16,10,97,119,30,246
5100602,0,0,0,62,20,4,86,184,35,305
5100603,6,0,6,55,27,3,85,171,18,274
5100604,0,0,0,53,6,9,68,117,4,189
5100605,0,0,0,53,21,0,74,173,40,287
5100606,0,3,3,37,20,4,61,130,20,211
5100607,0,0,0,110,41,11,162,255,37,454
5100608,3,0,3,46,17,3,66,201,13,280
5100609,3,0,3,50,29,3,82,239,26,347
5100610,3,8,11,102,37,6,145,304,38,487
5100611,3,0,3,58,29,6,93,188,6,287
5100612,64,9,73,37,18,0,55,246,29,330
5100613,0,0,0,43,19,0,62,144,8,214
5100614,4,0,4,69,33,3,105,219,30,354
5100615,44,0,44,63,41,0,104,429,25,558
5100616,0,0,0,76,13,3,92,208,54,354
5100617,6,0,6,66,47,11,124,272,41,437
5100618,3,0,3,32,25,6,63,178,4,245
5100619,54,5,62,58,28,4,90,349,15,454
5100620,8,0,11,64,30,4,98,462,27,587
5100621,3,3,6,50,20,6,76,228,30,334
5100622,3,3,6,60,17,6,83,192,30,305
5100623,8,0,8,81,36,6,123,301,24,448
5100624,4,0,4,49,21,0,70,193,18,281
5100625,6,0,6,62,23,0,85,189,20,294
5100626,10,0,10,49,23,0,72,136,14,222
5100627,4,5,9,43,24,0,67,202,34,303
5100628,6,0,6,50,18,11,79,210,18,307
5100629,3,7,10,78,27,0,105,264,63,432
5100630,3,3,6,37,15,0,52,192,68,312
5100631,3,0,3,76,34,7,117,250,30,397
5100632,8,0,8,59,27,3,89,171,21,281
5100633,3,4,7,66,31,0,97,267,69,433
5100634,9,0,9,79,32,0,111,348,37,496
5100635,32,3,35,57,25,0,82,279,29,390
5100636,18,0,18,40,29,0,69,207,24,300
5100637,0,0,0,33,24,9,66,234,34,334
5100638,9,3,12,50,18,0,68,180,57,305
5100639,13,3,16,53,28,0,81,241,34,356
5100640,14,3,17,58,25,0,83,253,36,372
5100641,8,3,11,96,31,0,127,220,29,376
5100701,3,0,3,41,27,6,74,151,16,241
5100702,0,0,0,42,15,0,57,127,24,208
5100703,3,0,3,55,18,3,76,179,18,273
5100704,0,3,6,75,12,11,98,205,33,336
5100705,3,0,3,48,18,0,66,105,22,193
5100706,0,0,0,40,15,3,58,141,7,206
5100707,0,0,0,56,29,6,91,214,11,316
5100708,0,3,3,81,28,8,117,236,24,377
5100709,3,0,3,53,18,0,71,168,8,247
5100710,6,0,6,81,21,0,102,241,40,383
5100711,0,4,4,56,13,6,75,116,26,217
5100712,0,3,3,127,41,10,178,333,98,609
5100801,0,0,0,68,28,3,99,249,12,360
5100802,3,0,3,78,47,3,128,344,57,529
5100803,3,3,6,36,15,0,51,164,27,242
5100804,0,0,0,87,33,6,126,216,19,361
5100805,0,0,0,86,18,0,104,220,19,343
5100806,0,0,0,0,0,0,0,0,331,331
5100807,3,0,3,59,28,3,90,266,46,402
5100808,0,0,0,0,0,0,0,0,0,0
5100809,15,0,15,92,30,3,125,359,61,545
5100810,6,3,9,74,26,0,100,251,53,404
5100811,3,48,51,28,12,0,40,115,108,263
5100812,15,6,21,20,22,6,48,213,54,315
5100813,11,0,11,62,26,0,88,237,61,386
5100814,9,0,9,41,24,6,71,190,25,286
5100815,4,0,4,86,25,0,111,225,57,393
5100816,0,0,0,40,21,0,61,183,31,275
5100901,3,3,6,30,21,0,51,147,15,213
5100902,0,0,0,80,36,3,119,211,33,363
5100903,3,0,3,74,36,4,114,192,15,321
5100904,0,0,0,53,17,0,70,164,13,247
5100905,7,0,7,95,20,6,121,300,42,463
5100906,4,0,4,42,10,3,55,142,20,217
5100907,3,0,3,45,16,4,65,119,8,192
5100908,0,0,0,54,18,5,77,175,10,262
5100909,6,0,6,39,11,0,50,147,14,211
5100910,0,0,0,0,0,0,0,0,0,0
5100911,6,0,6,52,17,12,81,113,12,206
5100912,10,0,10,49,20,8,77,212,23,312
5100913,3,0,3,44,14,3,61,145,13,219
5100914,0,0,0,56,30,0,86,170,8,264
5100915,0,0,0,0,6,0,6,6,0,12
5100916,33,3,36,79,31,6,116,271,25,412
5100917,0,0,0,0,0,0,0,0,0,0
5100918,14,0,14,23,15,0,38,114,16,168
5100919,5,0,5,153,58,3,214,478,167,859
5100920,4,0,4,84,40,3,127,240,26,393
5100921,4,0,4,0,0,0,0,4,0,4
5100922,3,0,3,24,16,3,43,106,15,164
5100923,4,0,4,79,34,5,118,168,3,289
5100924,0,0,0,37,14,6,57,102,0,159
5100925,0,0,0,52,18,0,70,131,24,225
5100926,3,0,3,50,21,0,71,106,14,191
5100927,4,0,4,57,19,0,76,196,43,315
5100928,5,3,8,80,41,3,124,255,36,415
5100929,3,0,3,61,17,0,78,167,15,260
5101001,3,0,3,59,19,3,81,150,9,240
5101002,0,0,0,89,33,4,126,253,31,410
5101003,0,0,0,71,20,11,102,154,9,265
5101004,5,0,5,52,19,3,74,169,18,261
5101005,0,0,3,116,19,9,144,195,31,370
5101006,3,3,6,89,35,3,127,235,41,403
5101007,0,4,4,89,23,6,118,179,16,313
5101101,0,0,0,0,0,0,0,3,3,6
5101201,5,4,9,105,30,6,141,222,36,399
5101202,5,0,5,76,38,7,121,215,29,365
5101203,0,0,0,55,26,3,84,188,16,288
5101204,0,3,3,74,25,0,99,167,18,284
5101205,0,0,0,56,23,3,82,105,15,202
5101206,0,0,0,64,17,9,90,144,10,244
5101207,0,0,0,72,29,6,107,212,18,337
5101208,3,3,6,34,24,7,65,120,12,197
5101209,3,0,3,101,46,6,153,284,28,465
5101210,0,0,0,33,29,3,65,134,0,199
5101211,0,0,0,313,84,14,411,451,40,902
5101212,112,14,126,159,41,9,209,676,58,943
5101213,0,0,0,0,0,0,0,0,0,0
5101214,0,5,5,66,23,10,99,248,21,368
5101215,0,0,0,101,15,6,122,153,10,285
5101216,5,0,5,139,43,10,192,223,13,428
5101217,4,0,4,75,6,6,87,121,24,232
5101218,3,0,3,105,29,6,140,193,29,362
5101219,6,0,6,48,23,7,78,258,30,366
5101220,6,0,6,78,41,6,125,230,27,382
5101221,3,7,10,77,23,0,100,173,15,288
5101222,0,0,0,97,35,6,138,248,24,410
5101301,0,0,0,30,15,0,45,95,8,148
5101302,6,0,6,133,41,3,177,336,34,547
5101303,3,0,3,34,19,0,53,146,14,213
5101304,0,0,0,63,25,3,91,140,6,237
5101305,0,3,3,32,19,3,54,175,3,232
5101306,0,0,0,65,15,0,80,74,8,162
5101307,0,0,0,96,47,9,152,261,29,442
5101308,6,0,6,59,23,3,85,154,12,251
5101309,0,0,0,134,28,0,162,180,14,356
5101310,0,0,0,107,13,4,124,126,24,274
5101311,0,0,0,141,13,3,157,218,23,398
5101312,3,0,3,131,23,6,160,178,28,366
5101313,0,0,0,86,26,4,116,141,21,278
5101314,0,0,0,167,15,9,191,204,31,426
5101315,0,0,0,156,25,8,189,201,28,418
5101316,0,0,0,117,23,6,146,145,27,318
5101317,0,0,0,114,12,6,132,156,21,309
5101318,0,0,0,113,12,0,125,142,10,277
5101319,0,0,0,67,12,3,82,113,7,202
5101320,0,0,0,123,10,6,139,123,4,266
5101321,0,0,0,303,42,13,358,502,61,921
5101322,0,0,0,0,0,0,0,0,0,0
5101401,8,0,8,42,33,3,78,163,33,274
5101402,0,5,5,71,27,0,98,180,14,292
5101403,3,3,6,105,49,4,158,241,30,429
5101404,4,0,4,46,9,9,64,168,12,244
5101405,3,0,3,62,27,3,92,197,28,317
5101406,20,6,26,52,21,0,73,192,53,318
5101407,10,3,13,68,25,5,98,217,42,357
5101408,0,4,4,44,8,0,52,129,23,204
5101409,6,0,6,24,17,3,44,128,12,184
5101410,3,0,3,52,26,3,81,193,18,292
5101411,6,0,6,45,14,3,62,187,32,281
5101412,0,0,0,58,10,3,71,171,21,263
5101413,0,0,0,22,6,0,28,98,13,139
5101414,3,0,3,45,19,0,64,116,45,225
5101415,3,0,3,61,30,12,103,223,35,361
5101416,0,0,0,41,12,6,59,121,10,190
5101417,3,0,3,88,15,4,107,203,30,340
5101418,0,0,0,44,21,0,65,118,18,201
5101419,6,0,6,47,19,6,72,190,24,286
5101420,3,3,6,73,19,7,99,209,46,354
5101421,3,0,3,99,28,7,134,225,61,420
5101422,3,6,9,64,28,3,95,196,45,336
5101423,3,0,3,76,24,10,110,198,40,348
5101501,8,0,8,36,15,12,63,177,19,259
5101502,9,3,12,63,19,3,85,210,12,307
5101503,0,4,4,71,34,3,108,283,59,450
5101504,4,0,4,40,24,3,67,160,10,237
5101505,10,7,17,68,41,7,116,325,39,480
5101506,0,0,0,0,0,0,0,0,0,0
5101507,13,3,16,84,35,6,125,371,27,523
5101508,9,3,12,57,36,3,96,231,48,375
5101509,0,0,0,38,17,0,55,156,21,232
5101510,16,8,24,58,35,3,96,398,58,552
5101511,0,0,0,131,45,3,179,320,28,527
5101512,0,0,0,136,41,7,184,282,51,517
5101513,0,5,5,110,34,4,148,219,37,404
5101514,0,0,0,134,31,7,172,279,34,485
5101515,0,0,0,41,11,0,52,133,38,223
5101516,0,0,0,0,0,0,0,0,0,0
5101601,0,0,0,38,10,7,55,105,7,167
5101602,0,6,6,69,21,4,94,199,25,318
5101603,4,0,4,38,16,0,54,104,12,170
5101604,0,0,0,44,12,6,62,105,7,174
5101605,30,3,33,61,17,0,78,222,28,328
5101606,0,0,0,36,12,7,55,109,6,170
5101607,7,0,7,60,29,9,98,262,22,382
5101608,3,0,3,97,25,9,131,292,23,446
5101609,0,0,0,44,14,7,65,97,0,162
5101610,0,0,0,0,0,0,0,3,0,3
5101611,0,3,3,73,11,7,91,203,32,326
5101612,3,0,3,18,18,0,36,148,14,198
5101701,3,0,3,81,11,3,95,142,10,247
5101702,28,0,28,67,21,6,94,324,35,453
5101703,6,0,6,90,27,0,117,258,18,393
5101704,0,0,0,79,17,0,96,174,15,285
5101705,3,0,3,70,20,3,93,157,15,265
5101706,3,0,3,59,21,0,80,191,27,298
5101707,3,0,3,39,9,0,48,158,0,206
5101708,0,0,0,39,12,3,54,138,0,192
5101709,10,0,10,58,27,0,85,164,3,252
5101710,5,0,5,85,23,10,118,216,31,365
5101711,0,0,0,40,20,0,60,211,12,283
5101712,0,0,0,35,12,3,50,107,12,169
5101713,5,3,8,38,8,3,49,125,12,186
5101714,19,3,22,47,18,0,65,184,12,261
5101715,0,0,0,40,27,3,70,138,6,214
5101716,0,0,0,31,17,3,51,113,12,176
5101717,0,0,0,26,9,0,35,77,9,121
5101718,0,0,0,30,6,0,36,108,15,159
5101719,3,0,3,34,9,0,43,113,9,165
5101801,0,0,0,62,12,0,74,91,9,174
5101802,3,4,7,57,20,3,80,223,22,325
5101803,19,5,24,46,16,6,68,172,9,249
5101804,3,3,6,41,12,0,53,129,21,203
5101805,0,0,0,41,15,12,68,178,16,262
5101806,3,0,3,106,30,4,140,247,19,406
5101807,0,0,0,43,17,0,60,147,8,215
5101808,0,0,0,52,23,0,75,178,23,276
5101809,0,0,0,49,17,0,66,139,9,214
5101810,6,0,6,35,13,0,48,154,8,210
5101811,3,0,3,31,28,0,59,189,21,269
5101812,0,0,0,67,27,0,94,225,32,351
5101813,3,0,3,79,23,3,105,206,25,336
5101814,6,3,9,27,24,3,54,150,18,222
5101815,3,0,3,51,12,0,63,177,6,246
5101816,10,3,13,41,24,3,68,221,31,320
5101901,7,0,7,89,23,4,116,249,28,393
5101902,3,3,6,43,13,3,59,112,18,189
5101903,11,0,11,59,18,6,83,201,21,305
5101904,3,0,3,50,15,0,65,133,19,217
5101905,0,5,5,64,14,7,85,166,17,268
5101906,0,3,3,25,10,0,35,65,6,106
5101907,39,6,45,70,19,6,95,268,19,382
5101908,6,0,6,41,19,9,69,241,6,316
5101909,3,0,3,67,17,3,87,244,13,344
5101910,0,0,0,63,10,6,79,142,12,233
5101911,7,0,7,57,19,4,80,138,21,239
5101912,3,0,3,35,12,3,50,114,21,185
5101913,6,4,10,55,24,9,88,194,26,308
5101914,0,6,6,87,26,5,118,199,12,329
5101915,3,4,10,19,26,3,48,142,38,228
5101916,0,0,0,39,10,0,49,104,11,164
5102001,7,0,7,42,14,4,60,214,27,301
5102002,0,0,0,34,12,6,52,89,7,148
5102003,3,5,8,52,13,9,74,132,12,218
5102004,0,0,0,70,24,4,98,265,46,409
5102005,8,0,8,84,28,3,115,261,24,400
5102006,3,0,3,56,22,0,78,216,15,309
5102007,0,0,0,44,18,3,65,145,12,222
5102008,0,0,0,25,13,6,44,170,21,235
5102009,7,0,7,84,22,6,112,277,17,406
5102010,0,4,4,55,36,5,96,293,29,418
5102011,4,0,4,36,15,7,58,131,15,204
5102012,0,0,0,46,15,3,64,116,3,183
5102013,3,0,3,47,9,0,56,146,7,209
5102014,0,3,3,104,35,6,145,213,21,379
5102101,0,0,0,85,36,0,121,209,17,347
5102102,0,3,3,54,28,4,86,270,40,396
5102103,6,0,6,45,20,3,68,206,32,306
5102104,0,0,0,117,33,6,156,240,17,413
5102105,0,0,0,92,24,6,122,172,24,318
5102106,0,0,0,57,22,3,82,83,21,186
5102107,0,0,0,52,14,9,75,62,9,146
5102108,0,0,0,50,9,3,62,91,12,165
5102109,0,0,0,49,35,5,89,145,4,238
5102110,0,0,0,3,0,0,3,3,0,6
5102111,0,0,0,12,3,0,15,28,3,46
5102112,3,0,3,20,17,0,37,122,12,171
5102113,3,0,3,104,39,0,143,274,32,449
5102114,0,0,0,48,18,3,69,129,6,204
5102115,3,0,3,65,20,0,85,290,35,410
5102116,0,0,0,109,30,3,142,192,15,349
5102117,3,0,3,14,19,3,36,118,3,157
5102201,6,3,9,44,33,9,86,170,20,276
5102202,0,0,0,35,23,0,58,146,12,216
5102203,0,3,3,48,15,0,63,141,15,219
5102204,0,0,0,157,38,10,205,305,41,551
5102205,0,0,0,59,49,12,120,306,51,477
5102206,4,0,4,25,13,6,44,136,8,188
5102207,7,0,7,59,25,6,90,198,23,311
5102208,6,0,6,57,12,0,69,96,5,170
5102209,0,4,4,38,26,6,70,193,26,289
5102210,3,6,9,53,31,0,84,266,39,389
5102211,4,0,4,72,16,0,88,170,15,273
5102212,7,3,10,58,26,3,87,183,29,299
5102213,5,0,5,53,36,9,98,224,20,342
5102214,0,0,0,40,23,6,69,279,26,374
5102215,3,0,3,53,19,5,77,164,24,265
5102216,3,3,6,23,35,0,58,178,23,259
5102217,6,0,6,37,13,0,50,156,28,234
5102218,3,0,3,44,23,3,70,180,17,267
5102219,0,0,0,75,29,0,104,243,22,369
5102220,4,0,4,48,15,14,77,162,18,257
5102301,0,0,0,64,23,5,92,336,33,461
5102302,0,0,0,20,12,0,32,88,0,120
5102303,3,0,3,46,25,6,77,135,6,218
5102304,15,5,20,51,20,3,74,400,56,530
5102305,0,3,3,123,38,5,166,254,73,493
5102306,3,0,3,72,22,0,94,199,28,321
5102307,7,0,7,60,21,0,81,195,42,318
5102308,0,3,3,111,34,0,145,245,34,424
5102309,0,0,0,74,41,3,118,285,19,422
5102310,0,0,0,54,32,0,86,221,37,344
5102311,0,0,0,87,34,4,125,276,38,439
5102312,3,0,3,48,15,3,66,147,18,231
5102313,8,0,8,139,62,12,213,352,35,600
5102314,6,0,6,51,25,0,76,242,19,337
5102315,0,3,3,45,18,3,66,152,30,248
5102316,26,7,33,43,39,0,82,376,43,501
5102317,0,0,0,56,24,4,84,134,21,239
5102318,8,0,8,85,37,6,128,252,36,416
5102319,3,0,6,102,30,13,145,279,32,456
5102320,6,0,6,85,27,12,124,264,38,426
5102321,0,0,0,0,0,0,0,3,0,3
5102322,112,15,127,3,15,0,18,391,60,469
5102401,0,0,0,44,46,4,94,344,51,489
5102402,4,0,4,31,36,3,70,250,50,370
5102403,5,0,5,52,26,3,81,159,6,246
5102404,4,0,4,42,20,0,62,171,13,246
5102405,0,0,0,41,17,3,61,182,9,252
5102406,3,0,3,86,43,5,134,298,32,464
5102407,0,3,3,65,35,6,106,286,22,414
5102408,15,0,15,59,57,3,119,553,47,719
5102409,0,0,0,51,18,0,69,213,32,314
5102410,0,0,0,113,23,10,146,209,15,370
5102411,0,0,0,91,16,0,107,225,26,358
5102412,0,3,3,46,24,3,73,142,20,235
5102413,7,0,7,63,28,0,91,199,17,307
5102414,3,0,3,69,28,4,101,209,14,324
5102415,4,0,4,62,44,3,109,223,16,348
5102416,3,0,3,184,32,3,219,338,22,579
5102417,0,0,0,117,21,9,147,255,24,426
5102418,0,0,0,0,0,0,0,0,0,0
5102419,6,0,6,66,15,3,84,184,27,295
5102420,34,12,46,43,18,6,67,237,54,358
5102421,0,0,0,111,20,11,142,187,25,354
5102422,6,6,12,68,31,5,104,183,27,314
5102423,0,0,0,73,33,12,118,252,28,398
5102424,3,0,3,65,15,0,80,176,18,274
5102425,4,8,12,63,26,0,89,249,39,377
5102426,0,4,4,52,14,4,70,202,36,308
5102427,0,0,0,148,18,9,175,144,25,344
5102428,0,0,0,90,21,12,123,194,31,348
5102429,3,3,6,40,58,0,98,277,46,421
5102430,8,0,8,44,35,3,82,273,31,386
5102431,8,3,11,37,16,4,57,163,14,234
5102432,7,0,7,75,40,4,119,323,37,479
5102433,3,0,3,41,50,3,94,296,58,448
5102434,3,39,42,46,25,0,71,113,110,294
5102435,0,0,0,0,0,0,0,0,0,0
5102436,0,0,0,55,31,12,98,171,11,280
5102437,0,0,0,69,30,0,99,152,23,274
5102438,41,22,63,3,15,0,18,329,79,426
5102439,0,0,0,119,12,4,135,150,20,305
5102440,0,0,0,144,33,12,189,231,26,446
5102501,11,0,11,27,17,0,44,254,33,331
5102502,6,4,10,57,61,0,118,487,138,743
5102503,9,3,12,16,17,0,33,197,29,259
5102504,7,11,18,54,19,3,76,342,85,503
5102505,3,3,6,71,42,4,117,240,42,399
5102506,0,4,4,40,34,0,74,160,32,266
5102507,9,4,13,58,37,4,99,222,51,372
5102508,10,6,16,45,14,5,64,219,37,320
5102509,9,0,9,21,7,0,28,169,18,215
5102510,33,57,90,26,19,0,45,276,153,474
5102511,15,7,22,56,34,3,93,320,31,444
5102512,10,7,17,54,12,0,66,251,42,359
5102513,10,3,13,48,17,3,68,229,46,343
5102514,8,5,13,62,27,0,89,235,19,343
5102515,8,0,8,40,21,0,61,191,33,285
5102516,8,4,12,66,22,0,88,272,36,396
5102517,6,5,11,52,21,0,73,174,23,270
5102518,9,3,12,45,13,3,61,236,32,329
5102519,9,0,9,57,21,3,81,206,30,317
5102520,15,3,18,55,41,3,99,353,32,484
5102521,0,0,0,0,0,0,0,0,0,0
5102601,3,0,3,38,26,0,64,104,13,181
5102602,3,3,6,59,25,0,84,199,21,304
5102603,0,0,0,49,36,9,94,279,51,424
5102604,0,0,0,43,31,0,74,257,38,369
5102605,6,0,6,65,28,6,99,276,41,416
5102606,4,0,4,54,30,0,84,172,27,283
5102607,3,0,3,51,23,7,81,160,19,260
5102608,0,0,0,25,12,3,40,120,15,175
5102609,0,0,0,43,6,3,52,111,12,175
5102610,0,0,0,0,0,0,0,6,0,6
5102611,3,0,3,18,23,0,41,136,9,186
5102612,3,0,3,39,0,0,39,149,30,218
5102613,16,9,25,50,35,4,89,361,56,506
5102614,3,0,3,29,23,0,52,225,20,297
5102615,0,0,0,20,15,0,35,111,30,176
5102616,0,0,0,45,3,0,48,105,10,163
5102701,0,6,6,148,30,7,185,326,70,581
5102702,0,0,0,134,35,9,178,233,27,438
5102703,3,0,3,165,35,6,206,236,35,477
5102704,0,0,0,0,0,0,0,0,0,0
5102705,4,3,7,63,22,0,85,211,29,325
5102706,0,0,0,58,27,5,90,123,18,231
5102707,14,10,24,70,28,0,98,206,48,352
5102708,0,0,0,72,49,6,127,301,21,449
5102709,3,4,7,67,28,6,101,231,40,372
5102710,0,0,0,50,24,0,74,164,16,254
5102711,3,0,3,147,37,7,191,281,25,497
5102712,3,4,7,51,8,7,66,121,14,201
5102713,121,52,173,13,22,0,35,387,111,533
5102714,3,0,3,176,43,8,227,351,51,629
5102715,0,5,5,121,60,8,189,258,86,533
5102716,0,0,0,97,29,6,132,267,39,438
5102717,4,0,4,59,15,0,74,194,26,294
5102718,0,0,0,145,27,4,176,232,39,447
5102719,3,0,3,128,26,3,157,242,30,429
5102720,6,3,9,18,12,0,30,162,21,213
5102721,5,0,5,79,35,6,120,284,19,423
5102722,4,0,4,78,14,3,95,186,27,308
5102723,3,0,3,93,35,12,140,259,23,422
5102724,6,0,6,91,23,9,123,256,38,417
5102725,0,0,0,96,30,4,130,228,36,394
5102801,3,3,6,63,24,6,93,169,26,288
5102802,5,0,5,38,7,3,48,165,41,254
5102803,19,16,35,65,35,10,110,313,90,513
5102804,6,3,9,68,25,13,106,256,65,427
5102805,6,3,9,63,33,0,96,170,38,304
5102806,66,0,66,107,63,3,173,537,42,752
5102807,3,3,6,28,9,0,37,126,21,184
5102808,6,0,6,49,17,4,70,216,38,324
5102809,4,0,4,73,29,3,105,271,24,400
5102810,0,0,0,24,21,0,45,103,12,160
5102811,7,0,7,18,44,5,67,311,29,407
5102812,6,3,9,88,35,3,126,307,25,458
5102813,0,0,0,62,26,0,88,314,32,434
5102814,0,0,0,31,20,0,51,197,24,272
5102815,25,0,25,0,4,0,4,205,27,236
5102816,38,17,55,38,32,0,70,308,51,429
5102817,10,6,16,33,16,0,49,273,70,392
5102818,9,0,9,31,28,0,59,194,26,279
5102819,10,0,10,43,31,3,77,312,20,409
5102820,12,22,34,37,25,0,62,173,66,301
5102821,10,5,15,54,28,0,82,291,41,414
5102822,4,3,7,39,18,3,60,147,9,216
5102901,16,14,30,0,13,0,13,303,46,362
5102902,0,0,0,137,37,13,187,217,22,426
5102903,6,0,6,81,23,8,112,164,29,305
5102904,0,0,0,41,20,0,61,73,6,140
5102905,0,0,0,34,7,0,41,83,10,134
5102906,0,0,0,40,12,3,55,119,7,181
5102907,3,0,3,61,11,0,72,167,26,265
5102908,0,0,0,232,47,13,292,364,37,693
5102909,5,0,5,86,27,0,113,233,27,373
5102910,0,6,6,70,30,4,104,283,44,431
5102911,3,0,3,77,27,6,110,233,29,372
5102912,3,0,3,18,13,0,31,145,20,196
5102913,5,0,5,55,29,6,90,200,31,321
5102914,6,0,6,69,25,0,94,228,49,371
5102915,12,0,12,55,27,3,85,237,43,365
5102916,24,4,28,58,27,3,88,282,34,404
5102917,4,0,4,48,26,0,74,161,15,250
5102918,0,0,0,91,21,9,121,224,44,389
5102919,0,0,0,32,12,3,47,153,24,224
5103001,83,18,101,3,6,3,12,192,34,238
5103002,0,0,0,69,27,0,96,176,0,272
5103003,0,0,0,0,0,0,0,0,0,0
5103004,0,0,0,0,7,0,7,43,0,50
5103005,0,0,0,0,0,0,0,0,0,0
5103006,0,0,0,0,0,0,0,0,0,0
5103007,7,0,7,85,41,3,129,208,27,364
5103008,0,0,0,83,15,9,107,241,27,375
5103009,3,3,6,104,34,3,141,191,18,350
5103010,8,0,8,84,57,6,147,272,27,446
5103011,16,5,21,113,43,9,165,341,29,535
5103012,7,0,7,81,17,3,101,184,21,306
5103013,0,0,0,101,39,5,145,202,12,359
5103014,5,0,5,34,24,0,58,155,9,222
5103015,6,0,6,110,51,9,170,279,22,471
5103016,8,0,8,88,27,0,115,278,22,415
5103017,6,3,9,39,28,0,67,167,21,255
5103018,8,0,8,80,46,0,126,272,21,419
5103101,10,0,10,28,14,3,45,102,20,167
5103102,0,0,0,0,0,0,0,0,0,0
5103103,0,3,3,71,28,9,108,211,36,355
5103104,11,3,14,51,36,3,90,187,24,301
5103105,9,3,12,52,21,7,80,206,34,320
5103106,32,43,79,80,38,0,118,312,102,532
5103107,61,3,64,26,21,0,47,243,18,308
5103108,5,4,9,62,31,0,93,326,47,466
5103109,5,3,8,41,29,0,70,141,7,218
5103110,4,0,4,33,18,0,51,197,15,263
5103111,10,0,10,37,15,0,52,279,52,383
5103112,8,4,12,46,14,0,60,154,24,238
5103113,7,0,7,77,30,4,111,198,3,312
5103114,14,3,17,50,68,0,118,360,48,526
5103115,8,3,11,71,27,6,104,204,15,323
5103116,0,0,0,0,0,0,0,0,0,0
5103117,5,0,5,46,12,6,64,243,19,326
5103118,6,0,6,35,0,3,38,153,61,252
5103119,49,8,60,66,32,0,98,247,15,360
5103120,4,0,4,37,22,3,62,300,36,398
5103121,9,0,9,70,30,0,100,261,44,405
5103201,12,0,12,49,23,6,78,180,38,296
5103202,18,46,64,32,17,3,52,181,75,308
5103203,9,6,15,46,32,0,78,242,26,346
5103204,0,0,0,53,38,0,91,164,24,279
5103205,4,3,7,97,21,10,128,169,19,316
5103206,9,3,12,70,25,3,98,162,12,272
5103207,8,3,11,37,24,0,61,269,51,381
5103208,6,3,9,61,26,0,87,126,19,232
5103209,11,0,11,106,48,7,161,301,49,511
5103210,4,0,4,58,18,6,82,184,24,290
5103211,4,0,4,73,42,3,118,217,59,394
5103212,0,0,0,35,22,0,57,176,36,269
5103213,6,0,6,92,27,6,125,278,37,440
5103214,10,0,10,50,22,3,75,215,25,315
5103215,8,5,13,49,40,0,89,303,78,470
5103216,4,0,4,45,18,0,63,167,33,263
5103217,5,3,8,54,22,3,79,224,29,332
5103218,0,0,0,112,32,9,153,237,10,400
5103301,3,0,3,67,19,3,89,150,15,254
5103302,3,0,3,70,17,4,91,148,13,252
5103303,10,3,13,107,36,6,149,236,24,409
5103304,6,0,6,74,12,3,89,127,9,225
5103305,13,0,13,121,24,13,158,183,21,362
5103306,4,4,8,95,21,15,131,162,10,303
5103307,14,0,14,76,21,4,101,238,12,351
5103308,0,0,0,0,0,0,0,0,0,0
5103309,12,0,12,63,14,0,77,138,3,218
5103310,6,0,6,74,16,8,98,141,10,249
5103311,10,3,13,48,18,0,66,123,6,195
5103312,8,3,11,70,33,11,114,216,18,348
5103313,3,0,3,46,12,7,65,101,3,169
5103314,0,0,0,0,0,0,0,0,0,0
5103315,6,4,10,88,35,3,126,223,17,366
5103316,9,3,12,69,23,13,105,124,3,232
5103317,5,0,5,48,29,7,84,128,6,218
5103318,6,4,10,49,25,4,78,122,7,207
5103319,11,0,11,56,23,0,79,160,13,252
5103320,24,0,27,111,33,3,147,253,9,409
5103321,10,3,13,62,16,6,84,169,15,268
5103322,0,0,0,73,14,6,93,131,15,239
5103401,12,4,16,25,19,0,44,139,43,226
5103402,7,0,7,21,21,0,42,132,9,183
5103403,14,4,18,109,34,6,149,309,50,508
5103404,3,0,3,76,22,0,98,154,12,264
5103405,10,3,13,93,31,10,134,229,21,384
5103406,6,7,13,79,29,0,108,286,19,413
5103407,11,0,11,118,16,4,138,190,19,347
5103408,3,3,6,87,14,4,105,144,24,273
5103409,36,4,40,70,33,7,110,251,23,384
5103410,0,5,5,55,28,0,83,215,12,310
5103411,0,0,0,51,20,0,71,149,13,233
5103412,13,0,13,16,37,6,59,209,13,281
5103413,6,0,6,52,26,0,78,408,42,528
5103414,6,3,9,53,20,0,73,208,44,325
5103415,3,0,3,47,11,0,58,335,60,453
5103416,6,3,9,78,21,0,99,205,19,323
5103417,21,17,38,54,25,6,85,280,45,410
5103418,6,3,9,33,23,0,56,162,18,236
5103419,7,0,7,45,21,3,69,139,19,227
5103420,7,5,12,95,15,6,116,223,32,371
5103421,6,3,9,88,41,0,129,418,82,629
5103422,6,0,6,81,20,3,104,164,21,289
5103423,3,0,3,53,22,3,78,182,7,267
5103424,37,3,40,32,25,0,57,385,40,482
5103501,0,0,3,50,15,0,65,125,12,202
5103502,0,0,0,0,0,0,0,3,0,3
5103503,19,6,25,68,39,6,113,209,19,341
5103504,4,0,4,68,15,0,83,308,54,445
5103505,7,0,7,30,34,0,64,348,20,432
5103506,6,0,6,38,15,0,53,239,25,317
5103507,0,0,0,35,3,0,38,180,6,224
5103508,0,0,0,0,0,0,0,0,0,0
5103509,3,3,6,29,6,0,35,107,18,160
5103510,7,0,7,98,34,10,142,274,40,456
5103511,0,0,0,79,29,3,111,270,12,393
5103512,60,13,73,83,29,7,119,411,44,574
5103513,16,0,16,108,39,6,153,331,18,502
5103514,6,6,12,82,30,7,119,271,24,414
5103515,5,0,5,53,23,8,84,173,7,264
5103516,14,3,17,55,18,8,81,242,9,332
5103517,8,3,11,84,18,9,111,259,12,382
5103518,3,0,3,72,29,0,101,179,11,291
5103519,3,0,3,49,18,0,67,142,26,235
5103520,10,0,10,74,40,0,114,192,16,322
5103521,4,3,7,74,44,0,118,469,42,629
5103522,0,0,0,3,10,0,13,413,12,438
5103523,20,0,20,37,53,0,90,388,28,506
5103524,0,0,0,3,21,0,24,480,29,533
5103525,3,3,6,75,49,3,127,243,32,402
5103526,6,0,6,48,14,3,65,149,9,223
5103527,4,0,7,57,28,3,88,244,15,347
5103528,7,0,7,86,39,0,125,246,36,407
5103529,6,0,6,55,24,0,79,210,6,295
5103530,5,3,8,48,23,3,74,166,23,263
5103531,7,3,10,67,22,3,92,212,18,322
5103532,9,3,12,117,39,7,163,302,31,496
5103533,19,3,22,137,46,6,189,336,16,541
5103534,64,55,119,33,5,3,41,167,98,306
5103535,6,0,6,89,22,0,111,301,4,416
5103536,7,5,12,111,15,5,131,221,19,371
5103537,6,0,6,75,18,9,102,178,12,292
5103538,3,0,3,70,42,7,119,268,18,405
5103539,9,0,9,60,31,6,97,277,21,395
5103540,6,0,6,80,20,9,109,248,22,379
5103541,0,0,0,95,23,8,126,212,5,343
5103601,0,0,0,0,0,0,0,0,0,0
5103602,21,4,25,70,19,6,95,235,25,355
5103603,3,0,3,62,34,3,99,221,15,335
5103604,0,0,0,50,9,3,62,127,9,198
5103605,14,5,19,48,16,6,70,196,23,289
5103606,26,3,29,72,30,3,105,249,21,375
5103607,0,0,0,0,0,3,3,0,4,7
5103608,6,0,6,48,8,3,59,114,9,182
5103609,6,0,6,73,31,3,107,257,39,403
5103610,3,0,3,37,23,3,63,110,6,179
5103611,7,0,7,71,22,3,96,227,7,330
5103612,10,3,13,112,35,6,153,272,18,443
5103613,3,0,3,37,18,0,55,138,9,202
5103614,4,4,8,62,44,6,112,203,10,325
5103615,0,0,0,58,6,5,69,37,3,109
5103616,3,0,3,57,26,6,89,135,15,239
5103617,15,0,15,80,22,11,113,331,19,463
5103618,0,0,0,57,15,3,75,178,12,265
5103619,13,0,13,78,39,3,120,311,32,463
5103620,5,0,5,67,39,0,106,173,12,291
5103621,6,0,6,51,15,0,66,162,68,296
5103622,0,0,0,0,0,0,0,0,0,0
5103623,6,0,6,115,14,9,138,124,14,276
5103624,16,9,25,45,20,6,71,186,24,281
5103625,0,0,0,0,0,0,0,0,0,0
5103701,0,0,0,7,0,0,7,20,3,30
5103801,7,0,7,40,21,0,61,171,23,255
5103802,25,7,36,26,20,0,46,288,43,377
5103803,6,0,6,32,21,0,53,342,58,453
5103804,5,0,5,38,24,6,68,153,31,252
5103805,7,3,10,46,7,0,53,190,25,268
5103806,3,0,3,38,16,3,57,376,74,507
5103807,0,0,0,42,10,0,52,142,17,211
5103808,4,0,4,21,9,4,34,169,34,237
5103809,3,3,6,43,18,3,64,315,41,420
5103810,7,0,7,78,9,3,90,246,15,351
5103811,9,6,15,100,15,3,118,208,24,350
5103812,0,0,0,0,0,0,0,0,0,0
5103813,6,5,11,126,22,11,159,178,28,365
5103814,3,0,3,43,23,3,69,173,16,258
5103815,10,0,10,85,9,0,94,139,27,260
5103816,6,0,6,75,9,9,93,106,9,208
5103817,10,3,13,126,31,9,166,240,16,422
5103818,4,0,4,79,10,0,89,136,9,234
5103819,0,3,3,55,21,0,76,127,9,212
5103820,0,0,0,49,16,4,69,139,35,243
5103821,6,0,6,59,9,3,71,110,12,193
5103822,0,3,3,132,24,10,166,273,40,479
5103823,6,0,6,43,17,9,69,138,9,216
5103824,0,0,0,94,11,5,110,177,19,306
5103825,10,0,10,29,15,6,50,179,11,240
5103826,6,0,6,115,22,4,141,319,39,499
5103827,7,3,10,76,7,9,92,132,10,234
5103828,9,3,12,68,22,6,96,201,24,321
5103901,4,0,4,35,16,6,57,133,15,205
5103902,3,3,6,65,41,3,109,252,26,387
5103903,10,0,10,52,26,3,81,253,16,350
5103904,0,0,0,0,0,0,0,0,0,0
5103905,4,0,4,34,26,0,60,281,39,380
5103906,3,0,3,46,10,6,62,205,9,276
5103907,0,0,0,95,12,6,113,195,6,314
5103908,5,0,5,68,29,3,100,340,37,477
5103909,3,4,7,27,3,5,35,214,50,299
5103910,15,3,18,49,15,3,67,389,38,494
5103911,6,0,6,40,15,6,61,243,28,332
5103912,9,0,9,41,24,0,65,260,41,366
5103913,0,0,0,54,21,3,78,189,23,290
5103914,3,0,3,53,21,0,74,313,27,414
5103915,23,5,28,31,15,0,46,197,16,259
5103916,3,0,3,79,32,0,111,213,24,348
5103917,7,0,7,63,32,3,98,297,24,419
5103918,6,0,6,87,24,6,117,281,12,410
5103919,3,0,3,30,16,0,46,373,39,458
5103920,5,3,8,70,25,3,98,263,21,382
5103921,5,0,5,82,17,6,105,255,20,380
5103922,0,0,0,71,31,6,108,341,18,467
5103923,9,44,53,36,22,3,61,312,112,485
5103924,27,3,30,54,23,0,77,357,47,481
5103925,8,0,8,51,27,0,78,310,45,433
5103926,0,0,0,36,15,3,54,155,14,223
5103927,4,0,4,56,18,6,80,190,34,304
5103928,6,0,6,73,32,5,110,274,11,395
5103929,3,0,3,79,22,0,101,364,39,504
5103930,9,0,9,40,37,3,80,401,39,520
5103931,3,0,3,56,12,0,68,191,12,271
5103932,3,3,6,69,18,4,91,274,33,398
5103933,22,3,25,59,38,0,97,331,15,443
5103934,6,3,9,58,11,6,75,188,28,291
5103935,15,0,15,67,17,3,87,320,34,441
5103936,0,3,3,73,15,3,91,172,12,275
5103937,4,0,4,70,12,6,88,171,9,268
5103938,3,0,3,78,11,0,89,140,17,246
5103939,6,3,9,68,18,4,90,137,24,251
5104001,6,0,6,56,12,0,68,249,27,344
5104002,16,3,19,62,23,4,89,267,34,390
5104003,9,0,9,84,24,0,108,263,22,393
5104004,0,0,0,61,9,6,76,139,16,231
5104005,6,0,6,76,24,6,106,254,27,387
5104006,6,6,12,86,37,0,123,328,32,483
5104007,11,0,11,102,32,6,140,209,14,363
5104008,3,3,6,48,15,0,63,173,28,264
5104009,6,0,6,72,20,9,101,230,22,353
5104010,18,3,21,74,19,4,97,255,36,388
5104011,9,0,9,94,20,0,114,242,30,386
5104012,3,3,6,53,3,0,56,125,15,196
5104013,5,0,5,93,20,6,119,169,19,307
5104014,6,0,6,66,27,9,102,178,15,295
5104015,0,0,0,32,15,0,47,250,29,326
5104016,46,0,46,27,22,0,49,206,9,264
5104017,3,0,3,56,33,0,89,286,45,420
5104018,3,0,3,41,20,0,61,208,19,288
5104019,8,0,8,56,5,6,67,213,39,319
5104020,15,4,19,43,10,10,63,213,36,312
5104021,8,3,11,54,26,6,86,325,42,453
5104101,4,0,4,49,38,3,90,467,62,619
5104102,0,0,0,25,15,3,43,351,79,473
5104103,3,0,3,38,24,0,62,327,41,430
5104104,22,0,22,25,9,0,34,332,66,432
5104105,9,7,19,18,15,0,33,367,64,464
5104106,4,0,4,28,12,3,43,268,92,403
5104107,0,0,0,21,14,0,35,299,89,423
5104108,0,3,3,90,30,0,120,776,128,1024
5104109,0,0,0,45,18,0,63,471,115,649
5104110,0,0,0,50,34,0,84,491,174,749
5104111,3,3,6,57,22,0,79,790,284,1153
5104112,3,3,6,111,28,0,139,1120,300,1559
5104113,3,0,3,51,30,3,84,292,31,407
5104114,0,0,0,35,23,0,58,256,32,346
5104115,0,0,0,23,27,0,50,173,62,285
5104116,3,0,3,21,24,0,45,207,34,286
5104117,0,0,0,15,9,0,24,165,56,245
5104118,0,0,0,7,4,0,11,137,21,169
5104119,6,3,9,41,19,0,60,159,30,249
5104120,6,0,6,60,22,9,91,377,55,523
5104121,0,0,0,45,23,0,68,604,108,780
5104122,6,0,6,39,19,0,58,379,41,478
5104123,24,4,28,32,20,0,52,400,49,501
5104124,27,4,31,23,12,0,35,298,62,395
5104125,6,3,9,28,0,0,28,232,78,338
5104126,0,0,0,64,17,0,81,552,84,717
5104127,0,0,0,15,15,0,30,319,78,427
5104128,7,0,7,19,21,0,40,385,86,511
5104129,4,0,4,64,29,3,96,410,48,554
5104130,8,0,8,56,28,0,84,408,44,536
5104131,9,0,9,50,16,3,69,458,94,621
5104132,9,0,9,36,24,3,63,286,46,395
5104133,0,0,0,25,24,0,49,306,50,405
5104134,10,0,10,51,18,0,69,397,58,524
5104135,0,0,0,15,12,0,27,395,67,489
5104136,3,0,3,60,23,0,83,505,62,650
5104137,4,3,7,46,19,3,68,449,69,586
5104138,0,0,0,20,9,0,29,126,48,203
5104139,0,0,0,23,11,0,34,254,76,364
5104140,5,0,8,16,22,0,38,202,49,289
5104141,0,4,4,25,13,0,38,520,114,672
5104142,9,0,9,32,30,0,62,451,109,622
5104143,19,4,23,42,13,0,55,287,51,393
5104144,0,0,0,45,22,0,67,530,101,698
5104145,3,0,3,19,24,0,43,294,128,465
5104146,0,0,0,15,12,0,27,298,85,410
5104201,0,0,0,57,42,0,99,269,19,387
5104202,3,0,3,42,46,0,88,264,13,365
5104203,0,4,4,42,39,3,84,406,103,593
5104204,51,5,56,74,71,3,148,468,31,647
5104205,10,0,10,38,16,0,54,360,29,443
5104206,6,3,9,65,42,6,113,290,24,427
5104207,9,0,9,58,21,6,85,190,16,291
5104208,6,0,6,98,41,3,142,346,45,533
5104209,21,44,65,43,14,6,63,195,79,337
5104210,4,0,4,56,22,3,81,250,13,344
5104211,0,0,0,63,28,0,91,161,13,265
5104212,15,0,15,55,27,3,85,181,38,304
5104213,7,3,10,61,23,6,90,228,18,336
5104214,9,0,9,44,8,0,52,202,25,279
5104215,3,0,3,67,28,4,99,242,19,360
5104216,5,0,5,66,18,6,90,184,19,293
5104217,4,0,4,80,35,6,121,217,3,341
5104218,3,0,3,31,15,4,50,119,5,174
5104219,5,0,5,92,25,4,121,187,27,335
5104220,3,0,3,79,14,5,98,186,16,300
5104221,3,3,6,88,24,9,121,210,27,358
5104222,0,0,0,66,27,9,102,222,20,344
5104223,3,3,6,123,28,14,165,242,18,425
5104224,4,0,4,54,12,0,66,261,21,348
5104225,4,0,4,84,25,11,120,166,28,314
5104226,18,3,21,49,29,0,78,265,23,366
5104227,0,0,0,0,0,0,0,121,7,128
5104228,0,0,0,35,12,0,47,172,17,236
5104229,0,0,0,41,16,0,57,200,25,282
5104230,6,0,6,61,10,5,76,236,19,331
5104231,15,0,15,45,25,3,73,347,72,492
5104232,0,0,0,35,17,0,52,174,23,249
5104233,10,0,10,61,27,3,91,376,62,529
5104234,6,0,6,54,25,9,88,260,21,369
5104235,4,0,4,45,14,0,59,177,24,260
5104236,0,0,0,23,25,0,48,377,66,491
5104301,0,0,0,26,22,0,48,182,9,239
5104302,3,3,6,82,14,0,96,405,129,630
5104303,4,0,4,43,12,0,55,257,29,341
5104304,12,33,45,42,10,0,52,285,93,430
5104305,4,3,7,31,13,3,47,221,80,348
5104306,6,3,9,52,20,0,72,351,33,456
5104307,3,3,6,23,6,0,29,178,24,231
5104308,21,0,21,32,17,0,49,292,19,360
5104309,0,0,0,0,0,0,0,0,0,0
5104310,33,4,37,60,33,9,102,285,21,408
5104311,0,0,0,0,0,0,0,0,0,0
5104312,0,0,0,71,21,3,95,385,75,555
5104313,0,0,0,68,16,0,84,329,100,513
5104314,8,5,13,48,19,0,67,261,42,370
5104315,0,0,0,33,4,0,37,192,33,262
5104316,0,0,0,92,24,0,116,339,26,481
5104317,8,3,14,120,30,12,162,205,45,412
5104318,9,0,9,39,26,9,74,194,9,277
5104319,3,3,6,127,10,8,145,179,24,348
5104320,32,0,32,89,47,0,136,218,9,363
5104321,14,0,14,76,34,0,110,225,9,344
5104322,5,3,8,67,18,6,91,197,15,303
5104323,0,0,0,108,17,8,133,233,18,384
5104324,109,11,120,42,21,0,63,399,39,501
5104325,6,3,9,117,31,0,148,153,15,316
5104326,9,0,9,80,17,3,100,146,15,261
5104327,0,0,0,78,18,9,105,141,3,249
5104328,3,0,3,110,15,9,134,167,7,308
5104329,6,0,6,142,29,10,181,212,10,403
5104330,11,3,14,148,22,7,177,215,26,418
5104331,8,0,8,108,31,7,146,255,12,413
5104332,29,0,29,53,12,0,65,237,39,341
5104333,15,0,15,62,32,3,97,227,6,330
5104334,3,0,3,90,34,7,131,210,10,351
5104335,6,0,6,68,28,0,96,240,56,392
5104336,5,0,5,18,15,0,33,271,17,321
5104337,8,0,8,58,13,0,71,381,43,495
5104338,0,7,7,59,16,3,78,175,25,278
5104339,6,0,6,58,20,6,84,236,15,335
5104401,8,0,8,38,30,3,71,173,6,250
5104402,8,0,8,43,26,3,72,256,12,340
5104403,8,0,8,43,9,0,52,156,4,212
5104404,6,0,6,70,13,6,89,254,24,367
5104405,8,0,8,54,38,3,95,254,24,373
5104406,6,3,9,67,20,0,87,176,15,278
5104407,3,0,3,81,34,0,115,264,24,403
5104408,6,3,9,70,33,3,106,278,24,408
5104409,6,0,6,53,18,6,77,171,15,263
5104410,0,3,3,42,20,7,69,137,21,227
5104411,6,3,9,81,14,0,95,265,22,382
5104412,0,0,0,50,22,3,75,153,20,248
5104413,3,0,3,49,14,6,69,201,27,297
5104414,11,0,11,74,30,3,107,198,28,333
5104415,6,3,9,110,34,6,150,347,49,546
5104416,3,0,3,65,17,3,85,251,15,351
5104417,6,3,9,63,21,10,94,152,27,273
5104418,6,0,6,72,27,7,106,184,29,319
5104419,6,0,6,79,37,10,126,258,43,427
5104420,4,0,4,45,11,0,56,198,28,282
5104421,6,3,9,100,31,10,141,278,35,454
5104422,6,0,6,95,46,3,144,271,19,434
5104423,7,3,10,108,42,5,155,279,28,462
5104424,3,0,3,50,21,6,77,179,12,268
5104425,6,0,6,52,13,0,65,179,10,254
5104426,8,0,8,71,21,4,96,266,60,422
5104427,4,0,4,43,21,3,67,183,32,282
5104428,7,0,7,62,26,0,88,246,14,348
5104429,17,4,21,85,33,3,121,345,35,501
5104430,8,0,8,46,23,0,69,219,21,309
5104431,5,0,5,65,27,3,95,177,23,295
5104432,4,0,4,0,0,0,0,4,0,4
5104433,8,3,11,102,31,9,142,364,28,534
5104434,0,0,0,0,0,0,0,0,0,0
5104435,60,0,60,45,13,0,58,248,21,327
5104436,0,0,0,27,17,0,44,157,6,207
5104437,3,3,9,35,12,0,47,103,22,172
5104501,8,3,11,63,24,0,87,173,15,275
5104502,6,0,6,42,26,0,68,153,9,230
5104503,8,0,8,69,41,7,117,248,14,379
5104504,6,0,6,47,20,0,67,251,30,348
5104505,6,6,12,75,21,0,96,293,33,422
5104506,8,0,8,52,29,3,84,190,12,286
5104507,0,0,0,50,24,3,77,198,21,296
5104508,4,0,4,26,24,0,50,181,10,241
5104509,0,3,3,64,27,10,101,209,22,332
5104510,16,0,16,27,15,3,45,178,46,269
5104511,5,0,5,86,36,8,130,333,38,501
5104512,0,0,0,0,3,0,3,24,0,27
5104513,8,0,8,69,26,10,105,248,24,377
5104514,0,0,0,92,12,9,113,171,15,299
5104515,10,0,10,54,24,0,78,245,40,363
5104516,11,0,11,78,22,0,100,214,15,329
5104517,12,0,12,93,31,0,124,296,16,436
5104518,5,0,5,47,9,3,59,138,16,213
5104519,0,0,0,0,0,0,0,0,0,0
5104520,92,10,102,90,35,5,130,408,32,570
5104521,0,0,0,44,21,0,65,187,21,273
5104522,3,0,3,37,16,3,56,164,21,241
5104523,7,0,7,30,18,0,48,159,12,219
5104524,36,6,42,77,23,0,100,343,33,476
5104525,4,0,4,79,16,12,107,247,9,363
5104526,5,3,8,127,25,6,158,341,23,522
5104527,31,30,61,19,4,0,23,224,79,326
5104528,8,0,8,71,23,6,100,283,21,404
5104529,10,0,10,32,10,0,42,199,43,284
5104530,6,0,6,76,31,0,107,306,38,451
5104531,3,0,3,65,18,3,86,172,24,282
5104532,6,0,6,74,16,7,97,258,19,374
5104533,51,0,51,72,18,3,93,265,25,383
5104534,5,0,5,92,25,4,121,266,9,396
5104535,4,0,4,46,17,0,63,190,24,277
5104536,20,0,20,37,22,4,63,191,10,264
5104537,9,3,12,71,37,6,114,342,25,481
5104538,47,11,62,31,8,0,39,252,30,321
5104539,4,3,7,71,18,0,89,190,9,288
5104540,8,0,8,82,19,3,104,204,15,323
5104541,6,0,6,97,24,5,126,215,46,387
5104542,9,0,9,80,20,6,106,201,40,347
5104543,3,0,3,79,14,9,102,245,21,368
5104544,6,0,6,79,17,12,108,206,21,335
5104545,3,0,3,44,7,6,57,204,9,270
5104546,3,3,6,79,27,16,122,234,42,398
5104547,7,0,7,73,14,4,91,226,26,343
5104548,0,0,0,60,19,3,82,181,42,305
5104549,0,0,0,87,34,6,127,386,103,616
5104550,9,3,12,83,12,12,107,206,38,351
5104551,3,0,3,58,13,0,71,189,26,286
5104552,0,3,3,41,15,3,59,137,15,211
5104553,8,0,8,49,18,0,67,153,29,249
5104601,0,0,0,28,9,0,37,193,25,255
5104602,0,3,3,70,29,0,99,380,49,528
5104603,0,0,0,33,23,0,56,180,13,249
5104604,6,0,6,43,31,6,80,214,20,314
5104605,4,0,4,70,39,3,112,285,39,436
5104606,0,0,0,93,28,3,124,200,24,348
5104607,0,0,0,73,20,6,99,137,28,264
5104608,0,0,0,0,0,0,0,0,3,3
5104609,3,4,7,63,32,4,99,321,46,466
5104610,71,0,71,34,12,0,46,415,40,501
5104611,3,0,3,41,6,0,47,228,40,315
5104612,0,0,0,54,12,0,66,210,27,303
5104613,5,3,8,43,22,0,65,264,33,362
5104614,4,0,4,53,17,0,70,375,59,504
5104615,3,6,9,45,6,3,54,285,45,384
5104616,9,3,12,63,30,0,93,359,36,488
5104617,0,3,3,50,17,0,67,266,31,364
5104618,3,6,9,56,21,3,80,233,41,354
5104619,4,3,7,34,8,3,45,200,53,298
5104620,7,4,11,38,6,3,47,236,32,315
5104621,6,6,12,64,16,3,83,412,68,563
5104622,4,0,4,79,9,0,88,348,78,514
5104623,11,0,11,68,25,6,99,414,80,593
5104624,4,0,4,45,7,6,58,246,30,334
5104625,3,0,3,61,12,6,79,288,57,424
5104626,6,0,6,99,24,0,123,298,46,467
5104627,9,6,15,69,32,3,104,284,41,429
5104628,3,0,3,63,24,3,90,342,44,476
5104701,3,0,3,75,50,6,131,199,29,359
5104702,3,0,3,67,35,0,102,244,15,361
5104703,8,0,8,49,20,6,75,247,11,333
5104704,0,0,0,61,20,6,87,232,9,328
5104705,15,3,18,85,32,0,117,239,48,404
5104706,3,0,3,68,38,6,112,233,20,365
5104707,3,0,3,55,29,0,84,291,21,396
5104708,4,0,7,63,35,9,107,226,24,357
5104709,3,0,3,93,38,0,131,371,30,532
5104710,7,0,7,56,15,0,71,177,9,257
5104711,13,6,19,58,27,0,85,301,28,414
5104712,5,0,5,70,25,6,101,261,34,396
5104713,9,3,12,72,24,3,99,292,61,452
5104714,5,3,8,31,22,12,65,214,20,299
5104715,0,0,0,0,0,0,0,0,0,0
5104716,7,0,7,45,20,3,68,228,46,342
5104717,12,0,12,65,27,3,95,302,32,429
5104718,3,0,3,71,20,0,91,254,4,349
5104719,10,0,10,38,16,0,54,142,6,202
5104720,0,0,0,45,23,0,68,215,18,301
5104721,5,4,9,42,24,3,69,241,40,350
5104722,6,0,6,63,31,3,97,240,9,346
5104723,12,3,15,73,20,0,93,242,25,360
5104724,0,0,0,52,14,6,72,211,22,305
5104725,17,0,20,40,30,9,79,238,19,336
5104726,6,4,10,73,37,0,110,325,35,470
5104727,3,0,8,85,27,0,112,347,35,494
5104728,3,0,3,71,26,0,97,253,17,367
5104729,6,0,6,62,27,9,98,309,40,447
5104730,6,3,9,56,22,0,78,216,15,309
5104731,3,0,3,45,12,3,60,160,18,238
5104732,4,0,4,82,43,0,125,300,31,456
5104733,4,0,4,89,44,0,133,356,41,530
5104734,6,0,6,71,18,0,89,212,21,322
5104735,6,3,9,103,48,0,151,339,34,524
5104736,0,0,0,67,23,3,93,256,11,360
5104737,9,0,12,81,47,6,134,250,21,405
5104738,5,0,5,106,30,3,139,308,30,477
5104739,6,6,12,91,37,6,134,265,26,425
5104740,10,0,10,64,24,6,94,222,23,339
5104741,6,0,6,80,54,0,134,320,37,491
5104742,3,0,3,64,25,0,89,266,19,374
5104743,0,5,5,87,39,4,130,320,38,488
5104744,49,9,58,43,29,3,75,318,22,415
5104745,4,0,4,81,14,3,98,203,30,331
5104801,0,0,0,0,0,0,0,0,0,0
5104802,6,0,6,106,48,9,163,278,30,471
5104803,41,0,41,61,26,3,90,266,27,383
5104804,3,0,3,48,21,0,69,210,14,293
5104805,3,0,3,61,23,3,87,214,9,310
5104806,3,3,6,67,30,3,100,283,21,404
5104807,14,0,14,96,46,3,145,280,21,446
5104808,6,5,11,53,34,5,92,343,5,440
5104809,3,0,3,84,31,0,115,270,22,407
5104810,3,3,6,40,17,0,57,212,10,279
5104811,6,3,9,74,34,0,108,261,24,393
5104812,4,0,4,60,15,5,80,270,13,363
5104813,7,0,7,39,24,0,63,133,0,196
5104814,0,0,0,45,29,0,74,159,0,233
5104815,6,0,6,85,31,0,116,256,20,392
5104816,0,0,0,48,40,0,88,197,12,297
5104817,10,0,10,66,23,0,89,290,22,401
5104818,4,0,7,27,31,0,58,171,15,244
5104819,3,3,6,49,30,3,82,217,22,321
5104820,6,0,6,54,24,0,78,137,6,221
5104821,5,0,5,40,21,3,64,151,15,230
5104901,3,0,3,58,13,0,71,160,29,260
5104902,0,0,0,60,20,0,80,140,21,241
5104903,0,0,0,31,6,0,37,90,6,133
5104904,6,0,6,60,26,4,90,170,10,270
5104905,0,0,0,13,0,0,13,32,1385,1430
5104906,0,0,0,33,21,9,63,187,18,268
5104907,6,0,6,69,32,9,110,199,10,319
5104908,0,0,0,56,21,3,80,200,9,289
5104909,0,0,0,9,9,6,24,19,9,52
5104910,0,3,3,25,22,0,47,116,25,188
5104911,0,0,0,10,0,0,10,23,3,36
5105001,0,0,0,73,12,0,85,143,13,241
5105002,8,0,8,47,28,3,78,148,38,264
5105003,0,0,0,0,0,0,0,0,0,0
5105004,7,0,7,65,28,5,98,179,12,289
5105005,0,0,0,63,23,3,89,196,5,290
5105006,3,0,3,72,32,3,107,220,15,342
5105007,6,0,6,54,16,0,70,165,25,260
5105008,3,0,3,60,20,3,83,178,11,272
5105009,6,0,6,55,13,7,75,147,10,232
5105010,3,0,3,76,40,4,120,212,27,359
5105011,0,0,0,52,24,0,76,177,9,262
5105012,0,0,0,51,31,3,85,164,14,263
5105013,7,0,7,96,41,12,149,242,21,412
5105014,3,0,3,47,28,4,79,163,5,247
5105015,8,0,8,90,58,9,157,279,24,460
5105016,6,0,6,27,24,4,55,149,3,207
5105017,0,0,0,32,18,0,50,80,6,136
5105018,0,5,5,95,37,3,135,207,35,377
5105019,3,0,3,59,14,3,76,154,29,259
5105020,4,0,4,93,38,11,142,263,52,457
5105101,4,3,7,48,29,3,80,143,18,241
5105102,3,0,3,157,49,13,219,362,29,610
5105103,3,0,3,42,29,3,74,138,28,240
5105104,0,0,0,68,36,3,107,217,63,387
5105105,5,0,5,75,31,6,112,271,42,425
5105106,5,0,5,62,32,6,100,200,21,321
5105107,6,0,6,50,21,3,74,197,14,285
5105108,3,3,6,63,41,10,114,227,23,364
5105109,0,0,0,65,19,9,93,145,14,252
5105110,6,0,6,134,51,3,188,349,38,575
5105201,0,0,0,0,6,0,6,3,6,15
5105301,4,0,4,61,25,4,90,193,27,310
5105302,0,0,0,46,15,6,67,156,6,229
5105303,0,0,0,136,29,13,178,228,18,424
5105304,3,0,3,108,26,11,145,189,18,352
5105305,6,0,6,95,52,3,150,314,30,494
5105306,0,3,3,18,10,6,34,83,18,135
5105307,0,0,0,34,16,4,54,99,35,188
5105308,0,0,0,83,26,9,118,209,21,348
5105309,0,0,0,47,13,0,60,127,11,198
5105310,0,0,0,40,21,0,61,141,43,245
5105311,3,0,3,66,17,6,89,122,4,215
5105312,5,0,5,85,28,11,124,183,15,322
5105313,0,0,0,41,10,0,51,109,7,167
5105314,6,3,9,88,59,3,150,276,18,444
5105315,0,0,0,4,0,0,4,25,3,32
5105316,0,3,3,72,26,3,101,195,21,317
5105317,0,0,0,94,22,10,126,187,27,340
5105318,0,0,0,54,12,9,75,134,19,228
5105319,0,3,3,60,23,0,83,135,30,248
5105320,6,0,6,66,15,9,90,144,6,240
5105321,3,3,6,69,25,0,94,189,18,301
5105322,0,0,0,77,26,6,109,178,22,309
5105323,6,0,6,80,20,3,103,199,9,311
5105324,3,0,3,114,35,3,152,214,16,382
5105325,0,0,0,61,16,9,86,170,11,267
5105326,0,0,0,27,20,0,47,144,27,218
5105327,0,0,0,37,5,6,48,114,18,180
5105328,3,0,3,43,28,3,74,113,28,215
5105329,3,5,8,74,19,4,97,201,19,317
5105330,3,0,3,41,10,0,51,98,12,161
5105331,6,3,9,46,23,4,73,193,28,294
5105332,0,0,0,0,0,0,0,3,0,3
5105333,0,0,0,27,16,0,43,94,9,146
5105334,3,0,3,50,31,9,90,161,22,273
5105335,11,3,14,66,34,6,106,298,36,440
5105336,3,0,3,25,6,6,37,142,8,187
5105337,21,44,65,26,28,3,57,217,74,348
5105338,4,0,4,47,24,4,75,115,9,199
5105401,3,0,3,48,34,0,82,172,12,266
5105402,21,4,25,20,12,3,35,143,25,203
5105403,0,0,0,85,30,4,119,220,34,373
5105404,3,0,3,84,33,4,121,221,22,364
5105405,0,3,3,45,9,0,54,153,26,233
5105406,6,0,6,22,12,0,34,128,13,175
5105407,0,0,0,88,40,3,131,307,26,464
5105408,0,0,0,71,49,7,127,242,21,390
5105409,5,0,5,46,35,11,92,230,21,343
5105410,13,9,22,17,8,0,25,154,26,205
5105411,0,0,0,58,36,9,103,195,17,315
5105412,5,0,8,28,21,0,49,147,17,213
5105413,6,3,9,58,16,0,74,194,36,304
5105414,0,0,0,25,15,3,43,146,15,204
5105415,6,0,6,66,46,0,112,316,35,463
5105416,13,3,16,43,39,0,82,275,35,392
5105417,6,3,12,33,22,6,61,184,40,285
5105418,3,0,3,25,20,0,45,169,3,217
5105419,9,0,9,71,29,3,103,231,19,353
5105420,0,0,0,63,28,0,91,197,21,309
5105421,56,8,64,46,38,6,90,293,33,416
5105422,0,9,9,68,29,6,103,191,24,318
5105423,3,0,3,81,33,6,120,243,14,377
5105424,0,0,0,45,23,11,79,137,12,228
5105425,6,0,6,67,31,6,104,215,25,344
5105426,6,0,6,75,30,0,105,241,23,369
5105427,7,0,7,81,39,0,120,266,30,416
5105428,3,0,6,77,33,6,116,256,39,411
5105429,3,0,3,49,17,0,66,102,52,220
5105430,4,3,7,47,20,0,67,166,24,257
5105431,4,0,4,26,6,0,32,105,30,167
5105432,4,0,4,43,27,0,70,160,27,257
5105501,0,0,0,0,0,0,0,0,0,0
5105601,0,0,0,51,14,0,65,74,9,148
5105602,0,3,3,70,15,0,85,147,29,261
5105603,0,0,0,51,19,0,70,156,12,238
5105604,3,0,3,56,9,0,65,98,11,174
5105605,3,0,3,41,26,0,67,243,27,337
5105606,5,0,5,33,16,0,49,165,16,230
5105607,6,0,6,73,31,6,110,280,27,417
5105608,0,0,0,104,24,3,131,291,21,443
5105609,6,0,6,39,9,6,54,106,9,169
5105610,3,0,3,62,10,3,75,179,33,287
5105611,0,0,0,48,21,0,69,158,14,241
5105612,0,3,3,51,14,3,68,138,21,227
5105613,4,0,4,95,25,3,123,275,22,420
5105614,3,0,3,91,11,5,107,188,31,326
5105615,0,0,0,66,8,3,77,125,15,217
5105616,0,0,0,83,17,0,100,204,18,322
5105617,3,0,3,77,17,4,98,179,7,284
5105618,0,0,3,63,24,6,93,232,12,337
5105619,3,0,3,99,20,9,128,304,29,461
5105620,0,0,0,77,27,4,108,181,15,304
5105621,0,0,0,69,23,0,92,165,10,267
5105622,0,0,0,60,25,6,91,221,15,327
5105623,0,0,0,73,30,6,109,220,13,342
5105624,3,0,3,54,3,0,57,128,15,200
5105625,3,0,3,74,19,0,93,229,23,345
5105626,3,0,3,60,18,3,81,220,35,336
5105627,3,0,3,70,15,6,91,220,18,329
5105628,0,0,0,94,26,12,132,248,4,384
5105629,0,0,0,71,15,0,86,214,39,339
5105630,0,0,0,54,15,0,69,157,27,253
5105631,0,3,3,76,40,0,116,163,27,306
5105632,3,0,3,10,3,3,16,69,6,91
5105633,0,0,0,67,28,0,95,225,17,337
5105634,0,0,0,68,26,3,97,182,12,291
5105635,3,0,3,57,35,0,92,223,3,318
5105636,0,0,0,55,22,0,77,185,13,275
5105637,3,3,6,104,29,3,136,283,28,447
5105638,0,0,0,55,17,3,75,163,15,253
5105639,0,0,0,63,21,3,87,183,9,279
5105640,4,0,4,58,20,4,82,165,18,265
5105641,0,0,0,101,38,9,148,275,21,444
5105642,0,0,0,59,18,4,81,208,18,307
5105643,0,0,0,63,19,4,86,153,6,245
5105644,0,0,0,33,12,6,51,130,12,193
5105645,0,0,0,85,21,0,106,163,25,294
5105646,0,0,0,120,39,3,162,293,36,491
5105647,6,0,6,56,21,0,77,178,21,276
5105648,0,0,0,80,21,3,104,249,9,362
5105649,0,4,4,38,12,0,50,119,14,183
5105650,0,0,0,0,0,0,0,0,0,0
5105651,0,0,0,63,17,0,80,195,9,284
5105701,0,0,0,46,12,0,58,114,20,192
5105702,6,5,11,91,40,0,131,224,44,399
5105703,4,0,4,75,24,3,102,209,30,341
5105704,0,0,0,90,18,6,114,177,19,310
5105705,0,0,0,141,35,6,182,300,27,509
5105706,0,4,4,179,27,7,213,312,39,564
5105707,3,0,3,65,18,0,83,193,24,300
5105708,3,0,3,108,18,6,132,254,51,437
5105709,0,0,0,0,0,0,0,0,0,0
5105710,3,0,3,73,21,3,97,275,26,398
5105711,0,0,0,28,15,0,43,148,26,217
5105712,0,0,0,53,11,0,64,152,13,229
5105713,3,0,3,66,18,4,88,159,22,269
5105714,4,3,7,97,27,12,136,332,32,500
5105715,0,0,0,62,44,0,106,241,24,371
5105716,7,0,7,69,23,0,92,260,24,376
5105717,5,0,5,79,31,3,113,200,33,346
5105718,0,0,0,63,17,4,84,253,45,382
5105719,3,0,3,87,28,3,118,233,27,378
5105720,6,0,6,87,24,4,115,260,26,401
5105721,0,0,0,64,11,0,75,145,24,244
5105722,0,0,0,76,17,0,93,185,18,296
5105723,6,0,6,81,47,0,128,285,10,423
5105724,3,0,3,116,29,4,149,232,37,418
5105725,0,0,0,104,16,3,123,231,37,391
5105726,5,0,5,183,30,7,220,385,37,642
5105727,3,8,11,84,38,4,126,301,34,461
5105728,3,0,3,28,15,6,49,159,12,220
5105729,3,6,9,109,26,12,147,295,30,472
5105730,0,3,3,62,25,5,92,201,41,334
5105731,0,0,0,29,11,0,40,84,224,348
5105732,6,0,6,41,24,0,65,221,52,338
5105733,9,0,9,66,37,0,103,243,50,396
5105801,0,0,0,0,0,0,0,5,0,5
5105802,3,0,3,72,24,3,99,184,16,299
5105803,6,3,9,139,26,8,173,287,48,508
5105804,3,0,3,29,15,0,44,115,6,165
5105805,3,0,3,32,9,0,41,100,25,166
5105806,0,0,0,28,3,3,34,74,22,130
5105807,0,0,0,35,10,0,45,83,17,145
5105808,6,0,6,60,19,0,79,228,26,333
5105809,0,0,0,108,18,6,132,262,23,417
5105810,0,0,0,82,19,0,101,191,15,307
5105811,0,0,0,72,22,0,94,219,35,348
5105812,0,0,0,43,21,4,68,143,13,224
5105813,0,0,0,81,13,6,100,205,31,336
5105901,0,0,0,211,31,11,253,383,36,672
5105902,0,0,0,131,21,9,161,169,9,339
5105903,0,0,0,157,39,3,199,250,19,468
5105904,0,0,0,222,33,16,271,269,22,562
5105905,0,0,0,71,17,6,94,122,8,224
5105906,0,0,0,70,15,3,88,98,9,195
5105907,0,0,0,0,0,0,0,0,0,0
5105908,3,0,3,21,9,0,30,37,0,67
5105909,0,0,0,98,36,4,138,169,25,332
5105910,68,6,74,38,20,3,61,346,24,431
5105911,0,0,0,10,4,0,14,77,0,91
5105912,3,0,3,44,7,3,54,150,23,227
5105913,6,0,6,57,23,4,84,157,18,259
5105914,0,0,0,44,22,0,66,138,18,222
5105915,0,0,0,110,18,7,135,143,13,291
5105916,3,0,3,58,11,6,75,121,12,208
5105917,0,0,0,73,20,0,93,153,11,257
5105918,0,0,0,85,25,0,110,142,18,270
5105919,3,0,3,80,14,0,94,144,6,244
5105920,0,0,0,123,23,6,152,202,22,376
5105921,0,0,0,74,19,3,96,98,15,209
5105922,0,0,0,100,32,6,138,131,15,284
5105923,0,0,0,146,17,0,163,166,25,354
5105924,0,0,0,138,45,0,183,201,10,394
5105925,0,0,0,63,3,5,71,91,0,162
5105926,3,0,3,114,23,12,149,198,18,365
5105927,0,0,0,77,17,3,97,93,10,200
5105928,3,0,3,41,7,6,54,62,10,126
5105929,0,0,0,65,4,0,69,75,6,150
5105930,0,0,0,47,24,4,75,135,0,210
5105931,0,0,0,179,40,8,227,251,53,531
5105932,0,0,0,96,22,9,127,162,27,316
5105933,0,0,0,110,21,7,138,204,23,365
5105934,0,0,0,106,22,7,135,122,43,300
5105935,8,0,8,0,17,0,17,123,12,152
5105936,0,0,0,80,13,3,96,67,6,169
5105937,0,0,0,184,32,5,221,215,35,471
5105938,0,0,0,107,14,5,126,140,5,271
5105939,0,0,0,67,9,0,76,88,0,164
5105940,0,0,0,100,29,5,134,181,13,328
5105941,0,0,0,131,30,3,164,149,5,318
5105942,0,0,0,80,21,6,107,144,15,266
5105943,0,0,0,83,24,0,107,167,17,291
5105944,0,0,0,77,39,3,119,117,24,260
5105945,0,0,0,105,17,7,129,131,20,280
5105946,3,0,3,111,22,4,137,168,15,320
5105947,3,0,3,48,11,0,59,65,3,127
5105948,0,0,0,79,15,3,97,117,15,229
5105949,4,0,4,126,24,3,153,213,8,374
5105950,0,0,0,154,24,9,187,247,32,466
5105951,0,0,0,0,0,0,0,0,0,0
5105952,0,0,0,78,12,3,93,121,18,232
5105953,0,0,0,127,24,12,163,171,33,367
5105954,0,0,0,73,12,6,91,172,9,272
5105955,0,0,0,45,12,9,66,108,6,180
5105956,3,0,3,130,24,3,157,212,24,393
5105957,0,0,0,78,12,9,99,122,6,227
5105958,0,0,0,171,41,12,224,257,26,507
5105959,0,0,0,104,16,3,123,98,4,225
5106001,3,0,3,27,17,4,48,140,19,207
5106002,0,0,0,53,10,3,66,148,15,229
5106003,3,0,3,34,20,3,57,116,20,193
5106004,0,0,0,44,20,10,74,153,22,249
5106005,3,0,3,102,16,10,128,212,33,373
5106006,0,0,0,66,9,0,75,160,21,256
5106007,3,0,3,40,20,0,60,129,29,218
5106008,0,0,0,51,18,12,81,193,18,292
5106101,0,0,0,62,25,4,91,200,12,303
5106102,3,0,3,167,33,6,206,338,59,603
5106103,0,0,0,0,0,0,0,3,0,3
5106104,4,0,4,15,21,0,36,190,25,251
5106105,0,0,0,132,25,6,163,297,37,497
5106106,0,0,0,0,0,0,0,0,0,0
5106107,11,5,16,68,33,4,105,290,27,422
5106108,3,0,3,59,21,7,87,221,25,333
5106109,0,0,0,89,28,4,121,198,9,328
5106110,3,4,7,33,17,0,50,118,4,172
5106201,0,0,0,51,23,3,77,150,22,249
5106202,0,0,0,44,22,0,66,121,23,210
5106203,0,0,0,58,22,6,86,158,23,267
5106204,5,0,5,99,13,3,115,195,12,322
5106205,0,0,0,91,24,3,118,213,32,363
5106206,0,0,0,71,9,3,83,120,3,206
5106207,0,3,3,36,21,0,57,197,33,287
5106208,3,0,3,29,20,0,49,151,27,227
5106209,0,0,0,98,26,0,124,221,24,369
5106210,3,0,3,56,10,3,69,124,32,225
5106211,0,0,0,53,6,0,59,154,32,245
5106212,5,0,5,63,21,0,84,218,22,324
5106213,0,0,0,73,20,3,96,179,15,290
5106214,6,0,6,44,17,0,61,150,19,230
5106215,3,0,3,84,25,6,115,316,59,490
5106216,0,0,0,108,27,8,143,316,13,472
5106217,3,0,3,125,42,0,167,335,24,526
5106218,4,0,4,69,34,0,103,245,29,377
5106219,0,0,0,31,13,3,47,116,15,178
5106220,5,0,5,87,30,0,117,306,40,463
5106301,0,0,0,0,0,0,0,13,0,13
5106401,0,0,0,0,0,0,0,4,0,4
5106501,0,0,0,0,0,0,0,24,0,24
5106502,5,0,5,48,25,3,76,203,21,300
5106503,3,0,3,43,26,0,69,190,35,294
5106504,0,0,0,49,20,4,73,159,13,245
5106505,3,3,6,77,26,3,106,270,79,455
5106506,4,0,4,22,18,0,40,141,97,278
5106507,6,0,6,39,30,0,69,178,26,273
5106508,7,4,11,99,25,6,130,294,40,464
5106509,6,3,9,55,31,3,89,213,45,347
5106510,0,0,0,9,9,0,18,43,30,91
5106511,3,0,3,68,24,6,98,202,33,333
5106512,0,0,0,98,38,3,139,247,38,424
5106513,8,3,11,85,32,9,126,346,44,516
5106514,0,0,0,30,29,0,59,135,21,215
5106601,4,0,4,55,12,0,67,197,47,311
5106602,7,6,13,31,9,0,40,143,40,223
5106603,62,0,62,43,22,0,65,342,68,475
5106604,8,0,8,48,19,0,67,276,28,371
5106605,9,63,72,46,19,0,65,278,149,492
5106606,8,3,11,53,25,0,78,250,25,353
5106607,14,0,14,49,23,6,78,288,28,394
5106608,12,0,12,96,36,6,138,408,74,620
5106609,29,0,29,60,21,0,81,380,84,545
5106610,43,0,43,24,11,0,35,173,8,216
5106611,8,0,8,32,15,6,53,151,4,208
5106612,3,3,6,97,49,14,160,317,59,536
5106613,11,0,11,58,31,3,92,215,43,350
5106614,6,3,9,44,19,0,63,211,49,323
5106615,18,4,22,110,39,8,157,375,24,556
5106616,8,0,8,37,16,0,53,164,13,230
5106617,0,0,0,9,0,0,9,47,12,68
5106618,0,4,4,15,6,0,21,132,43,196
5106619,10,3,13,69,21,0,90,242,70,402
5106620,0,0,0,68,21,3,92,267,27,386
5106621,4,3,7,116,41,7,164,346,43,553
5106622,3,0,3,60,27,7,94,221,20,335
5106701,3,0,3,107,21,9,137,267,32,436
5106702,0,0,0,66,17,10,93,164,52,309
5106703,4,0,4,69,17,0,86,128,10,224
5106704,0,0,0,90,31,0,121,205,15,341
5106705,0,0,0,85,21,4,110,210,12,332
5106706,0,0,0,47,12,9,68,138,18,224
5106707,0,0,0,61,19,0,80,72,3,155
5106708,0,0,0,99,24,4,127,159,6,292
5106709,0,0,0,126,33,3,162,184,9,355
5106710,0,0,0,16,10,3,29,41,4,74
5106711,4,0,4,82,24,3,109,166,29,304
5106712,0,0,0,75,20,7,102,165,15,282
5106713,0,0,0,79,20,0,99,184,27,310
5106714,0,0,0,52,18,6,76,113,17,206
5106715,0,0,0,81,17,0,98,198,43,339
5106716,0,0,0,137,57,12,206,217,27,450
5106717,4,0,4,61,23,0,84,99,6,189
5106718,0,0,0,0,0,0,0,0,0,0
5106719,0,0,0,0,0,0,0,0,0,0
5106720,3,0,3,44,15,0,59,129,0,188
5106801,0,0,0,37,9,0,46,109,18,173
5106802,0,0,0,59,15,3,77,114,15,206
5106803,3,0,3,46,21,4,71,151,21,243
5106804,0,0,0,93,30,0,123,180,18,321
5106805,0,0,0,100,21,6,127,88,15,230
5106806,0,0,0,193,25,9,227,295,13,535
5106807,3,0,3,75,44,6,125,251,37,413
5106808,0,0,0,49,16,0,65,152,12,229
5106809,0,0,0,114,37,10,161,337,17,515
5106810,3,3,6,28,17,0,45,105,15,165
5106811,6,0,6,54,18,0,72,220,13,305
5106812,3,0,3,44,17,0,61,126,21,208
5106813,0,0,0,87,35,0,122,232,18,372
5106814,4,0,4,55,28,0,83,227,23,333
5106901,0,0,0,0,0,0,0,0,0,0
5107001,3,0,3,52,13,3,68,98,17,183
5107002,0,0,0,79,24,3,106,237,24,367
5107003,0,0,0,39,15,0,54,150,6,210
5107004,4,0,4,63,24,6,93,210,20,323
5107005,3,0,3,91,22,0,113,253,24,390
5107006,0,0,0,65,28,4,97,227,13,337
5107007,3,0,3,87,39,3,129,299,23,451
5107008,13,3,16,100,45,11,156,288,40,484
5107009,0,0,0,57,19,0,76,177,26,279
5107010,0,0,0,45,24,4,73,150,16,239
5107011,0,0,0,40,17,3,60,200,22,282
5107012,3,0,3,68,25,6,99,202,18,319
5107013,0,0,0,55,20,0,75,169,21,265
5107014,7,4,11,111,34,4,149,309,29,487
5107015,7,3,10,123,46,5,174,315,27,516
5107016,4,0,4,96,50,0,146,283,30,459
5107017,6,0,6,85,23,3,111,209,14,334
5107018,0,0,0,99,35,0,134,291,23,448
5107019,3,3,6,46,19,3,68,151,24,243
5107020,3,0,3,88,30,7,125,197,34,356
5107021,6,0,6,65,20,4,89,203,18,310
5107022,3,0,3,73,15,0,88,219,15,322
5107023,0,0,0,0,0,0,0,0,0,0
5107024,0,0,0,45,12,3,60,117,17,194
5107101,3,3,6,93,31,0,124,194,3,321
5107102,0,0,0,116,18,5,139,137,3,279
5107103,0,3,3,66,8,7,81,214,15,310
5107104,0,0,0,74,12,9,95,152,4,251
5107105,3,0,3,107,33,3,143,277,18,438
5107106,26,0,26,41,11,4,56,114,3,173
5107107,0,0,0,82,35,3,120,214,30,364
5107108,0,0,0,60,13,6,79,200,18,297
5107109,0,0,0,65,15,3,83,99,13,195
5107110,3,0,6,97,19,3,119,232,14,365
5107111,3,0,3,60,11,4,75,174,4,253
5107112,0,0,0,80,28,4,112,178,22,312
5107113,3,0,3,80,24,0,104,225,13,342
5107114,0,0,0,122,17,0,139,216,11,366
5107115,0,0,0,73,27,0,100,149,21,270
5107116,0,0,0,118,36,10,164,282,8,454
5107117,0,3,3,100,33,11,144,219,22,385
5107118,0,0,0,100,32,7,139,387,20,546
5107119,0,0,0,83,19,12,114,167,6,287
5107120,3,0,3,84,26,0,110,157,3,270
5107121,0,0,0,69,13,3,85,134,10,229
5107122,0,0,0,97,34,10,141,178,12,331
5107123,3,0,3,128,34,4,166,242,10,418
5107124,0,0,0,137,22,3,162,252,12,426
5107125,0,0,0,0,0,0,0,0,0,0
5107126,0,0,0,82,24,0,106,202,5,313
5107127,0,3,3,109,24,6,139,153,9,301
5107128,0,0,0,65,16,0,81,200,9,290
5107129,3,0,3,69,18,9,96,219,3,318
5107130,0,0,0,55,18,3,76,170,12,258
5107131,0,0,0,49,17,3,69,125,3,197
5107132,0,0,0,88,19,3,110,223,13,346
5107133,0,0,0,3,6,0,9,20,6,35
5107134,0,0,0,109,27,0,136,231,11,378
5107135,0,0,0,118,23,5,146,254,18,418
5107201,4,0,4,51,13,4,68,125,3,196
5107202,6,0,6,42,12,3,57,96,6,159
5107203,3,3,6,52,23,0,75,140,18,233
5107204,4,0,4,117,38,6,161,295,14,470
5107205,4,0,4,117,47,21,185,340,18,543
5107206,0,0,0,89,29,3,121,311,11,443
5107207,0,0,3,71,37,4,112,239,13,364
5107208,6,3,9,48,33,3,84,187,19,290
5107209,34,0,34,53,36,6,95,213,12,320
5107210,4,0,4,94,31,6,131,176,6,313
5107211,6,3,9,51,10,0,61,121,15,197
5107212,4,3,7,79,29,9,117,221,6,344
5107213,0,0,0,91,44,3,138,308,12,458
5107214,83,10,93,55,26,6,87,422,35,544
5107215,3,0,3,116,51,7,174,352,22,548
5107216,10,0,10,108,40,9,157,309,19,485
5107217,4,0,4,93,22,11,126,262,10,398
5107218,6,0,6,59,31,3,93,227,6,326
5107219,6,3,9,73,43,9,125,260,12,397
5107220,9,3,12,86,28,11,125,223,15,363
5107221,6,0,6,34,12,6,52,116,3,171
5107222,0,0,0,53,26,8,87,131,0,218
5107223,0,0,0,110,24,10,144,256,12,412
5107224,6,3,9,93,37,4,134,256,26,416
5107225,0,0,0,76,30,0,106,219,12,337
5107226,5,0,5,88,36,10,134,247,14,395
5107227,10,0,10,80,37,3,120,219,20,359
5107228,0,0,0,105,55,3,163,283,14,460
5107229,0,0,0,39,36,4,79,131,7,217
5107230,6,0,6,37,31,0,68,142,15,225
5107231,0,0,0,113,46,3,162,257,28,447
5107232,3,0,3,112,41,4,157,212,20,389
5107233,5,0,5,88,25,3,116,224,6,346
5107234,3,3,6,76,28,3,107,163,9,279
5107301,6,0,6,73,34,9,116,244,18,378
5107302,0,0,0,87,27,3,117,183,12,312
5107303,3,0,3,60,31,3,94,237,10,341
5107304,6,3,9,83,51,3,137,230,15,382
5107305,3,0,3,69,28,0,97,238,33,368
5107306,0,0,0,47,10,0,57,135,9,201
5107307,0,0,0,69,20,3,92,155,10,257
5107308,4,0,4,93,32,6,131,277,16,424
5107309,0,3,3,56,23,8,87,142,7,236
5107310,6,3,9,96,48,0,144,299,21,464
5107311,0,0,0,93,45,5,143,271,30,444
5107312,5,0,5,44,28,4,76,110,9,195
5107313,0,0,0,61,20,6,87,78,4,169
5107314,6,0,6,90,40,7,137,229,13,379
5107315,0,0,0,85,30,7,122,143,9,274
5107316,0,0,0,46,54,9,109,182,7,298
5107317,7,3,10,73,50,6,129,260,31,420
5107318,6,0,6,54,29,9,92,172,9,273
5107319,81,6,87,67,52,0,119,338,21,478
5107320,0,0,0,77,34,3,114,222,18,354
5107321,13,0,13,87,30,6,123,340,26,489
5107322,0,0,0,41,24,3,68,106,15,189
5107323,0,3,3,48,37,3,88,216,30,334
5107324,5,0,5,65,30,0,95,187,6,288
5107325,3,0,3,42,21,6,69,152,12,233
5107326,3,5,8,69,31,4,104,173,13,290
5107327,6,0,6,57,34,7,98,201,12,311
5107328,3,0,3,57,34,4,95,163,12,270
5107329,4,0,4,51,31,0,82,169,7,258
5107330,3,0,3,58,28,0,86,134,17,237
5107331,3,0,3,55,38,3,96,282,3,381
5107332,3,3,6,32,32,3,67,202,12,281
5107333,0,0,0,0,0,0,0,0,0,0
5107334,4,0,4,44,13,3,60,195,21,276
5107335,0,0,0,90,43,6,139,284,25,448
5107401,6,0,6,70,21,3,94,224,12,330
5107402,4,0,4,74,34,0,108,311,15,434
5107403,0,0,0,103,33,8,144,237,10,391
5107404,8,0,8,128,35,0,163,354,17,534
5107405,3,0,3,97,46,0,143,273,24,440
5107406,0,0,0,53,28,4,85,239,15,339
5107407,3,0,3,63,24,7,94,140,6,240
5107408,3,0,3,51,27,3,81,267,27,375
5107409,3,6,9,76,26,0,102,323,46,471
5107410,3,0,3,49,25,9,83,169,13,265
5107411,3,0,3,72,25,3,100,223,21,344
5107412,3,0,3,108,42,4,154,382,48,584
5107413,0,0,0,52,27,9,88,213,15,316
5107414,3,0,3,109,34,4,147,291,18,456
5107415,0,0,0,74,30,10,114,254,18,386
5107416,0,6,6,169,16,10,195,318,30,543
5107417,0,0,0,95,25,7,127,243,28,398
5107418,6,0,6,81,27,5,113,207,19,339
5107419,3,0,3,85,36,8,129,272,19,420
5107420,0,0,0,74,23,0,97,248,15,360
5107421,6,3,9,73,53,3,129,305,25,459
5107501,0,0,0,116,48,7,171,261,13,445
5107502,0,0,0,72,13,0,85,206,14,305
5107503,0,0,0,70,19,3,92,188,15,295
5107504,0,0,0,81,27,4,112,305,23,440
5107505,0,0,0,60,21,5,86,146,15,247
5107506,3,0,3,105,48,9,162,281,24,467
5107507,5,0,5,49,18,6,73,136,16,225
5107508,0,0,0,67,18,0,85,188,17,290
5107509,4,0,4,71,25,3,99,207,15,321
5107510,3,0,3,108,55,0,163,378,19,560
5107511,0,0,0,81,26,0,107,306,24,437
5107512,3,0,3,86,48,3,137,234,38,409
5107513,5,0,5,94,37,12,143,295,22,460
5107514,4,5,9,59,38,0,97,258,22,377
5107515,12,0,12,77,58,0,135,302,24,461
5107516,6,0,6,91,20,0,111,205,6,322
5107517,0,0,0,45,21,0,66,122,3,191
5107518,0,0,0,90,22,5,117,241,6,364
5107519,0,0,0,46,19,4,69,100,15,184
5107520,3,0,3,142,42,3,187,364,18,569
5107521,0,0,0,78,28,3,109,232,20,361
5107522,0,0,0,78,47,0,125,296,11,432
5107523,8,0,8,88,36,3,127,235,6,368
5107601,0,0,0,58,11,0,69,201,9,279
5107602,3,0,3,85,22,7,114,179,12,305
5107603,0,0,0,89,20,9,118,236,15,369
5107604,3,0,3,74,27,3,104,226,21,351
5107605,9,0,9,269,42,19,330,552,29,911
5107606,0,0,0,51,8,4,63,126,6,195
5107607,0,0,0,53,15,0,68,168,5,241
5107608,0,0,3,118,44,3,165,293,15,473
5107609,0,0,0,129,22,4,155,266,4,425
5107610,3,0,3,355,100,15,470,689,38,1197
5107701,0,0,0,0,3,0,3,0,0,3
5107702,3,0,3,29,28,3,60,176,12,248
5107703,0,0,0,39,34,0,73,301,11,385
5107704,8,4,12,43,25,0,68,328,85,481
5107705,13,9,22,32,13,0,45,231,59,335
5107706,4,0,4,59,43,4,106,193,16,315
5107707,0,0,0,56,32,3,91,168,27,286
5107708,8,0,8,78,45,0,123,292,30,445
5107709,0,0,0,47,15,3,65,99,3,167
5107710,0,0,0,88,6,9,103,187,24,314
5107711,8,0,8,47,20,0,67,185,24,276
5107712,13,3,16,95,18,6,119,214,13,346
5107713,3,0,3,50,23,0,73,340,61,474
5107714,0,0,0,45,45,3,93,370,59,522
5107715,3,0,3,47,30,0,77,246,26,349
5107716,0,0,0,0,0,0,0,0,3,3
5107717,0,0,0,51,10,8,69,147,21,237
5107718,3,0,3,44,18,0,62,151,15,228
5107719,0,0,0,31,35,3,69,486,59,614
5107720,0,0,0,72,27,4,103,244,19,366
5107721,3,0,3,94,31,5,130,281,14,425
5107722,0,0,0,77,49,8,134,217,19,370
5107723,0,0,0,93,45,0,138,285,27,450
5107724,5,3,8,85,19,0,104,249,18,371
5107725,3,3,6,61,25,4,90,236,22,348
5107726,31,6,37,41,21,6,68,220,24,312
5107727,5,0,5,89,23,7,119,279,14,412
5107728,3,0,3,50,18,3,71,193,15,279
5107729,3,0,3,54,26,3,83,184,24,291
5107730,4,0,4,71,22,3,96,178,18,292
5107731,6,0,6,89,15,0,104,215,17,336
5107732,52,8,60,43,30,3,76,379,50,505
5107733,0,0,0,0,0,0,0,0,0,0
5107734,0,0,0,0,0,0,0,0,0,0
5107735,3,0,3,59,21,9,89,190,10,289
5107736,0,0,0,122,27,5,154,292,14,460
5107801,18,0,18,110,38,0,148,270,18,436
5107802,6,0,6,64,17,9,90,171,9,270
5107803,10,0,10,89,14,0,103,234,27,364
5107804,6,0,6,75,22,6,103,262,18,383
5107805,3,0,3,75,19,6,100,243,18,361
5107806,3,0,3,58,24,0,82,183,9,274
5107807,3,3,6,84,35,3,122,233,18,373
5107808,0,0,0,90,23,8,121,294,22,437
5107809,3,0,3,62,15,6,83,152,7,242
5107810,0,0,0,32,23,0,55,109,9,173
5107811,0,4,4,109,30,9,148,287,25,460
5107812,3,0,3,96,33,6,135,292,15,442
5107813,0,0,0,54,22,3,79,172,6,257
5107814,0,0,0,46,22,0,68,157,0,225
5107815,3,3,6,72,30,8,110,186,21,317
5107816,18,22,40,64,24,3,91,209,76,376
5107817,8,0,8,95,25,9,129,219,18,366
5107818,0,0,0,73,27,4,104,261,13,378
5107819,0,0,0,67,23,5,95,204,6,305
5107820,0,3,3,35,16,0,51,136,16,203
5107821,6,3,9,91,33,8,132,246,24,402
5107822,3,0,3,53,13,6,72,156,12,240
5107823,8,8,16,109,33,11,153,291,29,473
5107824,6,0,6,89,27,13,129,210,9,348
5107825,7,0,7,62,19,4,85,177,9,271
5107826,0,0,0,0,0,0,0,3,3,6
5107827,4,0,4,57,25,6,88,157,15,260
5107828,0,0,0,37,10,6,53,147,3,203
5107829,5,0,5,76,27,0,103,251,8,362
5107830,3,3,6,82,27,0,109,194,3,306
5107831,49,11,60,41,17,3,61,164,27,252
5107832,0,0,0,0,0,0,0,0,0,0
5107833,66,25,91,55,37,0,92,438,86,616
5107834,7,71,78,3,19,0,22,131,114,267
5107835,0,0,0,41,8,3,52,103,10,165
5107901,0,0,0,83,34,0,117,227,9,353
5107902,0,0,0,103,33,0,136,257,17,410
5107903,0,0,0,47,20,0,67,100,12,179
5107904,44,21,65,70,35,7,112,322,54,488
5107905,0,5,5,94,29,6,129,271,22,422
5107906,0,0,3,111,40,6,157,318,29,504
5107907,3,4,7,45,32,6,83,218,13,314
5107908,0,0,0,84,45,6,135,307,10,452
5107909,3,3,6,75,47,6,128,223,14,365
5107910,0,0,0,86,31,6,123,209,18,350
5107911,7,0,7,57,26,0,83,227,23,333
5107912,4,0,4,91,34,9,134,206,20,360
5107913,3,0,3,82,23,9,114,241,35,390
5107914,0,0,0,0,0,0,0,0,0,0
5107915,6,0,6,81,35,3,119,207,27,353
5107916,0,0,0,48,21,0,69,173,3,245
5107917,0,0,0,71,33,4,108,181,18,307
5107918,9,0,9,51,34,0,85,164,20,269
5107919,0,3,9,48,23,6,77,124,15,216
5107920,3,0,3,40,24,0,64,135,12,211
5107921,3,3,6,109,24,0,133,260,13,406
5107922,4,0,4,65,38,3,106,192,7,305
5107923,0,0,0,68,25,9,102,216,15,333
5107924,0,0,0,0,0,0,0,0,0,0
5107925,0,0,0,123,32,4,159,220,29,408
5107926,4,6,10,92,20,10,122,267,21,410
5107927,6,0,6,108,41,6,155,272,30,457
5108001,5,0,5,47,42,0,89,220,21,330
5108002,3,0,3,57,15,6,78,189,4,271
5108003,0,0,0,73,21,6,100,212,9,321
5108004,0,0,0,27,15,5,47,96,3,146
5108005,7,0,7,92,18,3,113,202,30,345
5108006,3,0,3,59,23,3,85,146,17,248
5108007,5,0,5,66,39,3,108,272,14,394
5108008,0,0,0,59,30,8,97,190,12,299
5108009,7,0,7,45,16,0,61,123,17,201
5108010,0,0,0,63,32,0,95,151,25,271
5108011,0,3,3,59,35,0,94,218,13,325
5108012,6,0,6,40,27,5,72,173,5,250
5108013,0,0,0,51,23,0,74,127,9,210
5108014,0,0,0,86,42,3,131,327,52,510
5108015,3,0,3,49,19,3,71,150,8,229
5108016,0,0,0,0,0,0,0,0,0,0
5108017,0,0,0,57,15,9,81,186,5,272
5108018,3,3,6,34,10,3,47,168,28,243
5108019,4,0,4,98,29,0,127,234,26,387
5108020,0,0,0,77,28,4,109,185,18,312
5108021,6,0,6,73,32,10,115,187,0,302
5108022,10,3,13,69,30,4,103,235,21,359
5108023,0,0,0,71,13,7,91,169,12,272
5108101,3,3,6,70,17,4,91,181,20,292
5108102,0,0,0,85,21,3,109,186,18,313
5108103,6,0,6,78,30,9,117,231,11,359
5108104,0,0,0,0,0,0,0,0,0,0
5108105,6,0,6,47,20,6,73,125,16,214
5108106,0,3,3,93,21,6,120,175,21,316
5108107,0,0,0,104,35,4,143,244,14,401
5108108,7,0,7,76,18,10,104,185,12,301
5108109,0,0,0,55,20,3,78,176,15,269
5108110,0,0,0,64,20,3,87,144,22,253
5108111,0,0,0,70,20,7,97,167,34,298
5108112,3,0,3,73,32,4,109,172,42,323
5108113,6,0,6,44,16,0,60,167,26,253
5108114,8,0,8,75,37,7,119,275,14,408
5108115,3,0,3,91,25,9,125,225,12,362
5108116,0,0,0,0,0,0,0,0,0,0
5108117,6,0,6,85,34,0,119,251,23,393
5108118,3,0,3,56,12,3,71,169,15,255
5108119,3,0,3,73,33,6,112,167,11,290
5108120,6,0,6,49,20,3,72,126,12,210
5108121,3,0,3,68,39,10,117,281,15,413
5108122,3,0,3,49,10,3,62,116,3,181
5108123,6,6,12,65,32,4,101,254,27,382
5108124,0,3,3,45,27,6,78,137,13,228
5108201,0,0,0,67,24,3,94,165,15,274
5108202,3,0,3,44,35,3,82,214,30,326
5108203,0,0,0,57,24,9,90,167,24,281
5108204,0,0,0,47,24,3,74,190,12,276
5108205,0,0,0,46,20,0,66,157,15,238
5108206,12,0,12,46,42,9,97,255,35,387
5108207,10,0,10,74,34,3,111,204,18,333
5108208,4,0,4,49,18,0,67,127,5,199
5108209,41,22,63,63,54,4,121,290,42,453
5108210,4,0,4,49,7,6,62,147,3,212
5108211,3,0,3,85,60,8,153,273,21,447
5108212,0,0,0,67,31,3,101,216,4,321
5108213,3,0,3,23,18,0,41,183,9,233
5108214,7,0,7,47,16,0,63,193,11,267
5108215,9,0,12,64,24,6,94,215,12,321
5108216,6,0,6,40,20,6,66,181,18,265
5108217,3,0,3,73,16,3,92,212,8,312
5108218,4,0,4,71,43,3,117,195,11,323
5108219,3,0,3,89,34,6,129,182,30,341
5108220,4,0,4,85,36,8,129,141,21,291
5108221,6,3,9,49,24,0,73,155,42,270
5108222,4,0,4,54,35,3,92,203,14,309
5108223,7,0,7,67,44,0,111,261,45,417
5108224,3,0,3,77,33,6,116,214,37,367
5108225,8,0,8,43,37,3,83,295,47,425
5108301,4,0,4,78,23,3,104,195,8,307
5108302,6,0,6,105,20,9,134,278,21,433
5108303,0,0,0,82,20,6,108,200,12,320
5108304,6,0,6,75,21,0,96,212,6,314
5108305,0,0,0,93,27,6,126,202,19,347
5108306,8,0,8,49,18,3,70,181,6,257
5108307,0,0,0,44,22,0,66,170,11,247
5108308,0,0,0,58,16,0,74,177,4,255
5108309,0,0,0,0,0,0,0,0,0,0
5108310,0,0,0,80,24,12,116,207,4,327
5108311,0,0,0,52,22,6,80,156,6,242
5108312,0,0,0,62,20,0,82,175,8,265
5108313,0,0,0,38,21,0,59,127,10,196
5108314,3,0,3,111,25,3,139,286,22,447
5108315,0,0,0,36,19,3,58,132,9,199
5108316,0,0,0,43,10,4,57,118,5,180
5108317,4,0,4,82,39,0,121,230,19,370
5108318,3,0,3,63,32,3,98,176,10,284
5108319,0,0,0,49,14,5,68,170,0,238
5108320,47,13,60,12,10,0,22,206,31,259
5108321,0,0,0,81,21,6,108,179,13,300
5108322,3,0,3,74,33,0,107,285,9,401
5108323,0,0,0,60,33,6,99,136,14,249
5108324,3,0,3,37,19,3,59,102,3,164
5108325,0,0,0,83,32,6,121,242,28,391
5108326,0,0,0,0,3,0,3,14,0,17
5108327,0,0,0,52,23,0,75,146,20,241
5108328,0,0,0,0,0,0,0,0,0,0
5108329,0,0,0,0,0,0,0,0,0,0
5108330,0,0,0,0,0,0,0,0,0,0
5108331,3,0,3,38,20,4,62,137,12,211
5108401,7,0,7,73,39,9,121,264,12,397
5108402,4,0,4,84,32,3,119,212,21,352
5108403,8,3,11,61,35,8,104,286,23,413
5108404,11,0,11,65,34,0,99,257,21,377
5108405,0,0,0,70,20,0,90,355,38,483
5108406,0,0,0,55,22,3,80,143,9,232
5108407,0,0,0,37,10,0,47,148,12,207
5108408,7,0,7,37,20,0,57,130,5,192
5108409,3,3,6,61,20,8,89,191,24,304
5108410,0,0,0,56,19,6,81,193,4,278
5108411,3,3,6,59,31,3,93,202,15,310
5108412,36,7,43,98,47,3,148,414,50,612
5108413,3,0,3,24,18,0,42,219,28,289
5108414,8,0,8,70,21,4,95,262,46,403
5108415,0,0,0,67,31,7,105,200,18,323
5108416,6,0,6,54,25,3,82,267,12,361
5108417,6,0,6,46,34,9,89,172,23,284
5108418,9,0,9,90,45,6,141,260,20,421
5108419,7,0,7,55,27,0,82,185,13,280
5108420,3,0,3,70,27,0,97,216,16,329
5108421,6,0,6,102,41,6,149,262,16,427
5108422,0,0,0,0,0,0,0,3,0,3
5108423,3,0,3,44,30,3,77,157,14,248
5108424,6,0,6,43,7,0,50,169,18,237
5108425,10,0,10,43,18,4,65,201,21,287
5108426,6,0,6,45,21,0,66,166,22,254
5108427,10,0,10,59,23,3,85,214,7,306
5108428,3,0,3,75,28,7,110,219,35,364
5108429,18,56,74,47,27,3,77,304,110,491
5108430,12,0,15,39,48,3,90,221,20,331
5108431,8,0,11,55,40,0,95,224,26,345
5108432,3,0,3,51,18,3,72,224,18,314
5108433,3,0,3,48,21,6,75,273,51,399
5108434,17,5,22,53,24,3,80,345,76,501
5108435,11,3,17,40,24,0,64,281,50,395
5108436,8,0,8,40,32,0,72,249,34,355
5108437,5,0,5,76,26,0,102,329,37,468
5108501,0,0,0,72,25,0,97,228,40,365
5108502,3,0,3,61,16,0,77,200,26,303
5108503,9,0,9,66,24,6,96,242,39,377
5108504,4,0,4,69,22,3,94,182,27,303
5108505,3,0,3,40,10,3,53,162,53,268
5108506,4,0,4,83,25,0,108,276,53,437
5108507,0,0,0,105,26,6,137,211,28,376
5108508,4,0,4,75,25,0,100,277,44,421
5108509,6,3,12,73,20,3,96,258,33,387
5108510,6,0,6,50,30,0,80,210,40,330
5108511,0,0,0,54,24,0,78,164,35,277
5108512,5,0,5,47,19,0,66,196,26,288
5108513,0,0,0,71,36,0,107,278,78,463
5108514,0,0,0,59,18,0,77,200,24,301
5108515,6,3,9,43,4,0,47,197,52,296
5108516,4,0,4,79,25,0,104,245,56,405
5108517,0,0,0,63,9,0,72,196,53,321
5108518,0,0,0,45,13,4,62,160,35,257
5108519,6,0,6,48,17,3,68,208,52,328
5108520,6,0,6,73,41,0,114,215,67,396
5108521,3,0,3,78,24,0,102,279,40,421
5108522,3,0,3,39,21,3,63,171,17,251
5108523,0,0,0,68,28,6,102,275,66,443
5108524,3,0,3,71,24,6,101,302,62,465
5108525,0,0,0,50,25,3,78,127,44,249
5108526,3,3,6,64,23,0,87,286,55,428
5108527,0,0,0,55,15,0,70,177,39,286
5108528,3,0,3,48,20,3,71,143,34,248
5108529,3,0,3,68,14,0,82,212,56,350
5108530,6,4,10,49,11,3,63,138,54,255
5108531,4,4,8,64,13,4,81,270,68,419
5108532,4,0,4,56,9,3,68,140,5,213
5108533,0,0,0,0,0,0,0,0,0,0
5108534,0,0,0,0,0,0,0,0,0,0
5108535,6,0,6,69,23,0,92,259,57,408
5108536,0,0,0,32,11,0,43,153,10,206
5108537,0,0,0,87,12,0,99,246,38,383
5108538,0,0,0,0,0,0,0,0,0,0
5108539,0,0,0,85,22,0,107,253,31,391
5108540,4,0,4,71,10,0,81,138,18,237
5108541,0,0,0,83,33,0,116,167,29,312
5108542,0,0,0,77,12,0,89,228,31,348
5108543,0,0,0,52,19,0,71,201,36,308
5108544,3,0,3,44,24,3,71,132,28,231
5108601,0,0,0,24,0,0,24,50,12,86
5108602,5,0,5,66,20,3,89,275,31,395
5108603,3,3,6,50,18,3,71,146,16,233
5108604,6,3,9,34,13,0,47,154,12,213
5108605,20,4,24,66,21,0,87,318,75,480
5108606,8,4,12,49,24,0,73,200,43,316
5108607,5,4,9,62,22,0,84,240,29,353
5108608,18,0,18,51,27,3,81,249,20,350
5108609,31,0,31,62,13,3,78,306,32,416
5108610,3,0,3,57,13,6,76,132,15,223
5108611,8,0,8,29,31,0,60,139,18,217
5108612,0,0,0,68,34,5,107,222,21,350
5108613,4,0,4,61,23,0,84,229,11,324
5108614,17,0,17,92,44,0,136,274,28,438
5108615,49,8,57,53,26,3,82,281,35,398
5108616,19,6,25,137,14,3,154,323,22,499
5108617,7,0,7,77,37,0,114,295,30,439
5108618,39,9,48,47,37,11,95,279,33,407
5108619,8,0,8,36,21,0,57,158,6,221
5108620,0,0,0,0,0,0,0,0,0,0
5108621,3,0,3,63,22,0,85,271,18,374
5108622,8,0,8,79,28,7,114,238,17,369
5108623,3,0,3,78,26,3,107,281,14,402
5108624,6,0,6,72,36,3,111,195,20,326
5108625,14,3,17,62,21,9,92,192,15,299
5108626,10,0,10,86,29,6,121,214,25,360
5108627,4,0,4,34,19,3,56,150,9,215
5108628,0,6,6,40,13,0,53,154,21,228
5108629,8,0,8,66,24,4,94,256,37,387
5108630,0,5,5,67,39,0,106,248,19,373
5108631,7,0,7,62,29,3,94,216,42,352
5108632,12,0,12,79,24,0,103,344,21,468
5108633,8,3,16,51,16,0,67,208,21,296
5108634,11,0,11,78,28,0,106,263,29,398
5108635,17,3,20,64,21,3,88,283,27,398
5108636,7,3,10,46,28,0,74,217,18,309
5108637,6,0,6,50,34,3,87,200,23,310
5108638,3,0,3,46,12,3,61,166,17,244
5108639,0,0,0,34,21,0,55,189,3,247
5108640,6,3,9,70,17,6,93,270,23,386
5108641,14,3,17,64,30,3,97,278,36,411
5108642,11,3,14,72,24,0,96,412,74,582
5108643,4,3,7,68,24,0,92,176,35,303
5108644,0,0,0,57,16,0,73,106,5,184
5108645,10,3,13,78,20,0,98,259,28,385
5108646,13,0,13,76,40,3,119,317,18,454
5108647,0,0,0,44,14,0,58,181,11,250
5108648,5,0,5,89,36,8,133,304,9,446
5108649,0,0,0,44,24,0,68,139,15,222
5108650,43,6,49,87,27,3,117,313,53,483
5108651,6,3,9,73,29,6,108,243,19,370
5108652,4,0,4,55,27,0,82,171,14,267
5108653,11,0,11,86,38,0,124,213,22,359
5108654,0,0,0,57,22,6,85,171,13,269
5108655,3,0,3,42,27,6,75,214,9,298
5108656,0,0,0,58,22,0,80,175,20,275
5108657,4,0,4,77,13,0,90,209,15,314
5108658,0,0,0,0,0,0,0,0,0,0
5108659,0,0,0,27,18,0,45,210,8,263
5108701,0,0,0,0,0,0,0,3,0,3
5108801,9,0,9,72,27,0,99,243,26,368
5108802,0,0,0,6,0,0,6,13,0,19
5108803,6,3,9,38,24,6,68,282,15,365
5108804,5,4,9,42,24,0,66,191,55,312
5108805,0,0,0,58,14,3,75,189,13,277
5108806,3,8,11,80,18,7,105,149,28,282
5108807,4,3,7,57,10,10,77,113,15,205
5108808,0,0,0,40,12,0,52,187,46,285
5108809,3,3,6,48,17,4,69,228,61,358
5108810,13,4,17,66,25,0,91,206,28,325
5108811,0,10,10,85,38,0,123,227,24,374
5108812,3,0,3,66,20,0,86,175,38,299
5108813,3,0,3,65,32,4,101,252,31,384
5108814,7,0,7,108,22,0,130,313,34,477
5108815,12,3,15,66,33,4,103,284,26,413
5108816,6,0,6,106,19,3,128,211,18,357
5108817,8,3,11,61,27,3,91,147,16,254
5108818,8,6,14,113,31,3,147,442,76,665
5108819,6,4,10,111,35,7,153,432,60,645
5108820,7,6,13,72,21,6,99,296,31,426
5108821,4,3,7,65,19,0,84,229,26,339
5108822,8,6,14,72,27,5,104,353,39,496
5108823,10,7,17,59,25,0,84,214,29,327
5108824,48,3,51,58,27,0,85,416,29,530
5108825,5,0,5,43,24,3,70,248,59,377
5108826,0,0,0,36,17,0,53,213,38,304
5108827,0,30,30,37,10,6,53,132,69,254
5108828,3,0,3,67,25,3,95,327,40,462
5108829,3,3,6,58,16,3,77,227,35,339
5108830,8,0,8,77,23,0,100,232,36,368
5108831,9,0,9,67,29,3,99,286,32,417
5108832,71,7,78,31,14,0,45,267,26,338
5108833,3,3,6,81,34,3,118,202,18,338
5108834,10,0,10,65,30,12,107,296,32,435
5108835,6,3,9,97,34,5,136,247,24,407
5108901,3,0,3,89,29,3,121,266,20,407
5108902,0,0,0,93,30,6,129,144,15,288
5108903,0,0,0,30,18,0,48,83,18,149
5108904,0,0,0,0,0,0,0,0,0,0
5108905,7,0,7,46,29,4,79,152,6,237
5108906,0,0,0,68,18,0,86,157,24,267
5108907,3,3,6,69,18,0,87,150,15,252
5108908,6,0,6,143,36,6,185,243,16,444
5108909,7,3,10,101,42,3,146,258,26,430
5108910,76,8,84,3,6,0,9,225,23,257
5108911,0,0,3,48,24,7,79,137,32,248
5108912,0,0,0,91,15,14,120,164,12,296
5108913,29,46,75,72,32,6,110,270,96,476
5108914,0,0,0,135,31,6,172,232,31,435
5108915,0,0,0,18,3,0,21,23,6,50
5108916,4,0,4,84,33,0,117,186,24,327
5108917,3,0,3,75,32,8,115,187,7,309
5108918,6,0,6,86,47,4,137,227,7,371
5108919,3,3,6,25,6,0,31,107,18,156
5108920,0,0,0,90,20,3,113,143,12,268
5108921,14,3,17,96,33,3,132,228,42,402
5108922,41,48,89,137,37,0,174,297,87,558
5108923,3,0,3,104,31,13,148,171,24,343
5108924,0,0,0,58,19,10,87,174,21,282
5108925,6,0,6,99,42,3,144,148,12,304
5108926,0,0,0,163,10,8,181,162,8,351
5108927,45,5,50,46,23,3,72,196,14,282
5108928,0,0,0,0,0,0,0,0,0,0
5108929,7,0,7,88,41,3,132,250,41,423
5108930,6,0,6,93,38,6,137,291,11,439
5108931,6,0,6,58,29,3,90,190,7,287
5108932,4,0,4,104,47,3,154,185,29,368
5108933,7,3,10,95,47,9,151,262,24,437
5108934,4,0,4,32,12,3,47,101,0,148
5108935,11,0,11,84,33,6,123,264,15,402
5108936,0,0,0,64,30,0,94,206,17,317
5108937,0,0,0,0,0,0,0,0,0,0
5108938,3,0,3,72,24,9,105,216,7,328
5108939,6,3,9,43,25,0,68,159,9,236
5108940,4,0,4,37,19,12,68,126,12,206
5108941,3,0,3,112,46,5,163,265,5,433
5108942,4,0,4,63,47,0,110,258,6,374
5108943,4,6,10,79,39,3,121,293,6,420
5108944,6,0,6,80,24,3,107,201,9,317
5108945,0,0,0,24,13,0,37,104,3,144
5108946,4,0,4,74,36,3,113,187,3,303
5108947,7,0,7,50,21,0,71,164,6,241
5108948,5,0,5,103,45,3,151,252,16,419
5108949,4,0,4,59,22,3,84,182,12,278
5108950,0,0,0,67,25,5,97,178,15,290
5109001,4,0,4,117,33,0,150,440,46,636
5109002,3,6,9,44,12,3,59,182,30,271
5109003,0,3,3,58,26,0,84,228,12,324
5109004,7,0,7,93,24,0,117,390,50,557
5109005,3,5,8,81,39,0,120,311,27,458
5109006,0,0,3,42,30,3,75,181,14,270
5109007,6,3,9,77,33,0,110,302,31,443
5109008,0,0,0,50,31,0,81,221,37,339
5109009,0,0,0,39,30,3,72,288,24,384
5109010,9,0,9,63,31,0,94,227,20,341
5109011,6,5,11,37,14,0,51,191,34,276
5109012,8,0,8,68,21,0,89,257,50,396
5109013,4,4,8,88,28,3,119,297,51,467
5109014,3,0,3,68,18,6,92,239,60,391
5109015,3,4,7,109,20,0,129,335,106,570
5109016,0,0,0,93,18,5,116,346,44,506
5109017,0,7,7,68,29,3,100,309,44,453
5109018,7,0,7,128,43,7,178,481,55,714
5109019,0,0,0,74,9,3,86,242,28,356
5109020,3,0,3,91,25,6,122,293,70,485
5109021,3,0,3,71,16,3,90,199,47,336
5109022,8,0,8,88,40,0,128,386,30,544
5109023,3,3,6,85,30,3,118,338,66,522
5109024,4,0,4,53,22,0,75,227,17,319
5109025,5,0,5,77,24,0,101,392,39,532
5109026,0,0,0,99,27,3,129,379,91,599
5109027,6,3,12,62,37,3,102,323,66,491
5109028,0,0,0,88,34,0,122,333,54,509
5109101,0,0,0,0,0,0,0,7,0,7
5109201,6,0,6,59,16,0,75,224,48,347
5109202,6,0,6,43,32,3,78,255,37,370
5109203,9,6,15,34,20,5,59,231,62,352
5109204,18,5,23,78,22,0,100,277,49,426
5109205,5,0,5,58,30,9,97,246,23,366
5109206,4,0,4,76,27,0,103,159,21,283
5109207,3,0,3,69,30,5,104,323,74,501
5109208,3,0,3,27,27,3,57,269,28,354
5109209,0,0,0,50,14,3,67,290,80,437
5109210,0,3,3,29,13,0,42,195,91,328
5109211,0,4,4,29,25,0,54,172,104,330
5109212,0,3,3,33,18,6,57,309,37,403
5109213,3,0,3,33,19,0,52,206,26,284
5109214,6,0,6,41,15,0,56,186,53,295
5109215,3,0,3,23,15,3,41,223,58,322
5109216,3,6,9,42,24,0,66,414,152,632
5109217,3,0,3,85,34,6,125,281,93,499
5109218,4,3,7,82,28,3,113,264,44,421
5109219,20,0,20,96,35,0,131,297,45,473
5109220,0,0,0,36,30,0,66,240,26,332
5109221,3,3,6,58,27,3,88,309,56,453
5109222,3,0,3,59,22,3,84,348,47,479
5109223,6,5,11,55,19,3,77,226,52,355
5109224,6,0,6,94,35,0,129,370,30,529
5109225,9,0,9,64,31,6,101,226,24,351
5109226,9,4,13,65,19,9,93,245,28,366
5109227,5,0,5,56,12,0,68,206,23,297
5109228,6,3,9,66,26,3,95,290,20,405
5109229,0,0,0,22,16,0,38,153,33,224
5109230,10,3,13,65,24,11,100,226,33,359
5109231,6,0,6,71,30,0,101,306,23,430
5109232,8,0,8,88,28,0,116,351,49,516
5109301,0,0,0,68,23,0,91,273,121,485
5109302,7,0,7,54,23,4,81,345,78,504
5109303,3,0,3,50,34,0,84,219,22,325
5109304,3,0,3,68,14,0,82,173,12,267
5109305,6,0,6,72,25,3,100,293,17,410
5109306,10,0,10,72,49,6,127,303,18,448
5109307,3,3,6,73,42,6,121,275,34,430
5109308,0,0,0,166,34,0,200,255,12,467
5109309,3,0,3,26,9,0,35,206,55,296
5109310,0,0,0,53,19,0,72,340,78,490
5109311,3,3,6,59,12,0,71,225,30,326
5109312,6,6,12,35,29,6,70,369,36,475
5109313,0,3,3,61,19,0,80,208,33,321
5109314,0,0,4,45,26,0,71,201,47,319
5109315,33,4,37,39,23,0,62,245,48,355
5109316,3,0,3,95,34,0,129,186,11,326
5109317,3,3,6,93,31,6,130,316,26,472
5109318,10,0,13,76,30,3,109,301,21,431
5109319,0,0,0,33,14,0,47,175,14,236
5109320,0,0,0,101,29,6,136,156,7,299
5109321,10,0,10,74,32,4,110,334,38,482
5109322,10,0,10,56,40,0,96,224,32,352
5109323,6,0,6,36,52,4,92,268,23,383
5109324,6,0,6,40,21,0,61,180,12,253
5109325,0,0,0,49,28,0,77,164,6,247
5109326,6,0,6,47,30,6,83,220,24,327
5109327,0,0,0,138,29,0,167,246,6,419
5109328,3,0,3,44,23,0,67,208,18,293
5109329,3,0,3,166,52,9,227,312,26,565
5109330,0,0,0,3,0,0,3,3,0,6
5109401,11,0,11,30,22,3,55,157,9,221
5109402,5,0,5,23,34,0,57,200,10,267
5109403,3,5,8,64,45,12,121,287,23,431
5109404,8,0,8,43,41,0,84,189,7,280
5109405,12,3,15,73,47,10,130,271,26,427
5109406,9,0,9,115,46,7,168,329,28,525
5109407,0,0,0,70,24,6,100,178,30,308
5109408,16,0,16,64,38,4,106,162,10,278
5109409,10,0,10,73,31,5,109,221,27,357
5109410,7,3,10,88,25,7,120,208,32,360
5109411,6,3,9,64,37,9,110,170,25,305
5109412,3,0,3,87,49,4,140,220,34,394
5109413,3,0,3,48,13,4,65,94,9,168
5109414,7,0,7,62,32,0,94,193,29,316
5109415,4,7,11,73,22,0,95,137,15,247
5109416,0,0,0,0,0,0,0,0,0,0
5109417,4,0,4,43,27,0,70,232,35,337
5109418,3,3,6,34,41,3,78,118,12,208
5109419,3,4,7,32,27,0,59,173,19,251
5109501,3,3,6,47,6,0,53,212,28,293
5109502,0,0,0,45,14,6,65,286,36,387
5109503,6,3,9,47,22,4,73,305,28,406
5109504,5,3,8,44,20,0,64,168,37,269
5109505,14,3,17,47,25,0,72,266,28,366
5109506,5,0,5,63,18,3,84,298,10,392
5109507,3,0,3,61,15,0,76,269,19,364
5109508,14,0,14,55,24,3,82,327,44,453
5109509,8,0,8,23,9,0,32,201,19,252
5109510,10,0,10,48,13,3,64,240,16,320
5109511,4,4,8,93,38,3,134,360,61,555
5109512,7,0,7,53,34,6,93,246,48,387
5109513,13,0,13,61,28,6,95,286,29,410
5109514,14,0,14,77,25,0,102,332,46,480
5109515,0,3,3,61,17,3,81,209,21,311
5109516,4,0,4,34,21,0,55,277,77,409
5109517,6,0,6,71,14,0,85,234,27,346
5109518,7,0,7,34,8,0,42,138,28,208
5109519,10,3,13,36,6,0,42,213,29,284
5109520,8,0,8,56,22,6,84,281,36,401
5109521,6,0,9,57,12,0,69,158,15,242
5109522,35,5,40,42,21,6,69,223,19,311
5109523,8,6,14,57,16,4,77,262,34,373
5109524,5,0,5,40,26,0,66,250,31,347
5109525,0,0,0,32,14,3,49,211,81,341
5109526,7,7,14,51,21,3,75,232,36,343
5109527,6,4,10,57,5,0,62,185,15,262
5109528,38,6,47,39,22,0,61,270,38,369
5109601,6,3,9,54,14,9,77,234,29,340
5109602,68,15,83,14,18,0,32,266,35,333
5109603,7,0,7,70,21,9,100,168,9,277
5109604,5,0,5,80,31,6,117,167,10,294
5109605,0,0,0,111,26,0,137,317,27,481
5109606,3,0,3,45,12,0,57,159,0,216
5109607,3,0,3,35,9,0,44,254,6,304
5109608,3,0,3,91,23,3,117,335,29,481
5109609,3,0,3,44,25,3,72,116,0,188
5109610,7,0,7,62,35,7,104,193,5,302
5109611,5,0,5,83,28,3,114,218,21,353
5109612,8,0,8,114,26,7,147,225,17,389
5109613,3,0,3,87,37,6,130,191,10,331
5109614,8,0,8,75,31,7,113,126,9,248
5109615,0,0,0,69,19,5,93,157,7,257
5109616,8,0,8,69,33,0,102,290,16,408
5109617,16,0,16,82,36,3,121,241,13,375
5109618,7,3,10,95,36,10,141,236,9,386
5109619,7,0,7,73,27,3,103,194,10,307
5109620,0,0,0,80,37,4,121,214,8,343
5109621,7,0,7,72,28,0,100,248,4,352
5109622,0,0,0,23,9,0,32,174,9,215
5109623,8,3,14,82,55,4,141,240,13,394
5109624,5,0,5,114,30,3,147,284,18,449
5109625,6,0,9,59,37,6,102,237,18,357
5109626,0,3,3,61,29,3,93,232,21,346
5109627,0,0,0,0,0,0,0,0,0,0
5109628,11,0,11,88,32,6,126,277,9,412
5109629,8,0,8,67,32,0,99,181,15,295
5109630,6,5,11,62,34,6,102,228,5,335
5109631,6,0,6,99,43,3,145,246,10,401
5109701,3,0,3,37,13,0,50,123,19,192
5109702,4,3,7,56,14,0,70,156,19,245
5109703,3,3,6,35,21,0,56,173,15,244
5109704,10,0,10,63,25,0,88,323,25,436
5109705,3,0,3,64,25,3,92,216,14,322
5109706,9,6,15,84,25,10,119,261,23,403
5109707,6,0,6,40,22,0,62,167,28,257
5109708,5,0,5,41,19,3,63,212,15,290
5109709,3,0,3,57,24,0,81,208,32,321
5109710,20,46,66,48,22,6,76,403,111,590
5109711,6,0,9,64,30,3,97,185,22,304
5109712,4,0,4,88,24,0,112,341,27,480
5109713,11,3,14,72,32,0,104,368,35,507
5109714,7,3,10,30,23,0,53,176,22,251
5109715,10,0,10,75,36,6,117,298,39,454
5109716,51,0,51,78,39,0,117,433,50,600
5109717,10,3,13,74,23,3,100,277,16,393
5109718,9,3,12,76,17,6,99,192,22,313
5109719,9,0,9,69,31,0,100,326,42,468
5109720,11,0,11,60,24,0,84,324,35,443
5109721,12,4,16,54,27,0,81,310,49,440
5109722,14,3,17,67,38,0,105,358,44,507
5109723,7,3,10,69,24,3,96,396,70,562
5109724,11,0,11,60,7,4,71,231,19,321
5109725,6,0,6,60,24,0,84,129,7,220
5109726,94,26,123,6,26,0,32,283,69,384
5109727,10,0,10,84,18,0,102,247,44,393
5109728,159,13,172,10,19,0,29,358,26,413
5109729,6,0,6,45,24,3,72,152,21,245
5109730,12,0,12,108,33,9,150,261,0,411
5109731,16,0,16,105,28,0,133,268,9,410
5109732,3,3,6,113,27,10,150,227,12,389
5109733,6,0,6,82,38,6,126,317,20,463
5109734,0,0,0,0,0,0,0,0,0,0
5109801,4,0,4,69,33,0,102,293,42,437
5109802,3,0,3,67,21,0,88,277,16,381
5109803,3,0,3,62,17,0,79,252,25,356
5109804,3,0,3,29,16,3,48,169,9,226
5109805,3,0,3,69,22,0,91,209,18,318
5109806,0,0,0,54,20,3,77,184,48,309
5109807,0,0,0,55,20,3,78,191,49,318
5109808,0,0,0,64,11,3,78,186,19,283
5109809,0,0,0,40,13,0,53,137,15,205
5109810,6,0,6,81,27,0,108,251,64,423
5109811,0,0,0,54,18,3,75,199,25,299
5109812,3,3,6,24,9,3,36,113,27,176
5109813,9,0,9,30,23,3,56,144,32,232
5109814,0,0,0,85,35,3,123,213,24,360
5109815,0,0,0,66,31,3,100,189,21,310
5109816,0,3,3,73,19,0,92,133,15,240
5109817,0,0,0,78,21,3,102,173,10,285
5109818,0,0,0,0,0,0,0,0,0,0
5109819,6,3,9,81,11,0,92,248,38,378
5109820,3,0,3,85,22,6,113,291,22,426
5109821,4,0,4,83,23,0,106,274,32,412
5109822,3,0,3,71,21,0,92,209,21,322
5109823,0,0,0,101,24,0,125,251,29,405
5109824,3,0,3,51,28,0,79,256,31,366
5109825,0,0,0,81,42,0,123,232,18,373
5109826,0,0,0,41,9,0,50,92,6,148
5109827,0,0,0,76,21,3,100,239,27,366
5109828,0,0,0,92,26,0,118,274,21,413
5109829,0,0,0,69,33,0,102,243,12,357
5109901,9,3,12,25,39,0,64,338,44,446
5109902,0,0,0,143,29,7,179,242,49,470
5109903,141,21,162,0,8,0,8,380,46,434
5109904,0,0,0,74,16,4,94,133,32,259
5109905,3,0,3,103,32,0,135,177,20,332
5109906,0,0,0,113,11,4,128,177,29,334
5109907,0,0,0,140,13,5,158,186,19,363
5109908,0,0,0,0,0,0,0,0,0,0
5109909,0,4,4,183,34,16,233,284,22,539
5109910,3,0,3,131,28,0,159,218,25,402
5109911,0,0,0,55,22,4,81,78,10,169
5109912,0,0,0,162,32,5,199,259,47,505
5109913,0,0,0,78,12,3,93,150,28,271
5109914,0,0,0,0,0,0,0,0,0,0
5109915,0,0,0,161,31,6,198,203,27,428
5109916,0,0,0,90,12,3,105,90,20,215
5109917,0,0,0,100,27,6,133,174,34,341
5109918,3,0,3,90,18,12,120,184,22,326
5109919,0,0,0,89,21,6,116,214,27,357
5109920,0,0,0,30,12,4,46,74,5,125
5109921,0,0,0,115,27,12,154,179,29,362
5109922,0,0,0,116,25,6,147,204,62,413
5109923,0,0,0,75,18,6,99,114,38,251
5109924,0,0,0,190,19,6,215,237,43,495
5109925,0,0,0,149,30,15,194,225,27,446
5109926,3,0,3,207,46,16,269,377,43,689
5109927,0,0,0,169,34,5,208,169,12,389
5109928,0,3,3,467,67,24,558,739,79,1376
5109929,0,0,0,109,38,7,154,263,69,486
5109930,0,0,0,73,22,6,101,151,35,287
5109931,0,0,0,80,19,3,102,179,44,325
5109932,3,3,6,79,21,9,109,224,52,385
5109933,0,0,0,89,22,3,114,130,38,282
5109934,82,14,99,9,20,3,32,416,48,496
5109935,4,0,4,254,54,12,320,466,142,928
5110001,0,0,0,152,34,3,189,159,25,373
5110002,0,0,0,119,16,3,138,137,21,296
5110003,6,0,6,95,45,3,143,268,26,437
5110004,0,0,0,202,54,8,264,569,60,893
5110005,0,0,0,119,28,0,147,141,28,316
5110006,0,0,0,129,15,6,150,160,23,333
5110007,0,0,0,233,29,3,265,327,24,616
5110008,0,0,0,117,9,6,132,200,20,352
5110009,0,0,0,119,17,6,142,181,28,351
5110010,3,0,3,139,25,20,184,249,28,461
5110011,0,0,0,143,20,4,167,205,24,396
5110012,0,0,0,3,0,0,3,0,9,12
5110013,0,3,3,47,9,6,62,111,24,197
5110014,0,0,0,127,34,4,165,261,38,464
5110015,0,0,0,89,19,3,111,141,7,259
5110016,0,0,0,128,20,6,154,251,15,420
5110017,0,0,0,115,21,9,145,202,3,350
5110018,0,0,0,113,22,11,146,213,9,368
5110019,0,0,0,104,19,8,131,155,19,305
5110020,0,0,0,165,34,6,205,192,33,430
5110021,0,0,0,186,31,15,232,235,49,516
5110101,0,0,0,50,29,0,79,116,14,209
5110102,0,0,0,63,21,4,88,146,13,247
5110103,0,0,0,0,0,0,0,0,0,0
5110104,0,0,0,85,32,0,117,200,33,350
5110105,0,0,0,87,19,6,112,161,27,300
5110106,0,0,0,53,15,6,74,134,6,214
5110107,0,0,0,144,29,5,178,390,46,614
5110108,3,0,3,81,21,4,106,156,101,363
5110109,0,3,3,116,26,3,145,193,65,403
5110110,5,0,5,134,34,9,177,241,23,441
5110111,0,0,0,117,27,9,153,253,43,449
5110112,0,0,0,146,22,9,177,258,37,472
5110113,0,0,0,181,44,9,234,503,120,857
5110114,0,0,0,157,32,5,194,340,47,581
5110115,0,0,0,88,19,3,110,194,42,346
5110116,0,0,0,110,18,9,137,251,40,428
5110117,3,0,3,85,17,4,106,151,33,290
5110118,0,0,0,59,10,5,74,193,26,293
5110119,0,0,0,57,24,6,87,149,19,255
5110120,0,0,0,83,22,0,105,162,34,301
5110121,0,0,0,47,5,6,58,108,18,184
5110122,0,0,0,118,20,0,138,165,17,320
5110123,0,0,0,109,30,7,146,184,14,344
5110124,0,0,0,67,9,6,82,145,33,260
5110125,0,0,0,76,22,3,101,132,12,245
5110201,0,0,0,60,25,0,85,204,42,331
5110202,0,0,0,98,29,10,137,251,32,420
5110203,3,0,3,46,22,4,72,127,9,208
5110204,3,3,6,59,29,6,94,215,39,348
5110205,0,0,0,36,15,0,51,149,18,218
5110206,3,0,3,30,10,0,40,137,23,200
5110207,0,0,0,53,21,4,78,160,28,266
5110208,3,0,3,68,24,0,92,215,28,335
5110209,4,5,9,48,26,3,77,140,10,227
5110210,4,0,4,45,27,0,72,134,27,233
5110211,0,0,0,58,29,0,87,167,29,283
5110212,0,0,0,68,16,0,84,185,25,294
5110213,0,0,0,48,16,0,64,154,21,239
5110214,6,0,6,61,20,0,81,240,22,343
5110215,0,6,6,42,30,0,72,187,37,296
5110216,0,0,0,71,22,0,93,204,24,321
5110217,3,0,3,68,26,0,94,148,12,254
5110218,3,0,3,70,35,0,105,248,40,393
5110219,0,0,0,77,30,0,107,255,51,413
5110220,3,0,3,54,23,0,77,221,21,319
5110221,3,0,3,26,15,3,44,167,30,241
5110222,0,0,0,67,22,0,89,220,30,339
5110301,3,0,3,346,79,10,435,593,60,1088
5110302,3,0,3,188,36,6,230,396,20,646
5110303,0,0,0,6,0,0,6,9,0,15
5110304,0,0,0,3,0,0,3,0,0,3
5110305,0,0,0,0,0,0,0,0,0,0
5110306,0,0,0,105,22,7,134,138,10,282
5110307,0,0,0,96,16,0,112,128,4,244
5110308,3,0,3,121,38,8,167,263,9,439
5110309,3,0,3,67,14,0,81,159,15,255
5110310,4,0,4,107,26,8,141,139,6,286
5110311,0,0,0,71,12,9,92,119,6,217
5110312,0,0,0,92,12,6,110,171,9,290
5110313,0,0,0,96,26,4,126,189,15,330
5110314,9,0,9,116,41,0,157,279,40,476
5110315,0,0,0,124,37,6,167,233,18,418
5110316,0,0,0,61,31,0,92,200,10,302
5110317,0,0,0,0,0,0,0,0,0,0
5110318,0,0,0,3,3,0,6,18,0,24
5110319,0,0,0,93,3,6,102,175,18,295
5110320,0,0,0,69,4,0,73,141,15,229
5110321,0,0,0,107,31,10,148,146,6,300
5110322,4,0,4,91,36,3,130,181,12,323
5110323,24,59,83,43,23,0,66,285,131,482
5110324,5,0,5,129,30,9,168,301,15,484
5110325,3,0,3,199,52,4,255,436,30,721
5110326,0,0,0,106,19,11,136,246,15,397
5110327,0,0,0,309,54,24,387,567,29,983
5110328,0,0,0,86,11,12,109,143,14,266
5110329,0,0,0,128,30,0,158,203,19,380
5110330,7,0,7,255,56,18,329,456,38,823
5110331,0,0,0,223,61,4,288,568,59,915
5110332,0,0,0,411,53,18,482,441,36,959
5110333,0,0,0,180,26,15,221,216,10,447
5110334,0,0,0,99,27,5,131,231,10,372
5110335,3,0,3,126,20,6,152,154,12,318
5110336,0,0,0,0,0,0,0,0,0,0
5110401,0,0,0,0,0,0,0,3,0,3
5110402,0,0,0,52,12,0,64,149,19,232
5110403,7,0,7,72,49,0,121,318,16,455
5110404,3,0,3,57,21,4,82,213,22,317
5110405,76,8,84,68,10,6,84,395,46,525
5110406,14,3,17,38,20,6,64,187,27,278
5110407,0,0,0,93,26,0,119,199,30,348
5110408,6,0,6,59,21,6,86,174,15,275
5110409,4,0,4,58,26,0,84,195,4,283
5110410,0,3,3,68,24,3,95,224,24,343
5110411,0,0,0,87,14,9,110,193,24,327
5110412,3,0,3,69,12,3,84,187,24,295
5110413,3,0,3,67,32,8,107,248,22,377
5110414,0,4,4,63,28,0,91,160,37,288
5110415,0,0,0,105,21,12,138,229,12,379
5110416,3,0,3,110,26,3,139,209,41,389
5110417,4,18,22,64,16,4,84,181,59,324
5110418,0,0,0,70,13,3,86,179,11,276
5110419,0,0,0,30,12,0,42,108,12,162
5110420,0,0,0,88,34,4,126,248,18,392
5110421,3,0,3,65,27,0,92,208,15,315
5110422,0,0,0,70,26,3,99,243,31,373
5110423,0,0,0,64,16,9,89,241,13,343
5110424,3,0,3,69,26,6,101,253,23,377
5110425,6,0,6,39,14,0,53,139,9,201
5110426,0,0,0,94,39,0,133,281,21,435
5110501,3,3,6,74,24,7,105,199,27,331
5110502,7,0,7,53,22,3,78,129,16,223
5110503,0,0,0,57,4,4,65,70,19,154
5110504,0,0,0,72,9,6,87,104,9,200
5110505,0,0,0,103,20,9,132,203,15,350
5110506,0,4,4,94,35,3,132,213,21,366
5110507,0,0,0,124,29,6,159,243,25,427
5110508,0,0,0,66,16,0,82,162,33,277
5110509,0,0,0,69,33,6,108,157,15,280
5110510,0,0,0,139,29,9,177,221,30,428
5110511,53,4,57,140,43,12,195,348,38,581
5110512,4,0,4,81,20,6,107,129,4,240
5110513,3,0,3,26,19,13,58,160,9,227
5110514,3,0,3,114,42,7,163,298,11,472
5110515,0,0,0,44,14,0,58,122,7,187
5110516,0,0,0,128,38,0,166,362,43,571
5110517,11,3,14,97,40,0,137,298,25,460
5110518,3,0,3,137,30,4,171,205,18,394
5110519,0,0,0,114,28,0,142,197,12,351
5110520,0,0,0,95,21,15,131,161,18,310
5110521,3,0,3,304,57,9,370,466,21,857
5110522,3,0,3,141,37,5,183,263,65,511
5110523,0,0,0,134,42,8,184,194,11,389
5110524,6,0,6,61,26,0,87,146,22,255
5110525,0,0,0,195,34,10,239,200,29,468
5110526,0,0,0,83,16,8,107,172,16,295
5110527,3,0,3,88,56,0,144,361,45,550
5110528,0,0,0,48,22,3,73,194,21,288
5110529,0,0,0,150,34,9,193,287,37,517
5110530,3,0,3,76,32,7,115,270,71,456
5110531,3,0,3,89,18,5,112,196,42,350
5110532,0,0,0,0,0,0,0,0,0,0
5110533,0,0,0,0,0,0,0,0,0,0
5110534,0,0,0,85,31,4,120,194,38,352
5110535,0,0,0,183,27,9,219,237,17,473
5110536,0,0,0,74,15,3,92,93,15,200
5110537,3,0,3,111,24,7,142,141,21,304
5110601,0,0,0,0,0,0,0,0,0,0
5110701,0,0,0,103,24,8,135,206,23,364
5110702,0,0,0,133,31,3,167,202,28,397
5110703,7,0,7,41,30,0,71,186,33,290
5110704,4,0,4,33,10,0,43,137,5,185
5110705,0,0,0,62,27,4,93,167,13,273
5110706,0,0,0,42,29,0,71,140,17,228
5110707,0,0,0,115,32,7,154,214,28,396
5110708,3,0,3,116,30,4,150,255,20,425
5110709,22,7,29,0,43,0,43,341,35,419
5110710,0,0,0,105,18,9,132,165,11,308
5110711,0,0,0,105,14,6,125,156,14,295
5110712,0,0,0,89,14,0,103,130,9,242
5110713,3,0,3,105,20,7,132,126,8,266
5110714,0,0,0,105,14,6,125,138,12,275
5110715,0,0,0,228,44,3,275,235,19,529
5110716,0,0,0,180,30,10,220,246,10,476
5110717,0,0,0,233,25,5,263,320,37,620
5110718,3,0,3,254,28,16,298,308,42,648
5110719,0,0,0,143,31,4,178,177,18,373
5110720,14,5,19,0,32,0,32,267,35,334
5110721,0,0,0,134,31,9,174,227,15,416
5110722,0,0,0,128,19,6,153,222,41,416
5110723,0,0,0,105,26,6,137,232,17,386
5110724,0,0,0,62,15,3,80,101,0,181
5110725,0,0,0,212,23,4,239,184,30,453
5110801,0,0,0,64,21,0,85,148,21,254
5110802,0,0,0,100,13,4,117,116,9,242
5110803,0,0,0,0,0,0,0,0,0,0
5110804,0,0,0,170,50,13,233,275,31,539
5110805,0,0,0,215,51,21,287,413,39,739
5110806,6,0,6,51,19,0,70,217,5,292
5110807,0,0,0,94,26,0,120,147,24,291
5110808,0,3,3,39,12,6,57,115,12,184
5110809,0,0,0,302,74,9,385,767,57,1209
5110810,3,0,3,34,26,0,60,164,3,227
5110811,3,0,3,153,33,9,195,206,13,414
5110812,0,0,0,111,20,0,131,234,12,377
5110813,0,0,0,97,32,0,129,269,41,439
5110814,6,0,6,66,26,6,98,149,19,266
5110815,3,0,3,147,50,6,203,434,17,654
5110816,0,3,3,47,15,0,62,151,22,235
5110817,8,0,8,87,32,11,130,277,23,430
5110818,6,3,9,34,14,6,54,144,25,223
5110819,41,0,41,103,34,4,141,393,19,553
5110820,0,4,4,73,28,0,101,211,18,330
5110821,80,5,85,29,8,0,37,327,48,412
5110822,0,0,0,47,18,9,74,112,19,205
5110823,4,0,4,79,34,4,117,238,31,386
5110824,3,0,3,49,34,0,83,168,27,278
5110825,6,0,6,39,14,0,53,143,9,205
5110826,0,3,3,43,13,0,56,126,30,212
5110827,78,0,78,124,38,9,171,396,32,599
5110828,3,0,3,96,28,0,124,228,27,379
5110829,6,3,9,71,47,0,118,264,40,422
5110830,3,0,3,54,12,4,70,191,32,293
5110831,13,0,13,86,25,0,111,273,28,412
5110832,0,3,3,78,26,5,109,228,24,361
5110833,7,0,7,85,31,4,120,293,21,434
5110834,7,0,7,86,46,6,138,377,31,546
5110835,3,0,3,47,40,0,87,262,27,376
5110836,0,0,0,316,74,18,408,534,68,1010
5110837,0,0,0,103,43,6,152,178,24,354
5110838,0,0,0,36,18,0,54,137,3,194
5110839,6,3,9,23,16,0,39,187,23,249
5110840,0,0,0,53,18,3,74,163,20,257
5110841,0,0,0,94,54,3,151,335,35,521
5110842,3,0,3,94,42,6,142,277,15,434
5110843,3,3,6,47,37,3,87,179,15,281
5110844,0,0,0,122,41,13,176,301,19,496
5110845,0,0,0,72,16,9,97,169,13,279
5110846,3,0,3,69,30,3,102,198,21,321
5110847,0,0,0,89,18,6,113,199,9,321
5110901,6,3,9,52,16,6,74,152,30,256
5110902,6,0,6,36,19,0,55,132,16,203
5110903,0,0,0,77,21,0,98,174,27,299
5110904,0,3,3,29,21,6,56,116,27,199
5110905,6,0,6,53,14,0,67,167,33,267
5110906,0,4,4,67,16,3,86,225,34,345
5110907,3,0,3,145,28,6,179,251,12,442
5110908,0,0,0,67,22,3,92,182,31,305
5110909,0,0,0,34,32,6,72,151,17,240
5110910,3,3,6,60,12,0,72,150,30,252
5110911,4,0,4,48,9,6,63,141,21,225
5110912,0,0,0,83,12,0,95,149,24,268
5110913,7,82,89,213,50,12,275,366,207,848
5110914,7,3,10,116,33,11,160,372,53,585
5110915,3,0,3,135,45,3,183,325,64,572
5110916,4,0,4,36,18,3,57,125,25,207
5110917,0,3,3,11,15,0,26,90,12,128
5110918,0,0,0,40,12,0,52,118,15,185
5111001,9,0,9,88,22,0,110,319,65,494
5111002,0,0,0,104,21,6,131,162,15,308
5111003,3,3,6,72,19,5,96,206,38,340
5111004,0,0,0,113,21,6,140,226,18,384
5111005,3,0,3,155,28,15,198,265,42,505
5111006,0,0,0,44,7,3,54,95,11,160
5111007,0,0,0,35,14,0,49,109,17,175
5111008,0,0,0,28,27,3,58,119,21,198
5111009,0,0,0,67,23,0,90,203,51,344
5111010,0,0,0,37,20,6,63,141,18,222
5111011,4,0,4,90,21,8,119,235,54,408
5111012,3,0,3,91,36,10,137,349,48,534
5111013,0,0,0,73,20,0,93,187,13,293
5111014,86,21,107,49,27,9,85,440,77,602
5111015,4,7,11,109,38,4,151,305,38,494
5111016,0,0,0,38,25,0,63,162,42,267
5111017,6,3,9,124,66,0,190,401,82,673
5111018,0,0,0,96,33,6,135,304,32,471
5111019,15,4,19,64,27,0,91,291,51,433
5111020,0,0,0,79,39,3,121,241,27,389
5111021,3,0,3,72,23,6,101,180,45,326
5111022,4,0,4,82,29,6,117,204,42,363
5111023,0,5,5,68,24,3,95,194,43,332
5111024,0,0,0,60,28,0,88,226,25,339
5111025,3,4,7,31,22,3,56,215,30,301
5111026,6,3,9,48,11,3,62,193,36,291
5111027,3,0,3,51,28,0,79,180,32,291
5111028,0,0,0,28,0,3,31,94,12,137
5111029,3,6,9,88,26,6,120,233,42,395
5111030,3,27,30,60,23,5,88,247,116,451
5111031,6,0,6,51,36,0,87,187,17,291
5111032,8,0,8,106,54,11,171,356,24,551
5111033,15,0,15,58,50,7,115,318,49,482
5111034,16,0,16,40,15,0,55,156,24,235
5111035,6,0,6,26,15,5,46,175,25,246
5111101,0,0,0,0,0,0,0,0,0,0
5111201,22,3,25,60,22,6,88,202,32,322
5111202,0,0,0,57,18,7,82,140,21,243
5111203,0,3,3,52,17,3,72,171,30,273
5111204,3,0,3,58,15,10,83,194,18,295
5111205,3,0,3,53,27,0,80,178,26,284
5111206,0,0,0,68,21,3,92,208,17,317
5111207,0,0,0,57,29,7,93,197,28,318
5111208,0,0,0,63,12,6,81,146,5,232
5111209,0,0,0,51,17,0,68,171,65,304
5111210,3,0,3,67,26,6,99,177,25,301
5111211,3,0,3,70,34,0,104,251,40,395
5111212,0,0,0,51,24,0,75,149,11,235
5111213,3,0,3,33,18,0,51,153,33,237
5111214,0,0,0,17,3,0,20,95,15,130
5111215,3,0,3,25,14,3,42,161,18,221
5111301,0,3,3,67,18,10,95,232,21,348
5111302,0,0,0,55,21,9,85,216,34,335
5111303,0,0,0,33,12,6,51,115,18,184
5111304,4,0,4,188,46,6,240,420,33,693
5111305,0,0,0,213,36,5,254,291,46,591
5111306,0,0,0,259,46,9,314,373,23,710
5111307,0,0,0,257,48,12,317,565,39,921
5111308,0,0,0,197,37,9,243,278,23,544
5111309,3,0,3,203,42,9,254,357,31,642
5111310,0,0,0,177,36,6,219,476,22,717
5111401,4,0,4,41,42,0,83,193,18,294
5111402,0,0,0,55,41,4,100,243,43,386
5111403,0,0,0,35,16,8,59,203,45,307
5111404,4,0,4,51,19,6,76,168,26,270
5111405,8,0,8,75,29,0,104,265,27,396
5111406,0,0,0,88,40,3,131,259,16,406
5111407,4,0,4,75,22,11,108,230,5,343
5111408,6,0,6,26,18,3,47,136,18,201
5111409,3,0,3,84,18,5,107,236,17,360
5111410,3,0,3,52,32,6,90,172,33,295
5111411,0,0,0,69,32,6,107,232,44,383
5111412,36,0,36,59,28,6,93,252,43,388
5111413,3,0,6,47,21,3,71,201,21,293
5111414,0,0,0,75,36,6,117,266,54,437
5111415,6,3,9,70,31,6,107,224,59,390
5111416,0,0,0,57,30,3,90,210,46,346
5111417,7,0,7,77,19,10,106,301,41,448
5111418,0,0,0,0,0,0,0,0,0,0
5111419,3,0,3,70,25,3,98,246,27,371
5111420,4,0,4,60,25,4,89,149,14,252
5111421,3,0,3,50,39,3,92,186,9,287
5111422,4,0,4,36,20,0,56,133,12,201
5111423,3,3,6,40,23,0,63,168,21,252
5111424,30,4,34,48,17,6,71,143,13,227
5111425,11,0,11,39,28,3,70,235,79,384
5111426,3,3,6,73,24,7,104,174,22,300
5111501,3,0,3,24,15,0,39,99,0,138
5111502,9,3,12,67,30,6,103,419,64,586
5111503,6,3,9,48,33,3,84,201,48,333
5111504,0,0,0,61,30,0,91,237,9,337
5111505,4,0,4,262,61,12,335,438,28,801
5111506,4,0,4,84,49,0,133,259,23,415
5111507,3,0,3,78,45,0,123,358,64,545
5111508,3,0,6,46,40,3,89,269,22,380
5111509,0,0,0,0,0,0,0,0,0,0
5111510,8,5,13,54,28,4,86,183,26,295
5111511,6,0,6,91,42,7,140,276,18,434
5111512,0,0,0,40,33,0,73,224,24,321
5111513,3,0,3,61,33,0,94,179,6,279
5111514,4,0,4,83,47,3,133,290,25,448
5111515,0,0,0,35,40,3,78,250,13,341
5111516,7,0,7,58,33,6,97,235,34,366
5111601,0,0,0,25,19,0,44,138,3,185
5111602,0,0,0,40,20,3,63,131,6,200
5111603,0,0,0,97,47,6,150,257,10,417
5111604,3,3,6,54,12,0,66,154,8,228
5111605,3,0,3,39,29,0,68,183,11,262
5111606,4,0,4,90,24,0,114,227,9,350
5111607,3,0,3,47,9,0,56,99,3,158
5111608,3,0,3,55,46,0,101,263,23,387
5111609,4,0,7,28,20,3,51,120,10,181
5111610,0,0,0,84,38,3,125,242,6,373
5111611,0,0,0,93,26,6,125,195,12,332
5111612,15,3,18,90,47,9,146,298,28,472
5111613,3,0,3,54,45,7,106,204,25,335
5111614,3,4,7,54,20,6,80,162,13,255
5111615,3,0,3,134,43,11,188,225,14,427
5111616,6,0,6,76,41,6,123,265,9,397
5111617,3,0,3,40,24,3,67,125,9,201
5111618,3,0,3,52,36,6,94,171,13,278
5111701,0,0,0,114,24,9,147,156,8,311
5111702,0,0,0,166,22,18,206,306,37,549
5111703,3,0,3,83,18,6,107,165,19,291
5111704,0,0,0,79,34,0,113,134,22,269
5111705,0,0,0,172,51,9,232,368,50,650
5111706,0,0,0,130,28,18,176,187,39,402
5111707,4,0,4,153,39,6,198,355,61,614
5111708,8,3,11,71,18,9,98,207,49,354
5111709,0,0,0,115,25,7,147,183,26,356
5111710,0,0,0,96,28,6,130,253,11,394
5111711,4,0,4,46,12,9,67,96,15,178
5111712,3,3,6,71,35,3,109,215,21,345
5111713,3,3,6,131,36,9,176,278,35,489
5111714,3,0,3,108,28,11,147,243,28,418
5111715,0,0,0,70,27,0,97,194,39,330
5111716,0,0,0,67,7,8,82,149,29,260
5111717,3,0,3,76,25,0,101,136,15,252
5111718,0,0,0,55,23,3,81,180,25,286
5111801,3,0,3,53,8,0,61,199,37,297
5111802,0,0,0,54,15,3,72,155,62,289
5111803,6,4,10,89,26,6,121,341,68,530
5111804,5,0,5,69,22,9,100,297,58,455
5111805,3,0,3,43,6,0,49,225,25,299
5111806,0,0,0,68,22,7,97,203,30,330
5111807,22,5,27,69,32,6,107,376,56,539
5111808,3,0,3,59,32,0,91,227,26,344
5111809,6,0,6,88,27,3,118,214,34,366
5111810,8,3,11,89,38,0,127,329,59,515
5111811,0,0,0,103,69,4,176,474,43,693
5111812,0,0,0,56,18,0,74,267,38,379
5111813,0,0,0,91,22,6,119,216,42,377
5111814,10,0,10,97,34,3,134,326,29,489
5111815,0,3,3,103,20,12,135,243,59,437
5111816,25,3,28,49,15,0,64,312,46,422
5111817,68,5,73,82,35,0,117,405,69,591
5111818,6,4,10,112,49,4,165,360,65,590
5111819,7,0,7,70,22,0,92,245,50,387
5111820,11,0,11,112,30,0,142,403,48,593
5111821,3,0,3,62,25,3,90,268,47,405
5111822,11,3,14,28,11,0,39,243,67,349
5111823,3,7,10,71,21,0,92,254,45,391
5111824,6,6,12,61,28,3,92,285,92,469
5111825,9,0,9,83,34,3,120,392,41,553
5111901,6,0,6,57,12,3,72,154,22,248
5111902,3,3,6,57,11,0,68,191,24,283
5111903,0,4,4,29,13,3,45,173,31,249
5111904,5,3,8,95,10,4,109,280,62,451
5111905,0,0,0,0,0,0,0,0,0,0
5111906,0,0,0,0,0,0,0,3,0,3
5111907,4,0,4,30,9,0,39,146,22,207
5111908,3,0,3,92,10,4,106,224,12,342
5111909,0,0,0,71,24,3,98,398,78,574
5111910,3,0,3,62,16,3,81,183,21,285
5111911,8,0,8,74,18,12,104,247,21,372
5111912,0,0,0,60,8,0,68,207,6,281
5111913,5,0,5,50,22,0,72,182,9,263
5111914,3,0,3,67,23,3,93,208,16,317
5111915,3,0,3,51,6,0,57,187,15,259
5111916,3,4,7,63,18,3,84,202,25,311
5111917,3,0,3,74,18,6,98,213,15,326
5111918,8,4,12,69,14,3,86,264,27,377
5111919,12,6,18,63,17,3,83,260,35,378
5111920,40,3,43,69,14,7,90,248,25,363
5111921,3,6,9,34,20,3,57,171,13,241
5111922,0,0,0,66,15,0,81,278,41,400
5111923,12,0,12,45,10,3,58,221,15,294
5111924,35,3,38,50,9,0,59,281,27,367
5111925,3,0,3,61,18,0,79,196,43,318
5111926,0,0,0,46,42,3,91,285,57,433
5111927,4,0,4,40,8,3,51,221,18,290
5111928,9,3,12,38,11,0,49,192,36,277
5111929,0,0,0,33,23,6,62,193,27,282
5111930,7,0,7,51,24,4,79,314,43,436
5111931,5,0,5,45,21,3,69,205,35,309
5111932,6,0,6,48,16,4,68,298,26,392
5111933,5,3,8,62,21,0,83,231,32,346
5111934,3,0,3,52,12,3,67,200,37,304
5111935,12,0,12,102,42,5,149,418,36,603
5111936,7,0,7,43,6,0,49,251,35,335
5111937,6,0,6,52,13,3,68,230,21,319
5111938,0,3,3,40,9,0,49,248,21,318
5111939,0,4,4,24,3,0,27,197,44,268
5111940,0,0,0,56,12,3,71,166,23,260
5112001,0,0,0,0,0,0,0,0,0,0
5112101,0,0,0,0,0,0,0,0,54,54
5112201,6,0,6,43,19,0,62,149,19,230
5112202,6,0,6,68,17,5,90,244,25,359
5112203,0,0,0,60,24,6,90,203,14,307
5112204,4,0,4,75,21,0,96,246,19,361
5112205,0,0,0,73,36,9,118,200,23,341
5112206,11,4,15,88,35,9,132,343,32,507
5112207,8,3,11,61,14,3,78,198,15,291
5112208,0,0,0,119,19,13,151,323,42,516
5112209,0,0,0,64,15,0,79,195,36,310
5112210,6,0,6,28,25,6,59,201,21,281
5112211,10,0,10,57,24,0,81,241,27,349
5112212,8,3,11,75,28,0,103,210,24,337
5112213,3,3,6,114,22,0,136,376,42,554
5112214,0,0,0,46,8,0,54,210,32,296
5112215,6,6,12,60,23,0,83,324,41,448
5112216,8,0,8,53,10,0,63,182,33,278
5112217,3,0,3,70,12,6,88,192,17,297
5112218,6,0,6,36,10,4,50,263,36,349
5112219,14,6,20,54,22,0,76,313,56,445
5112220,3,0,3,65,19,0,84,137,24,245
5112221,0,0,0,62,24,0,86,600,103,789
5112222,3,0,3,50,4,0,54,389,95,538
5112223,3,3,6,34,5,0,39,151,30,220
5112224,3,0,3,51,15,0,66,227,24,317
5112225,6,4,10,93,35,0,128,299,39,466
5112226,4,5,9,66,19,0,85,219,24,328
5112227,9,3,12,67,20,0,87,275,29,391
5112228,37,13,50,62,27,0,89,302,61,452
5112229,4,3,7,61,29,0,90,220,18,328
5112230,11,3,14,72,32,0,104,314,21,439
5112231,4,9,13,43,7,0,50,229,71,350
5112232,10,0,10,52,15,0,67,228,67,362
5112233,14,0,14,101,38,0,139,328,45,512
5112234,7,3,10,56,18,6,80,338,42,460
5112235,6,3,9,41,10,0,51,199,39,289
5112236,8,3,11,60,29,3,92,269,28,389
5112237,16,3,19,58,30,0,88,307,41,436
5112238,3,0,3,44,22,0,66,200,42,308
5112239,7,3,10,107,18,4,129,355,42,526
5112240,6,3,9,108,35,12,155,295,68,518
5112241,0,0,0,63,9,9,81,181,27,289
5112242,3,0,3,67,14,0,81,257,35,373
5112243,3,3,6,63,19,0,82,244,21,347
5112244,14,0,14,40,16,0,56,194,32,282
5112245,4,0,4,54,12,7,73,219,16,308
5112246,3,3,6,95,27,0,122,318,28,468
5112247,8,0,8,57,16,3,76,173,31,280
5112248,4,3,7,57,33,10,100,206,53,359
5112301,3,0,3,36,14,0,50,162,4,216
5112302,0,0,0,36,22,0,58,182,15,255
5112303,5,3,12,88,37,12,137,223,21,381
5112304,0,3,3,45,16,3,64,252,29,345
5112305,0,0,0,42,15,3,60,170,22,252
5112306,3,0,3,45,19,3,67,192,48,307
5112307,17,4,21,37,23,0,60,322,71,453
5112308,3,3,9,45,32,0,77,405,140,622
5112309,3,0,3,25,15,6,46,282,105,433
5112310,0,0,0,90,61,0,151,605,77,833
5112311,0,4,4,100,15,5,120,290,33,443
5112312,9,3,12,64,21,4,89,242,12,343
5112313,5,0,5,55,15,6,76,124,18,218
5112314,13,3,16,61,38,0,99,250,30,379
5112315,10,0,10,59,32,3,94,260,15,369
5112316,0,4,4,58,23,8,89,269,34,392
5112317,0,0,0,40,15,0,55,232,18,305
5112318,3,3,6,77,29,3,109,423,45,577
5112319,3,3,6,40,9,0,49,198,35,282
5112320,3,0,3,73,22,3,98,296,28,422
5112321,0,0,0,54,12,3,69,156,16,241
5112322,3,6,9,66,15,6,87,214,18,319
5112323,6,0,6,66,9,0,75,249,23,347
5112324,0,0,0,39,5,0,44,182,3,229
5112325,4,0,4,56,22,0,78,500,57,635
5112326,0,0,0,54,21,0,75,319,58,452
5112327,0,6,6,58,17,3,78,251,45,374
5112328,0,0,0,52,18,0,70,355,37,462
5112329,0,0,0,32,8,0,40,205,69,314
5112330,0,0,0,31,3,0,34,209,78,321
5112331,0,0,0,0,0,0,0,0,0,0
5112332,3,3,6,55,30,3,88,289,85,462
5112401,7,3,10,47,17,0,64,215,36,315
5112402,0,0,0,49,12,3,64,160,56,280
5112403,13,0,13,34,19,0,53,293,36,382
5112404,7,3,10,61,15,0,76,281,46,403
5112405,5,0,5,37,25,3,65,302,48,415
5112406,0,0,0,59,19,3,81,383,47,511
5112407,4,0,4,28,12,0,40,208,27,275
5112408,3,4,7,33,17,0,50,215,49,314
5112409,11,0,11,96,34,6,136,531,77,744
5112410,5,0,5,49,13,3,65,300,31,396
5112411,6,0,6,61,29,3,93,358,55,506
5112412,0,0,0,0,6,0,6,452,19,477
5112413,3,3,6,47,24,6,77,204,26,307
5112414,47,9,56,31,16,4,51,199,27,277
5112415,3,0,3,69,40,6,115,319,46,480
5112416,4,0,4,88,48,3,139,372,21,532
5112417,80,108,188,0,13,0,13,255,264,532
5112418,7,5,12,104,22,6,132,276,52,460
5112419,3,0,3,85,9,4,98,348,40,486
5112420,293,137,434,0,15,0,15,620,228,863
5112421,0,0,0,46,15,0,61,184,15,260
5112422,27,0,27,34,3,3,40,279,42,361
5112423,9,5,14,92,29,0,121,293,34,448
5112424,0,0,0,45,25,0,70,168,17,255
5112425,3,0,3,113,43,3,159,456,33,648
5112426,3,0,3,13,6,0,19,537,95,651
5112427,14,0,14,18,18,3,39,343,80,462
5112428,10,0,10,110,23,4,137,400,40,577
5112429,4,0,4,40,6,0,46,148,32,226
5112430,8,9,17,73,27,4,104,319,52,475
5112431,7,0,7,37,19,0,56,265,29,350
5112432,3,0,3,25,10,0,35,426,72,533
5112433,0,3,3,27,8,0,35,241,43,319
5112434,9,3,12,70,21,3,94,382,49,525
5112435,0,3,3,49,5,3,57,295,55,407
5112436,8,0,8,51,17,3,71,272,29,372
5112437,6,3,9,48,9,0,57,467,38,562
5112438,25,0,25,70,27,6,103,424,52,579
5112439,17,3,20,23,6,0,29,173,25,227
5112501,0,3,3,50,28,3,81,210,9,300
5112502,0,0,0,76,18,0,94,199,9,302
5112503,5,3,8,132,46,9,187,459,28,674
5112504,0,0,0,86,28,3,117,253,9,379
5112505,0,0,0,59,11,0,70,190,15,275
5112506,0,0,0,114,22,9,145,277,20,442
5112507,0,0,0,106,13,10,129,250,18,397
5112508,0,0,0,104,21,3,128,212,15,355
5112509,0,0,0,70,18,3,91,154,9,254
5112510,3,0,3,33,12,0,45,151,19,215
5112511,0,0,0,66,28,3,97,245,9,351
5112512,0,0,0,66,13,9,88,206,9,303
5112513,0,0,0,70,21,7,98,173,3,274
5112514,3,0,3,67,24,0,91,192,0,283
5112515,3,0,3,105,24,0,129,185,6,320
5112516,0,0,0,21,12,0,33,116,10,159
5112517,0,0,0,87,42,3,132,280,6,418
5112518,3,0,3,60,0,6,66,129,6,201
5112519,4,0,4,118,27,6,151,283,16,450
5112520,0,0,0,76,22,8,106,185,18,309
5112521,0,0,0,49,14,0,63,147,6,216
5112522,5,0,5,106,20,0,126,281,22,429
5112523,0,0,0,109,44,9,162,254,9,425
5112524,0,0,0,47,13,6,66,168,8,242
5112601,0,0,0,0,0,0,0,0,0,0
5112701,3,0,3,50,20,0,70,176,16,262
5112702,5,0,5,72,32,3,107,224,19,350
5112703,0,6,6,126,34,3,163,487,90,740
5112704,3,0,3,83,39,9,131,234,18,383
5112705,6,3,9,135,29,0,164,429,61,654
5112706,6,3,9,79,16,3,98,330,42,470
5112707,4,0,4,92,27,9,128,298,25,451
5112708,0,3,3,84,36,3,123,190,19,332
5112709,3,3,6,103,39,3,145,432,39,616
5112710,6,3,9,104,22,0,126,368,77,571
5112711,9,0,9,108,51,3,162,439,54,655
5112712,15,6,21,145,19,0,164,428,43,635
5112713,3,0,3,123,21,3,147,459,56,662
5112714,0,0,0,81,28,0,109,271,30,410
5112715,4,0,4,81,24,6,111,279,26,416
5112716,5,0,5,84,17,3,104,210,9,323
5112717,0,0,0,126,21,8,155,430,81,666
5112718,0,0,0,64,25,3,92,377,80,549
5112719,3,3,6,59,14,0,73,222,47,342
5112720,10,8,18,59,22,0,81,305,70,456
5112721,7,0,7,64,26,3,93,349,47,489
5112722,0,4,4,34,14,0,48,179,18,245
5112723,4,0,4,19,26,0,45,196,33,274
5112724,4,0,4,57,15,3,75,345,87,507
5112725,5,0,5,56,13,3,72,307,56,435
5112726,3,0,3,54,16,0,70,336,73,479
5112801,0,0,0,37,7,3,47,113,6,166
5112802,4,0,4,43,24,3,70,195,8,273
5112803,7,0,7,56,15,0,71,168,12,251
5112804,3,0,3,59,20,5,84,146,18,248
5112805,0,0,0,30,39,0,69,196,18,283
5112806,4,0,4,46,18,0,64,159,15,238
5112807,0,0,0,48,23,0,71,146,8,225
5112808,0,0,0,0,0,0,0,0,0,0
5112809,7,3,10,75,40,3,118,355,34,507
5112810,0,3,3,41,19,0,60,165,29,254
5112811,3,0,3,51,20,3,74,138,3,215
5112812,3,0,3,59,35,3,97,200,18,315
5112813,8,8,16,95,52,3,150,267,40,457
5112814,3,3,6,64,28,6,98,208,30,336
5112815,0,4,4,45,39,0,84,225,32,341
5112816,3,4,7,48,31,9,88,166,10,264
5112817,65,9,74,97,54,7,158,435,26,619
5112818,5,4,9,86,17,12,115,279,17,411
5112819,19,0,19,75,39,0,114,344,29,487
5112820,6,3,12,64,18,5,87,172,15,274
5112821,4,0,4,38,0,3,41,116,5,162
5112822,6,0,6,52,17,0,69,215,30,314
5112823,3,3,6,68,12,0,80,201,21,302
5112824,0,0,0,40,31,0,71,236,21,328
5112825,6,0,6,84,24,3,111,335,24,470
5112826,6,3,9,58,44,0,102,272,18,392
5112827,0,0,0,49,19,0,68,213,18,299
5112828,3,0,3,38,10,0,48,155,3,206
5112829,0,0,0,74,19,0,93,166,6,265
5112830,3,0,3,71,39,9,119,301,30,450
5112831,5,0,5,82,30,0,112,341,30,483
5112832,6,3,9,70,29,3,102,317,18,437
5112833,0,0,0,40,22,0,62,178,15,255
5112834,8,0,8,80,32,5,117,182,15,314
5112835,6,3,9,68,47,0,115,275,13,403
5112901,4,0,4,57,30,3,90,253,54,397
5112902,0,0,0,44,8,0,52,186,18,256
5112903,3,0,3,69,38,0,107,184,10,301
5112904,3,0,3,52,21,9,82,190,30,302
5112905,6,0,6,39,24,6,69,167,6,242
5112906,15,6,21,102,28,0,130,333,35,498
5112907,3,0,3,48,30,3,81,154,12,247
5112908,91,10,101,32,3,3,38,273,15,326
5112909,5,0,5,91,22,0,113,232,15,360
5112910,3,0,3,29,7,0,36,90,12,138
5112911,3,0,3,70,18,4,92,227,24,343
5112912,4,0,4,84,36,0,120,260,25,405
5112913,4,3,7,91,43,0,134,346,34,514
5112914,3,0,3,58,25,0,83,211,20,314
5112915,0,0,0,54,22,6,82,207,9,298
5112916,0,0,0,61,12,4,77,120,19,216
5112917,84,20,104,70,31,4,105,350,42,497
5112918,0,0,0,50,41,0,91,148,7,246
5112919,3,0,3,42,15,0,57,113,10,180
5112920,0,3,6,79,39,6,124,254,21,399
5112921,6,3,9,81,32,3,116,198,34,348
5112922,5,0,5,58,30,3,91,215,28,334
5112923,6,0,6,102,39,6,147,253,35,435
5112924,0,0,0,73,19,0,92,247,33,372
5112925,8,3,11,79,30,3,112,292,22,426
5112926,6,0,6,99,52,6,157,329,20,506
5112927,11,0,11,76,45,6,127,360,28,515
5112928,6,0,6,54,35,0,89,175,7,271
5112929,6,0,6,41,12,6,59,155,30,244
5112930,0,3,3,38,29,0,67,123,3,193
5112931,3,0,3,21,21,3,45,153,3,201
5112932,6,3,9,66,26,6,98,258,25,381
5112933,0,0,0,18,9,3,30,76,15,121
5113001,0,0,0,3,0,0,3,12,3,18
5113101,4,0,4,71,33,3,107,208,12,327
5113102,4,0,4,100,37,0,137,236,15,388
5113103,40,5,45,44,14,3,61,208,16,285
5113104,8,0,8,58,23,3,84,161,13,258
5113105,4,0,4,89,24,3,116,247,20,383
5113106,3,0,3,49,9,3,61,208,10,279
5113107,0,0,0,47,15,3,65,190,12,267
5113108,3,0,3,68,24,6,98,281,18,397
5113109,0,0,0,63,26,3,92,311,12,415
5113110,0,0,0,97,42,0,139,279,10,428
5113111,0,0,0,57,18,0,75,194,3,272
5113112,0,0,0,103,35,6,144,232,9,385
5113113,4,0,4,71,28,0,99,258,23,380
5113114,5,0,5,68,34,0,102,259,13,374
5113115,5,0,5,65,23,0,88,221,24,333
5113116,6,0,6,69,22,0,91,183,18,292
5113117,9,0,9,68,26,0,94,194,8,296
5113118,0,0,0,103,29,8,140,251,10,401
5113119,0,0,0,85,13,3,101,210,16,327
5113120,7,0,7,64,53,0,117,349,24,490
5113121,3,0,3,43,11,0,54,137,6,197
5113122,0,0,0,44,26,0,70,165,0,235
5113123,6,0,6,79,37,0,116,283,9,408
5113124,0,0,0,47,25,6,78,186,0,264
5113125,5,0,5,85,38,3,126,293,25,444
5113126,3,0,3,73,38,6,117,227,6,350
5113127,3,0,3,66,41,0,107,262,9,378
5113128,3,0,3,66,33,9,108,221,9,338
5113129,0,0,0,71,52,8,131,356,18,505
5113130,3,0,6,97,27,0,124,259,20,403
5113131,7,0,7,98,35,5,138,322,31,491
5113132,0,0,0,123,35,3,161,297,13,471
5113133,3,3,6,104,50,12,166,249,15,430
5113134,6,3,9,75,43,12,130,268,15,413
5113135,0,0,0,62,10,0,72,199,12,283
5113136,3,3,6,71,58,3,132,209,18,359
5113137,7,0,7,104,61,3,168,305,22,495
5113138,0,0,0,98,30,3,131,281,20,432
5113139,0,0,0,80,25,3,108,210,11,329
5113201,0,0,0,48,11,3,62,246,43,351
5113202,0,0,0,78,24,0,102,179,15,296
5113203,0,0,0,64,20,9,93,194,30,317
5113204,8,6,14,66,40,0,106,257,56,419
5113205,3,3,6,88,33,4,125,229,51,405
5113206,0,0,0,93,31,0,124,289,47,460
5113207,0,0,0,27,13,3,43,117,9,169
5113208,0,0,0,35,15,0,50,129,17,196
5113209,0,0,0,0,0,0,0,0,0,0
5113210,0,0,0,26,13,0,39,157,20,216
5113211,0,0,0,109,23,0,132,241,35,408
5113212,7,0,7,42,18,5,65,180,12,257
5113213,4,0,4,54,30,0,84,244,22,350
5113214,0,0,0,63,22,0,85,213,31,329
5113215,0,0,0,39,22,4,65,172,13,250
5113216,0,0,0,48,19,0,67,188,15,270
5113217,3,0,3,93,23,5,121,317,31,469
5113218,0,0,0,76,50,0,126,277,13,416
5113219,0,0,0,70,31,9,110,235,18,363
5113220,3,0,3,41,19,0,60,193,25,278
5113221,0,0,0,78,19,0,97,155,36,288
5113222,0,4,4,75,30,3,108,186,52,346
5113223,0,0,0,51,21,9,81,202,14,297
5113224,0,0,0,103,16,6,125,268,59,452
5113225,5,0,5,53,21,0,74,201,53,328
5113226,6,3,9,88,32,8,128,293,39,460
5113227,0,0,0,53,10,3,66,150,24,240
5113228,6,0,6,39,12,0,51,155,38,244
5113229,0,0,0,59,14,0,73,198,22,293
5113230,3,3,6,132,27,6,165,331,48,544
5113231,0,0,0,60,16,3,79,188,13,280
5113232,0,0,0,78,26,12,116,205,57,378
5113233,4,0,4,100,30,0,130,350,55,535
5113234,0,3,3,88,27,0,115,235,34,384
5113235,3,3,6,53,17,0,70,177,28,275
5113236,0,0,0,99,25,9,133,232,72,437
5113237,6,0,6,49,24,0,73,153,9,235
5113238,0,0,0,70,28,0,98,274,24,396
5113239,6,0,6,70,16,3,89,210,15,314
5113240,3,3,6,66,35,0,101,295,35,431
5113241,0,0,0,21,10,3,34,123,9,166
5113242,0,0,0,50,22,3,75,179,18,272
5113243,0,3,3,38,9,0,47,107,27,181
5113301,0,0,0,82,22,0,104,162,17,283
5113302,4,0,4,165,16,0,181,263,61,505
5113303,0,0,0,72,15,0,87,179,12,278
5113304,19,0,19,183,54,5,242,517,55,814
5113305,0,0,0,102,15,5,122,252,89,463
5113306,0,0,0,68,21,4,93,160,4,257
5113307,3,0,3,72,32,0,104,201,16,321
5113308,3,0,3,266,47,14,327,465,56,848
5113309,0,0,0,56,34,6,96,177,24,297
5113310,0,0,0,91,42,6,139,278,16,433
5113311,0,0,0,77,29,6,112,177,6,295
5113312,0,0,0,85,29,3,117,227,9,353
5113313,0,0,0,100,27,6,133,251,18,402
5113314,3,0,3,257,56,15,328,394,100,822
5113315,3,0,3,175,26,7,208,362,54,624
5113316,0,0,0,112,22,6,140,278,17,435
5113317,0,0,0,87,22,0,109,255,16,380
5113318,0,0,0,165,33,4,202,285,21,508
5113319,0,0,0,178,30,16,224,309,38,571
5113320,3,0,3,206,30,0,236,352,41,629
5113321,0,0,0,191,56,7,254,472,35,761
5113322,0,0,0,98,46,7,151,251,15,417
5113323,0,0,0,77,24,0,101,230,12,343
5113324,0,0,0,125,23,3,151,257,10,418
5113325,0,0,0,79,10,6,95,179,6,280
5113326,0,0,0,65,20,6,91,150,4,245
5113327,0,0,0,68,22,0,90,187,0,277
5113328,0,0,0,117,28,4,149,235,24,408
5113329,0,0,0,75,18,0,93,133,3,229
5113330,38,3,41,100,36,3,139,475,43,657
5113331,0,0,0,125,37,3,165,252,48,465
5113332,0,0,0,60,11,6,77,140,13,230
5113333,0,0,0,221,26,7,254,376,61,691
5113334,0,0,0,0,0,0,0,0,0,0
5113335,0,0,0,0,0,0,0,10,765,775
5113401,0,0,0,36,19,3,58,111,7,176
5113402,0,0,0,55,24,0,79,172,25,276
5113403,3,0,3,73,34,4,111,289,31,431
5113404,0,0,0,58,13,0,71,125,21,217
5113405,50,65,119,3,18,0,21,203,115,339
5113406,0,0,0,97,15,4,116,157,10,283
5113407,9,0,9,30,18,0,48,143,23,214
5113408,21,44,65,39,22,0,61,261,112,434
5113409,0,0,0,49,28,6,83,153,28,264
5113410,0,0,0,56,14,0,70,186,28,284
5113411,3,0,3,89,29,6,124,275,26,425
5113412,0,0,0,58,37,0,95,232,24,351
5113413,3,0,3,64,26,6,96,210,22,328
5113414,14,5,19,68,36,6,110,364,92,566
5113415,0,0,0,0,0,0,0,3,0,3
5113416,0,0,0,126,25,11,162,276,52,490
5113417,0,0,0,59,20,5,84,165,20,269
5113418,9,0,9,57,31,0,88,223,37,348
5113419,3,0,3,35,15,3,53,122,15,190
5113420,0,0,0,84,26,6,116,230,33,379
5113421,6,3,9,80,28,6,114,299,50,463
5113422,6,0,6,43,28,0,71,209,42,322
5113423,3,0,3,13,9,3,25,83,0,108
5113424,0,0,0,96,32,3,131,254,39,424
5113425,0,5,5,57,33,0,90,221,56,367
5113426,3,0,3,67,25,5,97,205,37,339
5113427,0,0,0,75,31,11,117,214,28,359
5113428,3,0,3,57,27,6,90,142,27,259
5113429,3,0,3,61,16,0,77,148,26,251
5113430,3,0,3,47,26,3,76,175,31,282
5113431,0,0,0,43,9,6,58,116,20,194
5113432,3,0,3,59,21,0,80,194,45,319
5113433,7,0,7,116,33,10,159,261,65,485
5113434,0,0,0,51,33,9,93,192,40,325
5113435,0,0,0,42,15,9,66,131,27,224
5113436,25,8,37,57,43,0,100,336,96,532
5113437,0,3,3,46,21,3,70,145,43,258
5113438,0,4,4,95,36,12,143,267,48,458
5113439,0,0,0,82,25,0,107,246,45,398
5113440,3,0,3,59,27,5,91,199,49,339
5113441,0,0,0,145,36,15,196,213,55,464
5113442,66,12,78,6,28,0,34,479,54,567
5113443,6,0,6,67,28,3,98,221,72,391
5113444,0,0,0,68,20,10,98,197,31,326
5113445,5,0,5,75,22,0,97,230,17,344
5113446,0,0,0,49,20,7,76,203,23,302
5113501,8,0,8,95,40,0,135,232,25,392
5113502,0,0,0,94,29,5,128,172,21,321
5113503,0,0,0,51,12,0,63,106,15,184
5113504,0,0,0,142,39,6,187,317,56,560
5113505,3,0,3,158,38,0,196,261,39,496
5113506,0,0,0,224,40,4,268,337,29,634
5113507,0,0,0,124,17,5,146,221,15,382
5113508,0,0,0,110,34,0,144,232,3,379
5113509,0,0,0,95,37,4,136,238,12,386
5113510,0,0,0,58,47,4,109,235,9,353
5113511,3,0,3,86,34,7,127,252,25,404
5113512,4,0,4,94,43,11,148,345,35,528
5113513,4,4,8,113,34,9,156,322,35,513
5113514,21,0,21,112,49,9,170,319,39,528
5113515,0,0,0,123,36,5,164,367,35,566
5113516,3,0,3,180,31,7,218,336,33,587
5113517,0,0,0,68,20,0,88,162,15,265
5113518,0,0,0,86,34,3,123,217,18,358
5113519,0,0,0,77,21,3,101,119,12,232
5113520,3,0,3,34,16,3,53,112,4,169
5113521,0,0,0,80,30,6,116,165,13,294
5113522,4,0,4,166,40,13,219,305,26,550
5113523,0,0,0,141,26,3,170,256,13,439
5113524,3,3,6,40,28,4,72,232,9,313
5113525,0,3,3,20,14,0,34,58,12,104
5113526,0,0,0,356,53,13,422,533,50,1005
5113601,3,0,3,41,21,0,62,121,13,196
5113602,0,0,0,63,16,3,82,175,27,284
5113603,3,0,3,33,21,0,54,152,28,234
5113604,3,0,3,37,22,4,63,244,32,339
5113605,0,0,0,35,15,0,50,101,0,151
5113606,4,0,4,102,37,3,142,277,25,444
5113607,3,0,3,35,24,0,59,140,30,229
5113608,8,4,12,65,26,3,94,234,56,384
5113609,3,0,6,50,28,0,78,231,41,350
5113610,3,3,6,21,11,4,36,151,87,274
5113611,4,0,4,60,27,6,93,197,40,330
5113612,0,0,0,72,12,0,84,157,27,268
5113613,27,11,41,31,26,0,57,361,69,487
5113614,6,3,9,94,44,9,147,325,35,507
5113615,3,3,6,95,38,3,136,330,39,505
5113616,0,3,3,56,30,6,92,251,45,388
5113617,0,0,0,55,14,0,69,160,45,274
5113618,4,0,4,122,30,0,152,228,19,399
5113619,3,0,3,51,15,3,69,224,22,315
5113620,0,0,0,90,16,0,106,189,23,318
5113621,25,0,25,103,27,6,136,271,25,432
5113622,0,3,3,17,6,0,23,90,12,125
5113623,3,0,3,38,11,7,56,123,7,186
5113624,0,0,0,48,30,7,85,190,7,282
5113625,24,4,28,48,32,0,80,367,43,490
5113626,4,0,4,44,19,0,63,168,18,249
5113627,3,6,9,37,25,3,65,158,24,247
5113628,9,15,24,47,24,0,71,243,46,360
5113629,0,0,0,144,27,5,176,257,81,514
5113701,0,0,0,49,14,4,67,159,5,231
5113702,0,0,0,83,18,0,101,211,8,320
5113703,0,0,0,63,22,3,88,179,26,293
5113704,0,0,0,58,27,3,88,302,23,413
5113705,0,0,0,77,26,0,103,230,30,363
5113706,0,0,0,68,23,6,97,249,24,370
5113707,6,0,6,45,25,0,70,149,19,238
5113708,4,0,4,95,40,6,141,320,12,473
5113709,8,0,8,91,31,0,122,296,59,477
5113710,0,0,0,36,25,0,61,181,3,245
5113711,0,0,0,68,27,6,101,200,10,311
5113712,0,0,0,80,26,6,112,212,3,327
5113713,13,0,13,40,28,3,71,264,22,357
5113714,6,0,6,38,28,9,75,143,22,240
5113715,4,0,4,48,29,9,86,192,24,302
5113716,6,0,6,63,28,0,91,199,15,305
5113717,8,0,8,66,25,3,94,158,55,307
5113718,0,0,0,103,31,6,140,202,0,342
5113719,0,0,0,77,31,3,111,340,22,473
5113720,3,0,3,55,27,0,82,121,9,212
5113721,0,0,0,73,41,7,121,226,27,374
5113722,0,0,0,46,18,0,64,125,15,204
5113723,6,0,6,66,29,3,98,257,19,374
5113724,3,0,3,82,50,4,136,289,23,448
5113725,3,0,3,61,25,5,91,177,32,300
5113726,7,0,7,71,36,6,113,252,17,382
5113727,3,0,3,62,10,0,72,151,21,244
5113728,6,0,6,56,27,3,86,234,30,350
5113729,3,0,3,60,38,0,98,198,16,312
5113730,3,0,3,64,33,0,97,199,21,317
5113731,6,0,6,60,49,3,112,269,33,414
5113732,0,0,0,69,16,3,88,215,24,327
5113733,3,3,6,40,17,0,57,113,21,191
5113734,7,0,7,65,29,3,97,197,32,326
5113735,0,0,0,53,33,0,86,186,17,289
5113736,0,0,0,150,34,9,193,369,27,589
5113737,0,0,0,66,11,0,77,197,17,291
5113738,3,0,3,74,18,7,99,160,7,266
5113739,0,0,0,96,25,6,127,237,28,392
5113740,0,0,0,58,30,0,88,179,29,296
5113741,3,0,3,40,35,3,78,175,16,269
5113742,3,0,3,44,22,7,73,213,23,309
5113743,0,0,0,56,15,3,74,174,14,262
5113744,0,0,0,76,20,3,99,145,10,254
5113745,3,0,3,55,15,3,73,153,21,247
5113746,0,0,0,33,17,0,50,123,6,179
5113747,8,3,11,30,27,0,57,214,39,310
5113748,9,0,9,59,63,12,134,289,11,434
5113749,3,0,3,62,34,3,99,247,27,373
5113750,4,0,4,50,39,4,93,167,10,270
5113751,0,0,0,69,34,0,103,243,25,371
5113752,3,0,3,40,11,0,51,149,0,200
5113753,3,0,3,60,26,0,86,127,17,230
5113754,3,0,3,47,20,6,73,129,21,223
5113755,7,0,7,77,49,3,129,275,18,422
5113756,3,0,3,28,13,3,44,117,3,164
5113757,0,0,0,79,19,3,101,162,10,273
5113758,4,0,4,65,22,3,90,180,15,285
5113759,0,0,0,0,0,0,0,0,0,0
5113801,0,0,0,26,10,3,39,114,9,162
5113802,0,0,0,184,53,7,244,397,31,672
5113803,0,0,0,130,18,7,155,181,12,348
5113804,3,0,3,117,23,11,151,251,26,428
5113805,0,0,0,219,48,12,279,395,40,714
5113806,0,0,0,0,0,0,0,0,0,0
5113807,3,0,3,62,22,0,84,195,45,324
5113808,47,4,51,29,29,0,58,278,18,354
5113809,9,4,13,23,17,3,43,154,20,217
5113810,4,0,4,59,19,4,82,210,4,296
5113811,0,0,0,40,32,0,72,172,21,265
5113812,6,0,6,22,18,0,40,147,22,209
5113813,6,0,6,65,36,0,101,288,18,407
5113814,22,12,34,93,31,3,127,296,46,469
5113815,3,0,3,71,34,3,108,189,28,325
5113816,0,0,0,40,3,4,47,106,6,159
5113817,0,0,0,0,0,0,0,0,0,0
5113818,3,0,3,66,23,3,92,160,14,266
5113819,3,0,3,65,35,3,103,249,25,377
5113820,3,0,3,69,40,0,109,200,15,324
5113821,6,0,6,56,17,6,79,242,30,351
5113822,6,0,6,73,38,0,111,311,40,462
5113823,0,0,0,69,22,0,91,172,37,300
5113824,3,0,3,40,19,4,63,165,14,242
5113825,0,0,0,54,22,3,79,273,42,394
5113826,3,0,3,95,30,3,128,244,27,399
5113827,6,6,12,42,20,3,65,161,18,244
5113828,0,0,0,48,34,0,82,200,15,297
5113829,0,0,0,166,45,7,218,327,28,573
5113830,0,0,0,185,38,9,232,356,25,613
5113831,0,0,0,68,35,3,106,160,15,281
5113832,8,0,8,82,27,6,115,219,33,367
5113833,5,0,5,76,43,3,122,278,31,431
5113834,6,0,6,41,33,8,82,243,27,352
5113835,0,0,0,46,23,6,75,162,27,264
5113836,0,0,0,61,28,3,92,193,43,328
5113837,3,0,3,96,32,3,131,281,17,429
5113838,0,0,0,0,0,0,0,0,0,0
5113839,0,0,0,0,0,0,0,0,0,0
5113901,7,0,7,35,25,0,60,162,6,228
5113902,0,0,0,112,24,0,136,226,31,393
5113903,0,0,0,81,41,6,128,259,38,425
5113904,0,4,4,84,25,9,118,262,32,412
5113905,6,0,6,147,49,7,203,287,34,524
5113906,8,0,8,83,62,6,151,518,52,721
5113907,5,0,5,50,29,0,79,167,25,271
5113908,0,0,0,72,38,3,113,177,21,311
5113909,0,0,0,81,19,6,106,196,12,314
5113910,0,0,0,52,7,0,59,115,14,188
5113911,0,0,0,107,39,9,155,240,58,453
5113912,0,0,0,174,37,12,223,367,76,666
5113913,0,0,0,54,26,6,86,178,19,283
5113914,3,0,3,58,20,10,88,187,18,293
5113915,0,0,0,79,19,9,107,222,25,354
5113916,0,0,0,46,12,0,58,104,23,185
5113917,3,0,3,57,11,0,68,145,21,234
5113918,3,3,6,104,35,0,139,291,39,469
5113919,0,0,0,82,26,4,112,242,10,364
5113920,0,0,0,70,24,3,97,216,53,366
5113921,3,0,3,93,33,6,132,226,15,373
5113922,5,0,5,68,29,12,109,272,30,411
5113923,0,0,3,98,46,4,148,264,39,451
5113924,11,3,14,53,32,6,91,209,22,322
5113925,9,3,12,46,17,3,66,194,24,284
5114001,3,0,3,69,42,6,117,299,15,431
5114002,5,0,5,54,23,3,80,221,36,337
5114003,0,0,0,74,19,6,99,186,15,300
5114004,0,0,0,55,28,6,89,153,18,260
5114005,3,0,3,61,32,4,97,229,10,336
5114006,25,7,32,44,41,0,85,293,28,406
5114007,0,0,0,57,28,0,85,188,20,293
5114008,10,0,10,49,39,0,88,200,12,300
5114009,6,0,6,93,45,9,147,261,33,441
5114010,5,0,5,43,45,3,91,206,16,313
5114011,0,0,0,49,23,4,76,113,6,195
5114012,10,0,10,62,31,3,96,271,24,391
5114013,12,0,12,75,39,6,120,285,31,436
5114014,0,0,0,57,45,0,102,165,9,276
5114015,6,0,6,82,57,3,142,297,18,457
5114016,3,0,3,123,35,8,166,274,42,482
5114017,0,3,3,91,29,0,120,195,22,337
5114018,0,4,4,53,20,3,76,216,20,312
5114019,6,0,6,65,54,0,119,286,19,424
5114020,5,0,5,61,25,7,93,180,21,294
5114021,3,3,6,62,32,3,97,239,29,365
5114022,6,3,9,58,22,0,80,186,15,281
5114023,33,14,47,29,44,0,73,282,35,390
5114024,8,0,8,58,45,0,103,343,26,472
5114025,6,0,6,41,22,0,63,178,6,247
5114026,3,0,3,62,33,3,98,246,34,378
5114027,0,0,0,77,44,15,136,261,25,422
5114028,7,3,10,66,29,0,95,216,35,346
5114029,0,3,3,43,25,3,71,124,12,207
5114030,0,0,0,50,21,0,71,133,19,223
5114031,3,3,6,51,19,0,70,156,15,241
5114032,4,3,7,110,64,8,182,345,32,559
5114033,4,0,4,60,22,6,88,225,14,327
5114034,12,7,19,102,56,7,165,341,29,535
5114035,0,0,0,4,0,0,4,0,0,4
5114101,0,0,0,0,0,0,0,6,0,6
5114102,0,0,0,14,4,3,21,98,3,122
5114103,49,9,58,61,19,6,86,237,24,347
5114104,4,0,4,86,36,0,122,235,14,371
5114105,3,0,3,62,30,3,95,238,12,345
5114106,0,0,0,69,25,6,100,149,17,266
5114107,0,0,0,59,20,0,79,160,6,245
5114108,4,0,4,102,52,9,163,244,15,422
5114109,0,0,0,45,18,3,66,136,18,220
5114110,3,0,3,86,23,3,112,223,9,344
5114111,4,0,4,58,27,0,85,158,13,256
5114112,7,0,7,52,22,6,80,165,24,269
5114113,3,4,7,65,55,3,123,219,28,370
5114114,3,0,3,74,33,6,113,210,30,353
5114115,3,0,3,22,13,6,41,88,6,135
5114116,0,36,36,61,26,6,93,144,67,304
5114117,6,0,6,32,36,0,68,151,14,233
5114118,0,0,0,40,31,3,74,148,12,234
5114119,3,0,3,60,27,6,93,160,16,269
5114120,0,0,0,36,20,3,59,198,21,278
5114121,6,0,6,76,33,7,116,206,10,332
5114122,0,0,0,46,27,0,73,116,16,205
5114123,6,0,6,31,10,5,46,93,9,148
5114124,3,0,3,50,18,10,78,163,39,280
5114125,3,0,3,67,31,3,101,181,23,305
5114126,5,0,5,69,42,6,117,241,16,374
5114127,20,5,25,55,45,7,107,279,27,413
5114128,3,0,3,53,23,14,90,158,6,254
5114129,7,0,7,52,28,6,86,138,12,236
5114130,3,0,3,45,14,6,65,137,15,217
5114131,4,0,4,96,27,7,130,225,31,386
5114132,24,6,30,29,17,10,56,172,23,251
5114133,3,0,3,45,14,0,59,164,19,242
5114201,0,0,0,72,24,3,99,178,17,294
5114202,3,6,9,352,82,22,456,638,79,1173
5114203,44,0,44,151,48,12,211,370,38,619
5114204,0,0,0,205,45,8,258,308,18,584
5114205,0,3,3,73,29,0,102,211,16,329
5114206,3,6,9,86,43,6,135,262,26,423
5114207,3,0,3,53,32,3,88,119,21,228
5114208,6,0,6,122,51,11,184,370,29,583
5114209,0,0,0,294,45,8,347,426,27,800
5114210,3,0,3,66,15,0,81,117,7,205
5114211,0,0,0,103,39,0,142,280,20,442
5114212,0,0,0,24,19,0,43,98,6,147
5114213,0,0,0,39,30,3,72,170,18,260
5114301,0,0,0,53,12,3,68,120,9,197
5114302,0,0,0,50,36,3,89,141,26,256
5114303,6,0,6,44,25,3,72,157,17,246
5114304,0,0,0,78,10,0,88,211,17,316
5114305,0,4,4,106,42,9,157,246,14,417
5114306,0,0,0,42,13,0,55,126,33,214
5114307,0,0,0,78,21,3,102,121,9,232
5114308,0,0,0,106,35,6,147,183,15,345
5114309,3,0,3,53,29,0,82,185,15,282
5114310,0,0,0,37,30,3,70,144,25,239
5114311,0,0,0,67,38,3,108,205,12,325
5114312,4,0,4,139,40,6,185,237,25,447
5114313,0,0,0,100,20,4,124,218,26,368
5114314,4,0,4,76,23,4,103,182,11,296
5114315,0,3,3,59,8,6,73,120,16,209
5114401,0,0,0,0,0,0,0,0,237,237
5114402,0,0,0,38,28,0,66,117,6,189
5114403,0,0,0,100,30,0,130,169,8,307
5114404,6,3,9,29,19,3,51,219,29,299
5114405,3,0,3,37,13,6,56,158,4,218
5114406,0,0,0,105,15,4,124,139,21,284
5114407,3,3,6,66,13,3,82,180,21,283
5114408,3,0,3,27,15,3,45,162,9,216
5114409,0,3,3,45,21,0,66,159,21,246
5114410,0,0,0,13,0,0,13,60,4,77
5114411,7,0,7,52,19,0,71,169,34,274
5114412,0,0,0,67,20,3,90,155,24,269
5114413,0,0,0,65,18,0,83,150,12,245
5114501,0,0,0,17,23,3,43,171,21,235
5114502,28,51,79,31,25,0,56,340,139,535
5114503,6,0,6,31,28,0,59,239,15,313
5114504,0,0,0,64,31,6,101,273,16,390
5114505,7,5,12,80,30,3,113,326,69,508
5114506,3,0,3,51,31,0,82,329,24,435
5114507,9,0,9,24,23,0,47,241,18,306
5114508,3,0,3,49,35,0,84,411,43,538
5114509,6,0,9,43,33,6,82,225,18,325
5114510,6,0,6,73,26,0,99,288,12,399
5114511,12,0,12,37,30,3,70,362,9,441
5114512,3,0,3,31,19,9,59,205,9,273
5114513,5,3,8,37,15,9,61,284,27,372
5114514,5,0,5,59,24,9,92,280,19,391
5114515,3,3,6,65,26,0,91,305,24,420
5114516,92,14,109,0,9,0,9,244,33,286
5114517,6,0,6,47,27,0,74,383,15,472
5114518,11,0,11,60,26,3,89,340,27,456
5114519,8,0,8,38,27,0,65,270,33,368
5114520,48,0,52,38,26,3,67,305,28,400
5114521,9,3,12,54,25,0,79,324,26,429
5114522,10,4,14,39,25,0,64,282,27,373
5114523,3,0,3,41,42,6,89,370,71,530
5114524,7,6,13,60,22,3,85,299,15,399
5114525,0,3,3,61,26,6,93,250,50,393
5114526,9,0,9,73,11,0,84,259,25,368
5114527,3,0,3,50,10,5,65,213,20,298
5114528,3,3,6,44,25,3,72,232,24,328
5114529,3,0,3,55,19,3,77,183,15,275
5114530,13,0,13,64,28,3,95,483,32,610
5114531,0,0,0,0,0,0,0,0,0,0
5114601,0,0,0,44,13,3,60,199,21,280
5114602,0,0,0,21,3,0,24,146,18,188
5114603,5,4,9,42,21,5,68,177,19,264
5114604,0,3,3,74,28,3,105,311,46,462
5114605,4,0,4,66,12,0,78,379,45,502
5114606,138,19,157,68,36,3,107,497,49,653
5114607,0,0,0,41,35,3,79,163,6,248
5114608,0,0,0,15,18,0,33,311,49,393
5114609,0,0,0,34,7,4,45,147,41,233
5114610,3,0,3,64,35,3,102,272,15,389
5114611,0,0,0,24,20,0,44,175,12,231
5114612,3,3,6,66,45,3,114,300,23,437
5114613,45,27,72,66,34,0,100,326,73,499
5114614,38,3,41,67,27,3,97,286,19,402
5114615,6,0,6,78,23,3,104,164,20,288
5114616,7,0,7,70,8,0,78,165,36,279
5114617,6,0,6,90,27,7,124,299,34,457
5114618,3,0,3,34,27,0,61,210,14,285
5114619,6,0,6,55,15,0,70,106,3,179
5114620,6,0,6,69,20,6,95,152,13,260
5114621,7,0,7,78,50,3,131,353,30,514
5114622,11,0,11,30,18,3,51,185,15,251
5114623,0,0,0,56,21,4,81,151,8,240
5114624,3,3,6,54,24,4,82,135,16,233
5114625,3,0,3,46,19,3,68,142,11,221
5114626,4,0,4,69,12,5,86,172,20,278
5114627,8,0,8,53,20,9,82,200,38,320
5114628,0,0,0,0,0,0,0,0,0,0
5114629,0,0,0,4,6,0,10,101,3,114
5114630,0,0,0,0,0,0,0,0,0,0
5114701,12,5,17,45,21,0,66,275,125,466
5114702,4,0,4,45,22,0,67,341,75,483
5114703,7,0,7,49,34,6,89,321,76,486
5114704,4,3,7,43,27,0,70,240,28,338
5114705,6,0,6,47,30,9,86,253,3,342
5114706,74,3,77,52,29,3,84,452,22,558
5114707,4,3,7,36,21,3,60,189,30,279
5114708,8,6,14,68,20,12,100,293,24,417
5114709,0,0,0,42,18,0,60,111,10,181
5114710,6,6,12,108,43,7,158,275,25,458
5114711,0,0,0,33,13,3,49,208,17,274
5114712,5,0,5,78,17,3,98,297,17,412
5114713,4,0,4,68,22,3,93,263,19,375
5114714,4,0,4,54,31,7,92,267,27,386
5114715,6,0,6,58,18,0,76,192,26,294
5114716,0,0,0,67,22,0,89,224,14,327
5114717,10,0,10,53,18,3,74,265,33,372
5114718,0,0,0,73,28,0,101,277,15,393
5114719,7,0,7,17,15,0,32,161,29,222
5114720,6,6,12,89,25,10,124,319,60,503
5114721,0,0,0,0,0,0,0,0,0,0
5114722,0,0,0,34,21,0,55,362,56,473
5114723,0,0,0,30,8,0,38,144,22,204
5114724,7,0,7,66,16,9,91,155,12,258
5114725,18,3,21,44,15,9,68,206,24,298
5114726,6,3,9,54,50,3,107,490,59,656
5114727,14,3,17,48,29,0,77,334,21,432
5114728,3,0,3,27,29,0,56,353,55,464
5114729,12,3,15,20,14,0,34,268,70,372
5114730,7,0,7,93,24,12,129,149,4,282
5114731,3,5,8,48,12,9,69,87,16,172
5114732,5,3,8,64,24,6,94,223,19,336
5114733,0,0,0,45,12,3,60,135,15,210
5114734,3,0,3,43,6,13,62,164,6,232
5114735,0,0,0,48,7,8,63,116,23,202
5114736,3,0,6,117,30,8,155,235,10,400
5114737,6,3,9,87,26,6,119,141,28,288
5114738,0,0,0,0,0,0,0,0,0,0
5114739,0,6,6,27,12,0,39,135,18,192
5114740,3,0,3,53,15,3,71,164,13,248
5114741,0,0,0,37,18,9,64,115,3,182
5114742,4,0,4,52,11,6,69,238,20,327
5114743,3,0,3,35,15,3,53,132,13,198
5114801,4,0,4,539,87,25,651,929,89,1669
5114802,3,0,3,505,85,22,612,710,71,1393
5114803,0,0,0,106,50,4,160,258,21,439
5114804,0,0,0,257,55,16,328,337,53,718
5114805,0,3,3,299,58,9,366,406,20,792
5114806,0,0,0,207,34,19,260,186,35,481
5114807,0,0,0,47,24,0,71,148,12,231
5114808,6,0,6,83,49,4,136,309,21,466
5114809,0,0,0,154,29,3,186,271,17,474
5114810,0,0,0,136,32,0,168,170,10,348
5114811,4,0,4,166,26,15,207,190,13,410
5114812,0,0,0,81,11,12,104,153,21,278
5114813,0,0,0,89,15,7,111,109,6,226
5114814,0,0,3,63,21,3,87,104,18,209
5114815,3,0,3,82,19,0,101,128,9,238
5114816,0,0,0,155,26,12,193,273,31,497
5114817,3,0,3,128,13,0,141,184,22,347
5114818,0,0,0,137,28,6,171,185,15,371
5114819,0,0,0,118,33,3,154,226,32,412
5114820,0,0,0,69,21,5,95,160,24,279
5114901,6,0,6,37,17,4,58,148,16,222
5114902,0,0,0,9,9,3,21,61,0,82
5114903,0,0,0,73,23,6,102,197,17,316
5114904,0,0,0,90,9,0,99,228,18,345
5114905,3,0,3,59,12,4,75,180,13,268
5114906,0,0,0,90,28,10,128,224,18,370
5114907,0,0,0,59,12,6,77,106,15,198
5114908,0,0,0,93,22,6,121,164,17,302
5114909,3,0,3,99,22,7,128,196,28,352
5114910,0,0,0,129,29,0,158,279,27,464
5114911,0,0,0,116,21,5,142,180,5,327
5114912,0,0,0,96,18,3,117,150,11,278
5114913,6,0,6,109,28,6,143,172,12,327
5114914,0,0,0,114,30,0,144,166,17,327
5114915,0,0,0,79,11,4,94,110,4,208
5115001,0,0,0,6,0,0,6,9,3,18
5115101,0,0,0,0,0,0,0,0,0,0
5115201,4,0,4,124,50,4,178,369,41,588
5115202,3,0,3,54,28,6,88,296,14,398
5115203,3,0,3,48,30,9,87,145,12,244
5115204,8,0,8,71,27,0,98,302,16,416
5115205,0,0,0,92,16,0,108,216,32,356
5115206,7,0,7,83,21,6,110,210,30,350
5115207,6,3,9,66,47,3,116,375,34,525
5115208,0,3,3,51,14,0,65,142,15,222
5115209,0,0,0,110,31,12,153,230,34,417
5115210,0,3,3,4,19,0,23,137,26,186
5115211,7,0,7,119,39,4,162,291,28,481
5115212,6,0,6,140,26,8,174,317,37,528
5115213,6,0,6,50,35,0,85,161,21,267
5115214,3,0,3,52,13,0,65,187,31,283
5115215,4,0,4,75,34,0,109,226,15,350
5115216,3,3,6,100,69,6,175,349,24,548
5115301,4,0,4,77,32,3,112,231,21,364
5115302,0,0,0,35,19,3,57,170,6,233
5115303,3,0,3,66,37,10,113,243,14,370
5115304,0,0,0,63,10,3,76,157,18,251
5115305,6,0,6,56,22,3,81,173,13,267
5115306,6,0,6,69,37,3,109,306,20,435
5115307,0,0,0,50,18,3,71,196,39,306
5115308,0,0,0,69,10,6,85,207,34,326
5115309,4,0,4,43,16,0,59,186,27,272
5115310,0,0,0,57,15,0,72,171,31,274
5115311,0,0,0,46,19,3,68,158,23,249
5115312,0,0,0,85,21,0,106,193,21,320
5115313,0,0,0,56,9,9,74,115,3,192
5115314,3,0,3,39,16,3,58,160,19,237
5115315,3,0,3,71,21,0,92,232,22,346
5115316,0,0,0,57,28,3,88,220,10,318
5115317,3,0,3,49,29,0,78,247,27,352
5115318,28,0,28,63,28,3,94,336,42,472
5115319,0,0,0,124,24,0,148,174,9,331
5115320,5,0,5,71,26,0,97,283,39,419
5115401,0,0,0,49,22,4,75,212,13,300
5115402,12,0,12,53,20,6,79,224,39,342
5115403,5,3,8,62,32,6,100,243,31,374
5115404,3,0,7,107,37,3,147,344,18,509
5115405,3,0,3,54,26,0,80,176,20,276
5115406,6,74,80,34,6,0,40,131,123,294
5115407,5,0,5,90,41,8,139,251,44,434
5115408,10,0,10,91,30,0,121,243,28,392
5115409,8,3,11,59,10,4,73,216,32,321
5115410,9,3,12,86,34,3,123,344,41,508
5115411,13,0,13,74,38,0,112,296,42,450
5115412,9,0,9,86,45,5,136,319,52,507
5115413,6,0,6,102,27,3,132,329,31,492
5115414,4,0,4,62,20,9,91,304,54,449
5115415,6,0,6,58,25,3,86,198,34,318
5115416,0,3,3,65,29,0,94,256,23,373
5115417,8,0,8,40,18,3,61,159,19,239
5115418,7,0,7,47,40,0,87,204,11,302
5115419,6,3,9,44,21,0,65,155,28,248
5115420,22,3,25,43,25,3,71,411,56,538
5115421,3,6,9,91,35,0,126,372,34,532
5115501,0,0,0,0,0,0,0,13,0,13
5115601,3,0,3,86,38,0,124,307,19,450
5115602,0,0,0,52,14,3,69,144,25,238
5115603,0,0,0,0,0,0,0,0,0,0
5115604,4,0,4,33,22,6,61,138,8,207
5115605,0,0,0,42,18,0,60,146,4,210
5115606,0,0,0,24,31,3,58,178,11,247
5115607,6,0,6,110,27,9,146,297,7,450
5115608,0,0,0,39,30,0,69,174,21,264
5115701,0,0,0,0,0,0,0,185,37,222
5115801,0,0,0,34,3,0,37,83,0,120
5115802,0,0,0,72,24,3,99,182,31,312
5115803,0,0,0,0,7,0,7,24,0,31
5115901,6,0,6,51,29,3,83,198,9,290
5115902,3,0,3,52,27,3,82,171,14,267
5115903,0,0,0,38,18,6,62,140,0,202
5115904,3,0,3,80,41,9,130,231,17,378
5115905,0,0,0,64,15,6,85,196,21,302
5115906,74,17,91,36,26,5,67,340,53,460
5115907,0,0,0,65,24,4,93,222,34,349
5115908,0,0,0,60,34,0,94,262,35,391
5115909,0,0,0,81,26,0,107,219,26,352
5115910,6,0,6,86,28,3,117,275,22,414
5115911,3,3,6,73,28,3,104,268,21,393
5115912,3,0,3,114,33,4,151,375,46,572
5115913,3,0,3,56,21,9,86,163,21,270
5115914,0,0,0,86,21,0,107,147,12,266
5115915,4,0,4,70,16,3,89,154,15,258
5115916,6,0,6,97,40,9,146,335,25,506
5115917,0,0,0,53,17,0,70,211,24,305
5115918,0,0,0,98,23,0,121,228,23,372
5115919,0,0,0,140,21,6,167,333,15,515
5115920,0,0,0,99,48,7,154,267,16,437
5115921,0,0,0,62,21,4,87,233,8,328
5115922,0,3,3,46,14,0,60,154,24,238
5115923,0,0,0,56,14,0,70,210,6,286
5115924,3,3,6,90,31,5,126,261,24,411
5115925,4,0,4,71,22,5,98,252,18,368
5116001,0,0,0,56,39,0,95,263,40,398
5116002,16,0,16,68,27,3,98,320,30,448
5116003,3,0,3,36,22,0,58,126,7,191
5116004,6,0,6,51,20,9,80,239,27,346
5116005,0,0,0,67,10,6,83,160,17,260
5116006,3,0,3,43,27,0,70,189,4,263
5116007,4,0,4,44,38,3,85,216,24,325
5116008,4,0,4,47,21,0,68,120,15,203
5116009,0,0,0,70,21,3,94,262,12,368
5116010,3,0,6,57,44,3,104,246,19,369
5116011,3,0,3,72,35,9,116,350,29,495
5116012,4,0,4,50,18,0,68,138,8,214
5116013,12,0,12,74,39,3,116,284,32,432
5116014,37,7,44,39,24,6,69,241,29,339
5116015,3,3,6,29,37,6,72,202,26,300
5116016,3,3,6,42,26,0,68,230,26,324
5116017,9,0,9,58,26,0,84,236,16,336
5116018,3,3,6,44,20,3,67,179,30,276
5116019,7,0,7,56,23,3,82,189,12,283
5116020,6,0,6,65,35,9,109,303,27,439
5116021,3,0,3,33,14,0,47,128,19,194
5116022,5,0,5,24,27,3,54,216,29,299
5116023,48,0,48,83,35,0,118,361,39,518
5116101,0,3,3,34,15,3,52,118,18,188
5116102,0,0,0,108,22,8,138,168,12,318
5116103,0,0,0,94,22,4,120,167,7,294
5116104,0,0,0,233,51,9,293,532,27,852
5116105,3,0,3,98,5,4,107,164,9,280
5116106,0,0,0,90,4,6,100,142,4,246
5116107,0,0,0,62,7,0,69,107,3,179
5116108,3,0,3,135,34,3,172,214,28,414
5116109,0,0,0,158,32,0,190,293,43,526
5116110,0,0,0,102,18,0,120,167,15,302
5116111,0,0,0,270,44,16,330,488,64,882
5116112,0,0,0,36,9,4,49,82,18,149
5116113,0,0,0,176,43,10,229,313,49,591
5116114,0,0,0,75,20,0,95,136,34,265
5116115,0,0,0,133,25,3,161,183,21,365
5116116,0,0,0,95,32,6,133,181,15,329
5116117,3,0,3,116,13,10,139,199,13,351
5116118,0,0,0,59,19,6,84,142,3,229
5116119,0,0,0,63,20,6,89,180,12,281
5116120,73,3,76,44,18,0,62,464,66,592
5116121,0,0,0,106,30,6,142,165,11,318
5116122,3,0,3,118,24,5,147,210,19,376
5116201,0,3,3,25,18,0,43,88,12,143
5116202,3,4,7,53,38,6,97,230,28,355
5116301,0,0,0,38,14,0,52,119,11,182
5116302,0,0,0,111,48,6,165,358,66,589
5116303,0,0,0,127,22,3,152,272,32,456
5116304,0,0,0,0,0,0,0,0,0,0
5116305,0,0,0,83,24,6,113,149,20,282
5116306,3,0,3,38,15,4,57,108,15,180
5116307,3,0,3,96,22,3,121,252,26,399
5116308,3,3,6,47,20,3,70,157,18,245
5116309,0,0,0,106,24,6,136,245,26,407
5116310,3,0,3,55,16,0,71,128,14,213
5116311,6,3,9,105,37,7,149,307,28,484
5116312,0,0,0,56,18,9,83,184,16,283
5116313,0,0,0,54,21,0,75,168,13,256
5116314,9,0,9,79,25,4,108,263,25,396
5116315,3,0,3,50,12,0,62,129,10,201
5116316,3,0,3,84,20,4,108,213,45,366
5116317,0,0,0,89,21,7,117,224,44,385
5116318,0,0,0,50,6,6,62,139,17,218
5116401,0,0,0,75,30,0,105,175,19,299
5116402,3,0,3,89,16,0,105,120,7,232
5116403,3,0,3,48,14,3,65,133,12,210
5116404,4,0,4,58,18,3,79,162,12,253
5116405,0,6,6,64,18,7,89,160,18,267
5116406,3,0,3,74,24,0,98,198,12,308
5116407,6,3,9,55,36,7,98,211,44,353
5116408,6,0,6,90,25,7,122,247,27,396
5116409,6,5,11,64,49,0,113,320,29,462
5116410,33,0,33,79,46,8,133,390,44,567
5116411,0,4,4,66,13,9,88,164,29,281
5116412,11,0,11,50,28,6,84,210,35,329
5116413,8,0,8,81,18,4,103,153,25,281
5116414,31,3,34,81,22,0,103,254,9,366
5116415,7,0,7,70,44,3,117,183,14,314
5116416,16,5,21,103,47,6,156,285,11,452
5116417,4,0,4,78,25,6,109,140,6,255
5116501,0,0,0,0,0,0,0,0,0,0
5116502,7,0,7,119,44,6,169,310,32,511
5116503,6,0,6,75,61,0,136,394,46,576
5116504,3,0,3,86,53,3,142,302,35,479
5116505,11,0,11,49,27,9,85,228,35,348
5116506,42,0,42,37,18,0,55,213,37,305
5116507,11,0,11,64,31,0,95,375,24,494
5116508,0,9,9,37,17,7,61,188,45,294
5116509,3,3,6,70,28,6,104,372,40,516
5116510,6,3,9,55,11,7,73,228,58,359
5116511,0,0,0,40,30,6,76,275,25,376
5116512,3,3,6,27,28,0,55,200,21,276
5116513,0,0,0,24,38,0,62,308,81,451
5116514,3,0,3,22,14,0,36,257,16,309
5116515,14,0,17,71,40,0,111,418,29,558
5116516,9,0,9,57,31,0,88,341,49,478
5116517,7,0,7,102,28,3,133,361,33,527
5116518,4,0,4,90,18,6,114,256,15,385
5116519,24,0,29,48,12,0,60,348,84,492
5116520,6,4,10,36,20,3,59,224,43,326
5116521,3,0,3,30,37,3,70,233,16,319
5116522,12,4,16,61,32,4,97,336,38,471
5116523,0,0,0,20,15,6,41,167,27,235
5116524,3,0,3,29,17,0,46,111,33,190
5116525,0,0,0,5,3,7,15,78,6,99
5116526,9,4,13,87,40,9,136,261,31,428
5116527,10,0,10,57,20,3,80,227,14,321
5116528,38,0,38,96,12,6,114,317,37,468
5116529,7,4,11,48,20,4,72,124,18,214
5116530,8,0,8,58,14,9,81,204,13,298
5116531,0,0,0,30,29,0,59,115,12,186
5116532,3,0,3,36,18,3,57,193,38,288
5116601,0,0,0,0,3,0,3,22,0,25
5116602,0,0,0,43,15,9,67,165,19,251
5116603,4,0,4,25,15,0,40,126,18,184
5116604,6,0,6,48,14,0,62,210,63,335
5116605,11,0,11,92,19,15,126,250,16,392
5116606,0,0,0,0,0,0,0,0,0,0
5116607,10,3,13,44,36,4,84,308,31,423
5116608,6,5,11,96,34,8,138,347,33,518
5116609,3,0,3,56,38,10,104,307,33,444
5116610,7,4,11,76,38,8,122,358,53,533
5116611,5,0,5,62,25,3,90,170,22,282
5116612,0,0,0,52,29,6,87,216,25,328
5116613,8,3,11,70,38,8,116,309,42,467
5116614,0,0,0,57,43,3,103,211,12,326
5116615,14,0,14,32,29,0,61,180,10,251
5116616,6,0,6,30,30,0,60,187,9,256
5116617,8,0,8,56,19,0,75,244,10,329
5116618,6,0,6,42,27,3,72,218,16,306
5116619,86,5,91,32,17,0,49,318,21,388
5116620,6,0,9,58,18,4,80,138,34,252
5116621,0,0,0,16,18,3,37,135,0,172
5116622,4,0,4,59,10,6,75,175,27,277
5116623,6,3,9,56,19,0,75,158,29,262
5116624,3,0,3,84,34,4,122,129,18,269
5116625,6,3,9,86,27,12,125,284,39,448
5116626,5,0,5,65,19,3,87,198,8,293
5116627,0,0,0,17,9,0,26,59,3,88
5116628,7,0,7,104,25,0,129,258,41,428
5116629,3,0,3,29,22,0,51,146,28,225
5116630,7,0,7,44,36,3,83,145,26,254
5116631,3,0,3,55,20,3,78,138,10,226
5116632,4,0,4,46,15,7,68,186,24,278
5116633,9,3,12,72,42,3,117,233,17,367
5116634,4,6,10,105,42,4,151,412,28,591
5116635,11,0,11,80,32,12,124,287,57,468
5116636,5,3,8,55,9,4,68,142,15,225
5116701,0,0,0,0,3,0,3,3,0,6
5116702,0,0,0,0,0,0,0,0,0,0
5116801,0,0,0,58,30,0,88,163,9,260
5116802,0,0,0,0,10,0,10,40,6,56
5116803,0,0,0,35,13,0,48,106,9,163
5116804,3,0,3,30,14,0,44,137,44,225
5116805,3,0,3,44,15,0,59,162,19,240
5116901,0,0,0,248,60,27,335,509,70,914
5116902,0,0,0,103,20,6,129,227,22,378
5116903,0,0,0,0,0,0,0,0,0,0
5116904,0,0,0,84,24,9,117,138,3,258
5116905,3,0,3,37,18,0,55,128,12,195
5116906,0,0,0,0,0,0,0,0,0,0
5116907,0,0,0,88,30,9,127,210,32,369
5116908,3,0,3,85,59,13,157,291,18,466
5116909,0,0,0,88,35,12,135,281,28,444
5116910,0,0,0,115,27,3,145,211,25,381
5116911,3,0,3,253,36,14,303,359,52,714
5116912,0,0,0,133,25,4,162,187,20,369
5116913,0,0,0,93,18,6,117,145,35,297
5116914,0,0,0,153,19,9,181,158,33,372
5116915,0,0,0,217,28,10,255,267,41,563
5117001,0,0,0,131,33,13,177,193,45,415
5117002,0,0,0,0,0,0,0,0,0,0
5117003,69,20,89,48,32,0,80,414,110,604
5117004,7,0,7,37,30,0,67,189,43,299
5117005,3,0,3,44,12,0,56,184,53,293
5117006,11,4,15,84,31,0,115,252,62,429
5117007,6,3,9,45,6,9,60,146,28,234
5117008,6,0,6,84,22,0,106,251,57,414
5117009,3,0,3,102,44,9,155,213,55,423
5117010,0,0,0,69,27,0,96,137,34,267
5117011,0,0,0,55,29,0,84,132,32,248
5117012,0,0,0,116,27,4,147,112,25,284
5117013,0,0,0,84,25,0,109,177,18,304
5117014,0,3,3,127,32,3,162,228,55,445
5117015,8,7,15,88,31,3,122,302,64,488
5117016,7,0,7,88,33,7,128,332,77,537
5117017,0,0,0,3,0,0,3,0,0,3
5117101,0,0,0,94,48,3,145,265,9,419
5117102,0,0,0,0,0,0,0,0,571,571
5117103,3,3,6,88,35,0,123,234,33,390
5117104,0,0,0,64,24,0,88,154,26,268
5117201,0,0,0,0,0,0,0,0,0,0
5117202,0,0,0,16,4,3,23,55,13,91
5117301,0,0,0,3,0,0,3,9,3,15
5117401,3,3,6,45,6,6,57,150,27,234
5117402,0,0,0,46,15,0,61,102,36,199
5117403,0,0,0,9,0,0,9,9,0,18
5117404,6,0,6,55,17,0,72,153,34,259
5117405,0,0,0,0,0,0,0,0,0,0
5117406,0,0,0,118,21,9,148,210,26,384
5117407,3,3,6,41,6,4,51,122,40,213
5117408,0,0,0,35,18,3,56,116,24,196
5117409,0,0,0,42,17,3,62,112,11,185
5117410,0,0,0,81,22,0,103,204,38,345
5117411,0,3,3,72,30,3,105,282,44,431
5117412,0,0,0,97,21,4,122,174,33,329
5117413,0,0,0,124,28,8,160,216,14,390
5117414,6,0,6,103,42,12,157,336,44,537
5117415,3,0,3,65,17,3,85,160,33,278
5117416,3,0,3,48,18,3,69,129,20,218
5117417,0,0,0,57,26,0,83,181,35,299
5117418,9,0,9,81,47,5,133,263,52,448
5117419,3,0,3,39,13,0,52,124,14,190
5117420,0,4,4,157,35,6,198,238,20,456
5117421,0,0,0,41,29,3,73,153,16,242
5117422,3,4,7,94,33,3,130,348,62,540
5117423,0,0,0,86,42,8,136,255,50,441
5117424,0,0,0,60,24,0,84,172,38,294
5117425,4,0,4,40,18,3,61,201,40,302
5117426,6,6,12,53,32,3,88,184,64,336
5117427,6,0,6,48,22,0,70,171,41,282
5117428,0,0,0,65,26,9,100,239,31,370
5117501,8,29,37,41,34,0,75,185,76,336
5117502,9,0,12,70,38,0,108,228,39,375
5117503,9,0,9,50,34,0,84,323,79,486
5117504,13,0,13,76,39,14,129,318,27,474
5117505,9,0,9,65,29,0,94,244,20,358
5117506,6,0,6,37,37,0,74,193,16,283
5117507,0,5,5,52,24,0,76,176,55,307
5117508,5,3,8,75,31,0,106,292,32,430
5117509,7,0,7,60,31,0,91,271,43,405
5117510,7,5,12,70,52,0,122,239,28,389
5117511,10,0,10,89,24,0,113,255,26,394
5117512,11,0,11,63,26,3,92,199,18,309
5117513,8,3,11,56,25,0,81,169,21,271
5117514,15,6,21,53,32,3,88,255,34,377
5117515,3,0,3,66,31,3,100,228,37,365
5117516,10,7,17,69,39,6,114,311,27,452
5117517,10,4,14,85,29,0,114,285,40,439
5117518,7,0,7,72,42,0,114,294,48,456
5117519,3,3,6,50,25,3,78,199,6,283
5117520,17,0,17,77,65,0,142,282,17,441
5117521,5,0,5,65,18,7,90,187,22,299
5117522,6,0,6,57,20,3,80,181,3,264
5117523,8,0,8,116,34,10,160,245,30,435
5117524,7,0,7,64,9,3,76,159,19,254
5117601,6,3,9,66,17,6,89,204,21,314
5117602,39,3,42,55,19,6,80,264,21,365
5117603,3,0,3,81,26,6,113,274,18,405
5117604,6,0,6,39,26,6,71,192,16,279
5117605,0,0,0,28,19,7,54,140,6,200
5117606,7,0,7,71,48,3,122,281,15,418
5117607,3,0,3,84,25,12,121,349,16,486
5117608,0,3,3,50,9,7,66,137,8,211
5117609,0,3,3,75,28,0,103,286,23,412
5117701,10,4,17,40,25,9,74,185,22,281
5117702,11,0,11,87,33,0,120,230,10,360
5117703,55,0,55,56,14,3,73,359,22,454
5117704,6,0,6,84,22,8,114,183,4,301
5117705,4,0,4,55,35,3,93,197,9,299
5117706,6,0,6,48,39,0,87,229,12,328
5117707,8,0,8,48,23,0,71,236,30,337
5117708,10,0,10,68,32,0,100,257,28,385
5117709,0,3,3,74,21,3,98,234,31,363
5117710,0,3,3,71,14,0,85,207,30,322
5117711,5,0,5,49,16,3,68,159,41,268
5117712,5,3,8,61,18,0,79,177,21,277
5117713,8,7,15,91,61,7,159,361,37,557
5117714,3,4,7,51,18,3,72,158,15,245
5117715,43,12,55,65,33,6,104,244,24,372
5117716,10,3,13,75,37,3,115,207,12,334
5117717,3,3,6,81,30,5,116,262,33,411
5117718,12,0,12,93,40,6,139,241,21,401
5117719,44,8,52,56,24,5,85,344,30,459
5117720,14,4,18,73,19,0,92,253,25,370
5117721,5,11,16,73,42,12,127,223,30,380
5117722,4,0,4,36,14,3,53,143,3,199
5117723,14,0,14,40,18,0,58,224,45,327
5117724,6,0,6,97,19,5,121,228,28,377
5117725,4,0,4,74,28,3,105,233,27,365
5117726,10,0,10,67,19,4,90,196,18,304
5117727,3,3,6,80,18,5,103,226,30,359
5117728,10,5,15,114,34,9,157,361,44,562
5117729,14,6,20,31,7,0,38,276,33,347
5117730,6,3,9,106,35,6,147,276,22,445
5117801,6,0,6,102,44,0,146,298,18,462
5117802,13,4,23,51,38,4,93,285,38,416
5117803,14,0,14,32,22,8,62,163,17,242
5117804,6,0,6,74,20,3,97,266,20,383
5117805,14,0,14,80,33,0,113,282,23,418
5117806,9,0,9,82,30,7,119,213,37,369
5117807,11,6,17,67,45,12,124,343,35,502
5117808,0,3,3,52,28,6,86,232,23,341
5117809,7,0,7,88,37,11,136,297,34,467
5117810,7,0,7,74,24,0,98,204,16,318
5117811,13,3,16,52,36,3,91,314,24,429
5117812,13,3,16,77,44,3,124,294,13,431
5117813,21,3,27,53,30,0,83,309,44,436
5117814,4,0,4,47,16,4,67,128,13,208
5117815,65,3,68,99,46,8,153,454,35,642
5117816,4,0,4,48,22,4,74,155,23,252
5117817,82,13,95,55,17,0,72,267,37,376
5117818,6,0,9,56,23,0,79,214,13,306
5117819,6,0,6,48,9,3,60,141,9,210
5117820,8,3,11,77,37,0,114,284,22,420
5117821,13,0,13,46,22,3,71,167,0,238
5117822,7,0,7,68,36,0,104,261,10,375
5117823,10,0,10,66,37,0,103,236,24,363
5117824,9,0,9,75,20,0,95,232,9,336
5117825,9,3,12,50,32,0,82,232,28,342
5117826,9,0,9,93,50,6,149,342,35,526
5117827,11,0,11,105,51,3,159,387,71,617
5117828,3,0,3,18,16,0,34,144,13,191
5117829,9,0,9,87,38,4,129,236,27,392
5117830,0,3,3,62,15,0,77,204,27,308
5117831,9,0,9,77,22,0,99,263,22,384
5117901,3,0,3,28,15,3,46,157,6,209
5117902,0,0,0,46,40,5,91,264,5,360
5117903,4,0,4,82,15,3,100,301,13,414
5117904,14,0,14,27,9,0,36,144,9,189
5117905,7,0,7,77,37,3,117,338,21,476
5117906,0,0,0,69,39,3,111,174,18,303
5117907,97,88,185,0,4,0,4,230,126,360
5117908,14,0,14,57,27,3,87,281,16,384
5117909,7,0,7,51,13,0,64,245,3,312
5117910,3,0,3,61,14,0,75,292,7,374
5117911,41,3,44,56,24,0,80,333,21,434
5117912,20,3,23,115,48,3,166,322,26,514
5117913,5,7,12,73,45,0,118,316,22,456
5117914,0,0,0,44,32,3,79,261,24,364
5117915,6,3,9,56,18,3,77,187,12,276
5117916,0,0,0,92,45,9,146,294,20,460
5117917,6,0,6,112,43,9,164,331,24,519
5118001,3,0,3,50,13,3,66,165,4,235
5118002,0,0,0,38,22,0,60,196,5,261
5118003,25,7,35,40,22,0,62,307,19,388
5118004,5,0,5,71,15,4,90,132,0,222
5118005,0,0,0,36,22,0,58,148,12,218
5118006,7,0,7,55,41,10,106,286,24,416
5118007,3,0,3,59,16,3,78,174,5,257
5118008,0,3,3,80,37,9,126,279,21,426
5118009,0,0,0,56,18,8,82,198,9,289
5118010,6,0,6,34,16,6,56,188,0,244
5118011,3,0,3,63,24,6,93,202,12,307
5118012,0,0,0,95,30,12,137,274,22,433
5118013,0,3,3,47,23,8,78,176,12,266
5118014,0,0,0,61,17,6,84,146,6,236
5118015,0,0,0,97,28,6,131,311,24,466
5118016,6,0,6,94,30,3,127,216,10,353
5118017,6,0,6,73,39,3,115,256,12,383
5118018,0,0,0,38,19,0,57,103,12,172
5118019,4,0,4,64,16,7,87,214,6,307
5118020,5,0,5,93,52,0,145,340,18,503
5118021,0,0,0,81,33,9,123,269,15,407
5118022,4,0,4,61,28,4,93,190,10,293
5118023,0,0,0,46,18,0,64,102,9,175
5118024,0,0,0,49,22,9,80,98,6,184
5118025,0,0,0,31,18,0,49,113,12,174
5118026,0,0,0,0,0,0,0,0,0,0
5118027,0,0,0,43,5,0,48,134,6,188
5118028,6,0,6,44,17,0,61,173,12,246
5118029,0,0,0,95,29,0,124,308,14,446
5118030,3,3,6,40,27,4,71,123,12,206
5118031,3,0,3,37,20,6,63,140,18,221
5118032,0,0,0,31,21,0,52,180,6,238
5118101,3,3,9,43,26,0,69,229,22,320
5118102,8,0,8,76,29,6,111,225,19,355
5118103,15,0,15,55,27,3,85,245,10,340
5118104,6,0,6,91,40,0,131,256,22,409
5118105,12,4,16,63,32,3,98,242,19,359
5118106,15,4,19,62,50,10,122,234,15,371
5118107,3,0,6,101,26,4,131,295,21,447
5118108,11,0,11,71,30,0,101,246,12,359
5118109,7,3,10,90,18,0,108,205,38,351
5118110,8,0,8,80,21,4,105,223,14,342
5118111,13,0,13,123,30,3,156,267,30,453
5118112,12,0,12,85,36,11,132,311,34,477
5118113,10,3,13,109,39,0,148,266,24,438
5118114,4,0,4,102,21,4,127,169,9,305
5118115,4,3,7,78,27,6,111,208,12,331
5118116,6,3,9,96,27,9,132,222,24,378
5118117,7,0,7,40,16,0,56,129,5,190
5118118,4,0,4,119,25,11,155,280,23,458
5118119,79,14,93,46,28,9,83,375,50,508
5118120,8,0,8,128,37,13,178,294,25,497
5118121,7,3,10,101,37,4,142,225,39,406
5118122,10,3,13,85,23,6,114,224,30,368
5118123,4,0,4,118,24,4,146,168,27,341
5118124,8,3,11,116,27,7,150,305,27,482
5118125,3,0,3,124,34,10,168,311,24,503
5118126,11,3,14,99,49,5,153,219,25,397
5118127,47,0,47,19,7,0,26,198,12,236
5118128,8,0,8,48,30,0,78,170,13,261
5118129,12,0,12,63,24,6,93,241,24,358
5118130,16,6,22,89,45,0,134,385,42,561
5118131,7,0,7,69,46,3,118,319,27,464
5118132,4,0,4,86,25,6,117,215,25,357
5118201,3,0,3,89,40,4,133,299,18,450
5118202,3,0,3,61,47,4,112,288,15,415
5118203,8,3,11,27,8,6,41,133,18,192
5118204,6,3,9,47,27,6,80,259,10,349
5118205,3,0,3,61,7,3,71,169,11,251
5118206,6,0,6,58,27,6,91,248,15,354
5118207,6,0,6,65,26,3,94,217,21,332
5118208,6,0,6,59,17,0,76,233,24,333
5118209,7,0,7,52,32,4,88,242,23,353
5118210,6,0,6,92,28,11,131,317,17,465
5118211,0,0,0,25,12,5,42,140,13,195
5118212,0,0,0,50,16,0,66,263,29,358
5118213,115,39,154,3,47,0,50,844,114,1008
5118214,3,0,3,50,26,0,76,306,22,404
5118215,9,0,9,41,18,0,59,153,15,227
5118216,3,0,3,43,35,6,84,201,3,288
5118217,5,0,5,54,37,0,91,258,15,364
5118218,6,0,6,46,29,9,84,238,23,345
5118219,4,0,4,56,26,0,82,184,0,266
5118220,3,3,6,53,26,6,85,219,13,317
5118221,6,0,6,80,33,0,113,341,15,469
5118222,0,0,0,60,25,0,85,197,9,291
5118223,0,0,0,87,28,3,118,295,31,444
5118224,3,3,6,69,34,0,103,464,21,588
5118225,5,0,5,38,9,0,47,214,11,272
5118226,0,0,0,30,12,0,42,194,19,255
5118227,0,0,0,90,49,0,139,377,10,526
5118228,3,0,3,63,18,0,81,240,8,329
5118301,6,3,9,82,15,3,100,227,24,351
5118302,39,0,39,112,27,8,147,321,24,492
5118303,18,3,21,58,23,3,84,225,18,327
5118304,4,0,4,86,28,6,120,198,24,342
5118305,8,3,11,52,24,5,81,211,19,311
5118306,10,4,14,94,21,11,126,297,49,472
5118307,5,0,5,42,16,3,61,157,49,267
5118308,11,5,16,87,41,12,140,302,53,495
5118309,3,0,3,81,5,9,95,157,33,285
5118310,6,0,6,70,27,3,100,251,45,396
5118401,0,0,0,55,19,0,74,157,7,238
5118402,3,0,3,41,19,0,60,163,4,227
5118403,4,0,4,72,24,0,96,307,21,424
5118404,3,0,3,52,25,0,77,270,4,351
5118405,0,0,0,47,13,0,60,144,12,216
5118406,0,0,0,50,13,0,63,178,8,249
5118407,0,0,0,0,0,0,0,0,0,0
5118408,4,0,4,34,28,3,65,201,9,275
5118409,0,0,0,77,38,12,127,304,16,447
5118410,4,0,4,101,24,0,125,274,3,402
5118411,6,0,6,57,35,6,98,208,16,322
5118412,0,0,3,47,6,3,56,124,7,187
5118413,6,0,6,71,21,0,92,151,24,267
5118414,7,0,7,55,27,0,82,244,0,326
5118415,6,0,6,37,16,0,53,163,12,228
5118416,0,0,0,50,17,0,67,146,6,219
5118417,0,3,3,49,8,0,57,189,6,252
5118418,6,0,6,96,40,0,136,349,13,498
5118501,0,0,0,0,0,0,0,0,0,0
5118502,3,0,3,343,51,21,415,493,25,933
5118503,0,3,3,166,39,16,221,202,33,456
5118504,0,0,0,284,40,21,345,432,34,811
5118505,0,0,0,349,72,19,440,519,34,993
5118506,0,0,0,66,24,0,90,165,11,266
5118507,0,0,0,59,17,6,82,107,6,195
5118508,0,0,0,67,18,0,85,89,11,185
5118509,4,0,4,30,39,0,69,241,34,344
5118510,0,0,0,66,23,0,89,194,19,302
5118511,4,0,4,117,25,7,149,305,46,500
5118512,0,0,0,69,21,4,94,156,12,262
5118513,4,0,4,50,31,6,87,159,24,270
5118514,0,0,0,38,29,6,73,153,4,230
5118515,3,0,3,172,79,12,263,463,48,774
5118516,0,0,0,53,4,0,57,145,16,218
5118517,3,0,3,119,26,11,156,246,21,423
5118518,0,0,0,79,15,5,99,99,6,204
5118519,0,0,0,97,24,6,127,161,11,299
5118520,0,0,0,85,21,6,112,144,14,270
5118521,3,0,3,153,35,0,188,200,19,407
5118522,0,0,0,293,50,25,368,417,38,823
5118523,0,0,5,389,59,17,465,456,58,979
5118524,4,0,4,573,97,39,709,794,69,1572
5118525,0,0,0,85,23,5,113,191,19,323
5118601,7,0,7,51,26,6,83,188,17,288
5118602,0,4,4,76,35,11,122,277,38,437
5118603,4,0,4,49,35,0,84,221,25,330
5118604,30,3,33,74,30,3,107,316,36,459
5118605,5,0,5,87,46,5,138,305,37,480
5118606,0,0,0,49,28,5,82,226,18,326
5118607,3,0,3,32,21,9,62,161,19,242
5118608,3,0,3,46,19,0,65,136,8,209
5118609,22,11,33,80,29,0,109,347,33,489
5118610,3,0,3,80,28,0,108,234,15,357
5118611,0,0,0,50,29,3,82,176,26,284
5118612,3,0,3,53,19,9,81,168,13,262
5118613,4,5,9,52,18,6,76,161,23,260
5118614,5,0,5,46,19,0,65,113,12,190
5118615,5,0,5,49,17,3,69,156,35,260
5118616,0,0,0,82,32,0,114,282,28,424
5118617,3,0,3,94,25,0,119,181,21,321
5118618,5,0,5,47,11,7,65,155,19,239
5118619,6,6,12,31,25,6,62,188,34,284
5118620,7,0,7,77,46,0,123,248,35,406
5118621,13,0,13,75,31,0,106,251,37,394
5118701,3,0,3,45,21,0,66,116,31,213
5118702,0,0,0,64,12,0,76,118,9,203
5118703,0,0,0,96,21,5,122,133,30,285
5118704,0,0,0,120,22,10,152,196,24,372
5118705,0,0,0,101,25,9,135,161,50,346
5118706,0,0,0,38,15,6,59,92,30,181
5118707,0,0,0,128,39,9,176,234,23,433
5118708,0,0,0,69,14,6,89,129,15,233
5118709,0,0,0,108,16,9,133,175,30,338
5118710,0,0,0,72,28,4,104,187,15,306
5118711,0,0,0,103,29,9,141,145,19,305
5118712,0,0,0,149,32,3,184,246,76,506
5118713,0,0,0,107,21,10,138,206,17,361
5118714,0,0,0,99,19,6,124,170,7,301
5118715,0,0,0,96,19,15,130,137,33,300
5118716,0,0,0,69,23,7,99,150,15,264
5118717,3,0,3,86,27,7,120,231,26,377
5118718,38,45,83,46,22,9,77,302,118,497
5118719,0,0,0,102,33,13,148,211,29,388
5118720,0,0,0,98,17,3,118,162,13,293
5118721,3,0,3,198,43,23,264,304,40,608
5118722,0,0,0,0,0,0,0,0,0,0
5118723,0,0,0,0,14,0,14,39,9,62
5118724,0,0,0,0,3,0,3,17,0,20
5118725,0,0,0,81,25,3,109,104,28,241
5118726,0,0,0,74,17,3,94,173,42,309
5118727,3,0,3,57,23,0,80,137,16,233
5118728,0,0,0,57,15,3,75,137,30,242
5118729,0,0,0,65,18,8,91,133,36,260
5118730,0,0,0,72,28,0,100,145,26,271
5118731,0,0,0,56,12,4,72,130,39,241
5118732,0,0,0,77,31,6,114,230,36,380
5118733,0,0,0,121,45,6,172,323,39,534
5118734,4,0,4,107,22,8,137,207,30,374
5118801,0,0,0,0,0,0,0,0,0,0
5118802,3,3,6,51,17,7,75,120,18,213
5118803,0,0,0,27,26,0,53,187,58,298
5118804,10,4,14,44,33,0,77,323,32,432
5118805,62,0,62,37,27,0,64,333,20,417
5118806,50,11,61,0,9,0,9,214,48,271
5118807,3,0,3,66,41,4,111,337,33,481
5118808,12,7,19,69,41,0,110,430,68,608
5118809,0,0,0,45,5,0,50,178,18,246
5118810,6,0,6,96,46,3,145,331,38,514
5118811,36,12,48,52,37,3,92,397,86,575
5118812,10,0,10,26,37,0,63,191,25,279
5118813,7,3,10,58,35,3,96,240,19,355
5118814,6,3,9,55,30,3,88,356,53,497
5118815,8,19,27,47,45,3,95,246,69,410
5118816,29,5,34,46,25,3,74,368,44,486
5118817,0,0,0,0,0,0,0,0,0,0
5118818,20,9,29,57,32,6,95,312,81,488
5118819,0,0,0,12,0,0,12,412,87,511
5118820,3,0,3,44,4,0,48,156,14,218
5118821,4,0,4,107,39,3,149,274,70,493
5118822,9,3,12,55,23,0,78,249,48,375
5118823,0,0,0,3,6,0,9,89,10,108
5118824,6,3,9,52,23,9,84,204,10,298
5118825,3,0,3,132,51,3,186,364,28,578
5118826,3,0,3,81,25,0,106,219,45,370
5118827,9,0,9,47,22,3,72,232,28,332
5118828,0,0,0,72,44,3,119,216,18,353
5118829,7,6,13,81,47,0,128,391,90,609
5118830,13,3,16,48,20,3,71,269,33,373
5118831,6,0,6,65,39,0,104,268,30,402
5118832,7,8,15,49,30,0,79,206,41,326
5118833,3,0,3,15,0,0,15,22,0,37
5118834,3,0,3,54,18,0,72,191,22,285
5118835,0,0,0,108,37,0,145,314,19,478
5118901,0,0,0,0,0,0,0,0,7,7
5119001,6,0,6,56,41,0,97,233,33,363
5119002,6,0,6,76,33,8,117,242,28,387
5119003,15,0,15,50,49,9,108,263,21,392
5119004,13,0,13,74,34,0,108,214,25,347
5119005,6,0,6,40,20,3,63,169,11,243
5119006,10,3,13,43,30,5,78,189,17,284
5119007,3,4,7,84,42,10,136,267,31,434
5119008,10,0,10,91,35,3,129,297,38,464
5119009,11,3,14,50,29,0,79,263,36,378
5119010,3,0,3,62,31,0,93,232,12,337
5119011,0,0,0,86,36,0,122,296,6,424
5119012,7,0,7,48,18,0,66,238,50,354
5119013,7,4,11,40,39,0,79,271,32,382
5119014,3,3,6,50,28,6,84,176,28,288
5119015,7,4,11,53,24,0,77,313,28,418
5119016,3,0,3,39,9,0,48,112,12,172
5119017,0,0,0,80,38,12,130,226,29,385
5119018,6,0,6,50,28,3,81,175,20,276
5119019,6,0,6,66,28,0,94,181,19,294
5119020,7,0,7,29,35,4,68,183,12,263
5119021,6,0,6,61,26,0,87,202,36,325
5119022,6,3,9,47,32,3,82,183,16,281
5119023,84,0,84,27,27,3,57,318,28,403
5119024,9,0,9,23,20,6,49,179,26,254
5119025,12,0,12,62,39,0,101,272,33,406
5119026,3,0,3,201,69,7,277,474,40,791
5119101,0,0,0,197,27,0,224,194,30,448
5119102,0,0,0,43,22,6,71,124,31,226
5119103,3,0,3,117,33,0,150,222,29,401
5119104,3,0,3,85,26,0,111,155,23,289
5119105,0,0,0,51,14,6,71,118,27,216
5119106,0,3,3,68,17,0,85,176,27,288
5119107,3,0,3,56,21,6,83,160,22,265
5119108,0,0,0,75,19,6,100,123,3,226
5119109,0,0,0,129,27,13,169,192,14,375
5119110,0,0,0,155,30,11,196,247,12,455
5119111,0,0,0,176,34,12,222,267,23,512
5119112,0,0,0,192,18,8,218,212,24,454
5119113,0,0,0,205,36,7,248,267,30,545
5119114,0,3,3,130,21,0,151,164,12,327
5119115,0,0,0,83,18,3,104,100,20,224
5119116,0,0,0,147,22,12,181,268,17,466
5119117,0,0,0,61,28,0,89,127,10,226
5119118,0,0,0,148,29,4,181,219,9,409
5119119,3,0,3,68,31,0,99,169,42,310
5119120,0,0,0,236,36,6,278,244,9,531
5119121,0,0,0,357,35,25,417,343,36,796
5119122,0,0,0,79,21,0,100,150,23,273
5119123,0,0,0,60,25,6,91,137,7,235
5119124,3,0,3,130,28,10,168,237,27,432
5119125,3,0,3,104,24,6,134,190,15,339
5119126,0,0,0,95,33,3,131,227,27,385
5119127,0,0,0,153,39,15,207,278,34,519
5119128,0,0,0,105,26,10,141,143,13,297
5119129,0,0,0,151,30,12,193,225,20,438
5119130,0,0,0,55,21,0,76,144,13,233
5119201,6,3,9,51,19,6,76,152,21,249
5119202,3,0,3,54,36,3,93,216,32,341
5119203,6,0,6,62,26,6,94,189,40,323
5119204,15,3,18,74,39,6,119,272,29,420
5119205,9,0,9,40,26,0,66,177,15,258
5119206,9,4,13,60,32,0,92,243,24,359
5119207,3,0,3,84,24,0,108,210,28,346
5119208,0,0,0,46,19,3,68,119,35,222
5119209,0,0,0,59,15,3,77,168,13,258
5119210,3,3,6,67,14,3,84,165,31,280
5119211,0,0,0,58,14,3,75,168,20,263
5119212,0,0,0,147,39,3,189,268,44,501
5119213,0,0,0,88,33,4,125,289,21,435
5119214,4,0,4,65,31,6,102,148,6,256
5119215,6,0,6,43,22,3,68,119,18,205
5119216,22,0,22,49,15,3,67,157,3,227
5119217,3,7,10,100,27,9,136,292,90,518
5119218,0,0,0,152,35,14,201,231,37,469
5119219,3,0,3,96,25,4,125,297,31,453
5119220,3,0,3,86,25,9,120,308,25,453
5119221,3,0,3,41,8,4,53,149,31,233
5119222,0,0,0,63,33,8,104,196,11,311
5119223,0,0,0,91,32,0,123,179,33,335
5119224,3,0,3,61,21,6,88,219,30,337
5119225,0,0,0,61,22,0,83,141,25,249
5119226,0,0,0,61,19,7,87,171,23,281
5119227,6,0,6,51,25,0,76,172,18,266
5119228,0,0,0,62,29,3,94,218,12,324
5119229,0,0,0,35,22,0,57,118,29,204
5119301,0,3,3,63,26,3,92,168,31,291
5119302,3,3,6,69,26,0,95,212,31,338
5119303,0,0,0,46,10,0,56,166,21,243
5119304,3,0,3,50,34,0,84,158,5,247
5119305,3,0,3,115,36,4,155,239,13,407
5119306,4,0,4,33,22,0,55,136,7,198
5119307,0,3,3,81,23,7,111,185,38,334
5119308,3,5,8,49,20,3,72,174,44,290
5119309,3,0,3,102,32,8,142,204,33,379
5119310,6,3,9,104,33,4,141,215,46,402
5119311,0,0,0,68,22,0,90,145,33,268
5119312,0,0,0,72,18,0,90,125,20,235
5119313,0,0,0,51,8,6,65,103,15,183
5119314,3,0,3,93,27,3,123,214,38,375
5119315,0,0,0,51,16,12,79,182,21,282
5119316,0,0,0,71,9,4,84,171,24,279
5119317,3,0,3,74,27,3,104,154,27,285
5119318,0,0,0,53,15,3,71,158,16,245
5119319,0,0,0,35,15,0,50,105,13,168
5119320,0,0,0,64,18,0,82,144,17,243
5119321,0,0,0,78,24,0,102,159,4,265
5119322,3,0,3,107,25,0,132,222,27,381
5119323,3,3,6,65,31,6,102,208,16,326
5119324,3,0,3,86,17,9,112,186,34,332
5119325,0,3,3,109,56,5,170,273,39,482
5119326,6,3,9,99,31,7,137,243,31,411
5119327,0,3,3,73,27,4,104,203,40,347
5119328,0,0,0,64,26,0,90,228,13,331
5119401,0,0,0,106,12,9,127,119,6,252
5119402,3,0,3,29,15,0,44,106,18,168
5119403,0,0,0,3,0,0,3,6,0,9
5119404,0,0,0,0,0,0,0,0,0,0
5119405,0,0,0,58,21,3,82,122,41,245
5119406,50,3,53,11,19,0,30,255,30,315
5119407,11,0,11,45,29,0,74,278,67,419
5119408,0,4,4,94,30,6,130,267,43,440
5119409,0,0,0,79,34,0,113,206,49,368
5119410,0,0,0,66,21,0,87,145,37,269
5119411,20,6,26,30,15,3,48,220,42,310
5119412,0,0,0,75,15,7,97,116,22,235
5119413,7,4,11,46,18,6,70,217,33,320
5119414,4,4,8,54,18,0,72,175,25,272
5119415,8,3,11,59,19,0,78,211,30,319
5119416,0,0,0,60,23,0,83,137,67,287
5119417,4,0,4,102,18,12,132,222,29,383
5119418,10,6,16,37,10,3,50,198,19,267
5119419,3,0,3,38,18,0,56,124,18,198
5119420,0,0,0,92,24,3,119,184,13,316
5119421,0,0,0,107,25,0,132,177,19,328
5119422,0,0,0,35,22,3,60,139,7,206
5119423,0,0,0,38,9,5,52,118,9,179
5119424,0,0,0,59,23,3,85,169,28,282
5119425,6,0,6,73,21,0,94,202,30,326
5119426,6,0,6,38,19,0,57,167,19,243
5119427,0,3,3,33,11,0,44,77,23,144
5119428,0,0,0,63,21,9,93,172,6,271
5119429,3,0,3,36,7,3,46,99,21,166
5119430,0,0,0,72,27,6,105,150,28,283
5119431,0,3,3,76,27,4,107,212,51,370
5119432,0,3,3,39,20,3,62,136,30,228
5119433,0,0,0,40,24,0,64,161,15,240
5119434,3,0,3,22,13,0,35,100,15,150
5119435,0,3,3,32,22,3,57,136,21,214
5119501,0,0,0,0,0,0,0,0,0,0
5119502,0,0,0,24,15,8,47,84,9,140
5119503,3,0,3,32,3,0,35,99,17,151
5119504,0,0,0,0,0,0,0,6,0,6
5119505,0,3,3,112,22,0,134,287,55,476
5119506,3,0,3,110,9,12,131,232,36,399
5119507,0,0,0,27,9,3,39,124,21,184
5119508,0,0,0,60,9,0,69,216,5,290
5119509,0,0,0,64,6,6,76,106,6,188
5119510,0,0,0,40,4,0,44,73,0,117
5119511,4,0,4,71,17,0,88,219,59,366
5119512,3,0,3,100,22,9,131,174,37,342
5119513,3,0,3,0,0,0,0,3,0,3
5119514,0,0,0,86,21,3,110,178,24,312
5119515,0,0,0,56,6,9,71,103,9,183
5119601,0,0,0,27,15,0,42,80,0,122
5119602,3,0,3,78,31,3,112,209,47,368
5119603,0,0,0,53,23,6,82,190,18,290
5119604,0,0,0,32,11,6,49,193,27,269
5119605,3,0,3,49,10,3,62,124,65,251
5119606,3,4,7,54,14,3,71,140,43,254
5119607,0,4,4,68,20,0,88,188,67,343
5119608,0,0,0,49,23,0,72,162,55,289
5119609,3,0,3,49,24,3,76,193,46,315
5119610,0,0,0,49,12,0,61,174,41,276
5119611,0,0,0,39,24,3,66,112,49,227
5119612,0,0,0,57,21,6,84,151,48,283
5119613,7,0,7,27,4,3,34,118,32,184
5119614,0,0,0,51,22,0,73,166,41,280
5119615,0,0,0,41,9,0,50,101,12,163
5119616,3,0,3,37,14,0,51,120,13,184
5119701,0,0,0,0,0,0,0,0,0,0
5119702,0,0,0,26,9,0,35,38,3,76
5119703,0,0,0,43,14,4,61,91,14,166
5119704,3,0,3,34,9,0,43,136,18,197
5119705,0,0,0,53,10,9,72,242,51,365
5119706,0,0,0,50,24,6,80,174,22,276
5119707,0,0,0,23,9,0,32,108,18,158
5119708,0,0,0,83,24,6,113,226,42,381
5119709,4,0,4,22,9,0,31,146,54,231
5119710,5,0,5,53,13,0,66,197,18,281
5119711,6,0,6,39,10,0,49,187,22,258
5119712,0,0,0,14,0,0,14,67,20,101
5119713,3,0,3,40,4,6,50,112,8,170
5119714,0,0,0,20,4,4,28,92,32,152
5119715,0,0,0,109,11,9,129,225,25,379
5119801,0,0,0,127,35,10,172,267,79,518
5119802,0,0,0,97,26,4,127,137,42,306
5119803,3,0,3,81,31,4,116,261,154,531
5119804,0,0,0,66,13,15,94,162,54,310
5119805,3,0,3,33,21,6,60,180,69,309
5119806,0,0,0,0,0,0,0,0,0,0
5119807,0,0,0,38,9,3,50,185,85,320
5119808,0,0,0,40,9,0,49,114,55,218
5119809,0,0,0,57,25,15,97,160,57,314
5119810,0,0,0,63,26,9,98,236,74,408
5119811,0,0,0,62,24,6,92,201,87,380
5119812,3,3,6,97,12,7,116,223,55,394
5119813,0,0,0,74,9,10,93,210,47,350
5119814,3,3,6,72,12,8,92,188,52,332
5119815,0,0,0,86,13,0,99,154,11,264
5119816,3,0,3,71,21,3,95,208,29,332
5119817,0,3,3,65,12,0,77,189,32,298
5119818,0,0,0,70,17,0,87,196,58,341
5119901,0,0,0,35,12,6,53,101,45,199
5119902,0,0,0,23,0,0,23,54,3,80
5119903,0,0,0,9,9,0,18,83,14,115
5119904,26,0,26,70,12,3,85,257,74,416
5119905,0,4,4,17,15,0,32,190,72,294
5119906,0,3,3,42,19,0,61,214,84,359
5119907,0,0,0,54,0,3,57,108,15,180
5119908,0,0,0,125,15,6,146,123,4,273
5119909,0,0,0,14,12,0,26,56,10,92
5119910,0,0,0,41,26,0,67,211,49,327
5119911,4,0,4,23,6,0,29,224,37,290
5119912,0,0,0,69,25,0,94,268,43,405
5119913,3,6,9,63,26,3,92,153,34,279
5119914,6,0,6,107,28,6,141,275,36,452
5119915,3,0,3,74,16,6,96,225,79,400
5119916,23,3,26,60,13,3,76,272,30,378
5119917,0,0,0,95,35,7,137,290,154,581
5119918,3,0,3,90,21,9,120,257,78,455
5119919,3,0,3,46,24,0,70,241,78,389
5119920,0,0,0,64,13,3,80,282,75,437
5119921,4,0,4,56,22,0,78,211,62,351
5119922,0,0,0,77,20,7,104,187,35,326
5119923,0,0,0,103,40,8,151,261,20,432
5119924,3,0,3,63,27,3,93,178,68,339
5119925,0,0,0,133,44,0,177,254,29,460
5119926,0,0,0,131,41,6,178,307,85,570
5119927,0,0,0,101,16,3,120,260,32,412
5119928,4,0,4,128,36,6,170,234,31,435
5119929,0,0,0,86,14,11,111,170,9,290
5119930,0,0,0,113,13,0,126,135,8,269
5119931,0,0,0,51,13,3,67,165,17,249
5119932,0,0,0,93,19,6,118,139,18,275
5120001,0,0,0,49,9,3,61,102,18,181
5120002,0,0,0,38,6,0,44,79,14,137
5120003,0,0,0,45,4,7,56,111,32,199
5120004,0,0,0,62,17,5,84,143,36,263
5120005,0,0,0,13,0,0,13,10,0,23
5120006,0,0,0,68,19,0,87,130,45,262
5120007,0,0,0,74,37,0,111,245,123,479
5120008,0,0,0,89,9,4,102,172,27,301
5120009,0,0,0,0,0,0,0,0,0,0
5120010,0,0,0,75,7,5,87,91,25,203
5120011,0,0,0,0,0,0,0,0,0,0
5120012,0,0,0,98,18,0,116,106,20,242
5120013,0,0,0,0,0,0,0,0,0,0
5120014,0,0,0,0,0,0,0,0,0,0
5120015,0,0,0,54,9,0,63,118,12,193
5120016,0,0,0,67,10,0,77,135,24,236
5120017,0,0,0,0,0,0,0,0,0,0
5120018,3,0,3,68,8,6,82,147,28,257
5120019,3,0,3,69,17,4,90,175,18,283
5120020,0,3,3,84,27,12,123,217,35,375
5120021,3,0,3,62,21,3,86,169,54,309
5120022,0,0,0,65,16,0,81,181,60,322
5120023,3,4,7,99,26,9,134,251,48,433
5120024,6,0,6,82,19,4,105,151,35,291
5120025,0,0,0,39,15,0,54,102,12,168
5120026,4,0,4,91,22,4,117,169,37,323
5120027,3,0,3,105,18,6,129,183,24,336
5120028,6,0,6,69,18,8,95,188,16,299
5120029,3,0,3,86,27,8,121,205,9,335
5120030,3,0,3,85,18,9,112,251,43,406
5120031,0,0,0,0,0,0,0,0,0,0
5120101,0,0,0,0,0,0,0,0,0,0
5120201,0,3,3,48,31,3,82,167,46,295
5120202,0,0,0,0,0,0,0,0,0,0
5120203,0,0,0,25,4,0,29,137,33,199
5120204,0,0,0,39,18,0,57,149,53,259
5120205,0,0,0,0,0,0,0,22,3,25
5120206,0,0,0,61,15,0,76,289,90,455
5120207,0,0,0,7,0,0,7,24,0,31
5120208,0,0,0,19,3,0,22,28,0,50
5120209,0,0,0,45,15,6,66,181,78,325
5120210,7,0,7,55,12,4,71,218,59,348
5120211,3,0,3,56,8,0,64,150,37,251
5120212,0,0,0,104,15,5,124,198,34,356
5120213,0,0,0,107,18,4,129,148,30,307
5120214,0,0,0,73,15,4,92,99,18,209
5120215,0,0,0,67,10,4,81,144,23,248
5120216,0,0,0,75,15,3,93,78,18,189
5120217,0,0,0,49,8,5,62,168,58,288
5120218,3,0,3,90,19,4,113,147,55,315
5120301,0,0,0,0,0,0,0,0,0,0
5120302,0,0,0,31,28,0,59,91,15,165
5120303,0,0,0,13,31,6,50,64,8,122
5120304,0,0,0,36,24,4,64,31,9,104
5120305,0,0,0,52,32,9,93,121,21,235
5120306,0,0,4,45,74,3,122,187,36,345
5120307,0,0,0,107,7,3,117,171,34,322
5120308,0,0,0,87,26,3,116,320,75,511
5120309,0,0,3,76,18,0,94,351,131,576
5120310,0,0,0,12,13,0,25,36,0,61
5120311,0,0,0,57,40,8,105,286,227,618
5120312,0,0,0,18,3,0,21,101,21,143
5120313,3,0,3,40,7,0,47,203,170,420
5120314,0,0,0,39,27,7,73,212,55,340
5120315,0,0,0,6,16,9,31,63,15,109
5120316,0,0,0,21,23,6,50,77,4,131
5120317,0,0,0,15,17,6,38,48,6,92
5120318,0,0,0,60,8,0,68,67,30,165
5120319,0,0,0,7,0,0,7,48,0,55
5120401,0,0,0,0,0,0,0,0,0,0
5120501,0,0,0,13,0,0,13,54,129,196
5120502,0,0,0,0,0,0,0,0,0,0
5120503,0,0,0,44,26,4,74,154,34,262
5120504,6,0,6,59,25,3,87,208,43,338
5120505,0,0,0,70,19,6,95,247,24,366
5120506,0,0,0,6,4,0,10,78,18,106
5120507,0,3,3,25,23,9,57,147,62,266
5120508,0,0,0,13,10,0,23,112,25,160
5120509,0,0,0,90,39,8,137,272,68,477
5120510,0,4,4,46,16,9,71,173,47,291
5120511,3,0,3,43,24,6,73,192,52,317
5120512,3,0,3,54,15,0,69,230,96,395
5120513,0,0,0,41,8,3,52,137,24,213
5120514,0,0,0,24,10,6,40,108,22,170
5120515,0,0,0,71,27,0,98,144,55,297
5120516,3,3,6,12,18,0,30,202,39,271
5120517,0,7,7,30,9,0,39,108,57,204
5120518,0,0,0,25,7,0,32,45,17,94
5120519,0,0,0,65,9,12,86,135,28,249
5120520,0,0,0,48,7,8,63,164,37,264
5120521,0,0,0,117,25,21,163,172,53,388
5120522,0,0,0,10,6,0,16,55,29,100
5120523,0,0,0,90,20,3,113,278,19,410
5120524,0,0,0,51,15,12,78,149,19,246
5120525,0,0,0,142,48,0,190,302,55,547
5120526,3,0,3,57,5,0,62,156,3,221
5120527,3,0,3,31,9,7,47,155,29,231
5120528,0,0,0,40,12,3,55,174,24,253
5120529,0,0,0,23,20,3,46,114,75,235
5120530,0,0,0,43,13,0,56,144,30,230
5120531,4,0,4,43,20,4,67,99,37,203
5120532,0,0,0,62,21,8,91,165,58,314
5120533,0,0,0,36,16,3,55,203,36,294
5120534,3,3,6,145,34,8,187,275,58,520
5120535,0,0,0,152,21,12,185,236,66,487
5120536,0,0,0,69,14,0,83,118,24,225
5120601,0,0,0,18,3,0,21,59,15,95
5120602,0,0,0,30,12,0,42,41,0,83
5120603,0,0,0,3,0,9,12,26,0,38
5120604,0,0,0,13,22,0,35,53,12,100
5120605,0,0,0,11,5,0,16,93,21,130
5120606,0,0,0,18,0,0,18,22,0,40
5120607,0,0,0,8,4,0,12,8,3,23
5120608,0,0,0,12,0,0,12,18,0,30
5120609,0,0,0,84,18,0,102,82,6,190
5120610,3,0,3,86,33,3,122,291,55,468
5120611,3,0,3,33,20,0,53,81,0,134
5120612,0,3,3,61,21,9,91,141,21,253
5120613,0,0,0,23,23,0,46,47,0,93
5120614,4,0,4,8,15,10,33,11,11,55
5120615,0,0,0,19,0,0,19,37,0,56
5120616,0,0,0,18,16,9,43,75,22,140
5120617,0,3,3,28,46,22,96,85,12,193
5120618,0,0,0,3,0,0,3,18,13,34
5120619,15,0,15,51,26,0,77,153,74,304
5120620,4,0,4,35,12,3,50,95,23,168
5120621,0,0,0,63,18,9,90,182,50,322
5120622,0,0,0,71,20,4,95,173,130,398
5120623,3,3,6,73,34,10,117,221,93,431
5120624,0,0,0,73,18,3,94,281,107,482
5120625,0,0,0,17,8,0,25,131,1445,1601
5120626,0,0,0,8,6,0,14,49,14,77
5120627,0,0,0,9,33,12,54,35,0,89
5120628,0,0,0,52,44,0,96,102,8,206
5120629,0,0,0,47,45,5,97,156,4,257
5120701,3,0,3,35,24,0,59,147,13,219
5120702,0,0,0,22,12,0,34,49,0,83
5120703,3,0,3,43,30,10,83,249,21,353
5120704,0,0,0,41,70,12,123,107,3,233
5120705,0,6,6,69,34,16,119,184,48,351
5120706,0,0,0,29,19,0,48,185,47,280
5120707,0,0,0,29,22,19,70,70,0,140
5120708,0,0,0,28,25,12,65,32,0,97
5120709,0,0,0,72,53,9,134,215,10,359
5120710,0,0,0,29,19,12,60,53,0,113
5120711,0,0,0,48,48,24,120,98,36,254
5120801,0,0,0,46,5,0,51,103,8,162
5120802,0,0,0,21,13,0,34,102,31,167
5120803,0,0,0,31,22,3,56,134,14,204
5120804,0,0,0,42,15,12,69,222,79,370
5120805,0,0,0,129,27,11,167,379,42,588
5120806,0,0,0,0,0,0,0,15,0,15
5120807,0,0,0,25,15,0,40,46,21,107
5120808,0,3,3,39,10,3,52,103,43,198
5120809,3,0,3,63,47,9,119,164,13,296
5120810,4,0,4,85,35,9,129,186,47,362
5120811,0,0,0,176,47,20,243,358,43,644
5120812,0,0,0,18,20,3,41,38,8,87
5120813,0,0,0,14,7,4,25,34,3,62
5120814,0,0,0,61,20,3,84,398,51,533
5120815,0,0,0,111,45,5,161,388,70,619
5120816,0,0,0,70,23,9,102,358,74,534
5120817,0,0,0,89,41,29,159,255,102,516
5120818,0,0,0,74,32,7,113,261,52,426
5120901,0,0,0,63,9,6,78,145,38,261
5120902,0,0,0,85,101,19,205,175,14,394
5120903,3,0,3,58,28,0,86,109,9,204
5120904,0,0,0,48,7,0,55,88,3,146
5120905,0,0,0,66,22,4,92,81,3,176
5120906,0,0,0,33,12,3,48,143,35,226
5120907,0,0,0,22,16,9,47,74,6,127
5121001,4,0,4,67,32,4,103,255,38,396
5121002,8,0,8,48,19,0,67,153,17,237
5121003,6,0,6,36,9,7,52,149,12,213
5121004,8,3,11,61,30,0,91,276,33,400
5121005,9,0,9,38,16,3,57,157,18,232
5121006,7,0,7,50,31,0,81,209,26,316
5121007,8,3,11,47,40,0,87,266,31,384
5121008,20,0,20,38,23,3,64,226,42,332
5121009,0,0,0,48,21,3,72,156,28,256
5121010,0,0,0,49,15,6,70,147,15,232
5121011,6,3,9,63,32,5,100,239,25,364
5121012,54,0,54,23,9,3,35,205,12,252
5121013,9,0,9,91,34,5,130,301,37,468
5121014,6,3,9,72,33,0,105,279,34,418
5121015,45,26,71,36,22,0,58,283,56,397
5121016,4,0,4,26,16,0,42,132,18,192
5121017,24,0,24,62,17,3,82,296,68,446
5121018,5,0,5,70,31,9,110,275,14,399
5121019,6,4,10,76,30,0,106,232,38,376
5121020,6,0,6,62,27,6,95,181,13,289
5121021,3,0,3,46,30,6,82,229,22,333
5121022,6,3,9,28,25,3,56,343,47,446
5121023,0,0,0,0,0,0,0,0,0,0
5121024,0,0,0,0,0,0,0,6,0,6
5121025,4,0,4,54,33,10,97,167,26,290
5121026,7,0,7,49,27,0,76,194,12,282
5121027,3,3,9,63,26,8,97,207,67,371
5121028,6,3,9,36,34,9,79,142,30,251
5121029,3,0,3,47,27,0,74,141,38,253
5121030,4,0,4,54,21,6,81,199,41,321
5121031,0,0,0,26,6,3,35,62,12,109
5121032,5,0,5,58,26,3,87,244,35,366
5121033,6,3,9,87,29,6,122,222,32,376
5121101,3,3,6,125,32,3,160,314,24,498
5121102,6,3,9,102,24,9,135,219,30,384
5121103,3,0,3,18,21,3,42,93,30,165
5121104,0,0,0,94,24,9,127,236,32,395
5121105,0,0,0,89,31,3,123,247,79,449
5121106,0,0,0,42,18,3,63,122,62,247
5121107,3,0,3,43,16,4,63,109,47,219
5121108,0,0,0,85,33,6,124,170,9,303
5121109,6,0,6,79,21,3,103,244,37,384
5121110,0,0,0,71,9,0,80,97,3,180
5121111,0,0,0,59,17,13,89,172,16,277
5121112,3,0,3,37,14,0,51,135,18,204
5121113,0,0,0,115,21,7,143,197,12,352
5121114,3,0,3,90,23,0,113,179,16,308
5121115,3,0,3,48,40,0,88,251,19,358
5121116,3,0,3,59,26,0,85,191,12,288
5121117,0,3,3,59,23,6,88,189,32,309
5121118,0,0,0,29,6,9,44,116,298,458
5121201,0,3,3,78,25,3,106,199,25,330
5121202,0,0,0,77,9,0,86,93,6,185
5121203,0,0,0,113,22,0,135,184,14,333
5121204,9,0,9,74,22,0,96,228,21,345
5121205,3,3,6,26,7,0,33,128,9,170
5121206,3,0,3,89,32,3,124,188,16,328
5121207,0,0,0,81,16,10,107,147,10,264
5121208,3,0,3,138,33,8,179,223,29,431
5121209,0,0,0,76,22,0,98,129,25,252
5121210,3,0,3,48,13,3,64,160,16,240
5121211,3,0,3,105,27,0,132,172,17,321
5121212,3,0,3,55,35,0,90,183,6,279
5121213,3,0,3,61,22,3,86,180,18,284
5121214,6,0,6,53,19,3,75,202,29,306
5121215,3,0,3,36,18,0,54,105,10,169
5121216,0,0,0,67,20,3,90,186,15,291
5121217,0,0,0,75,13,3,91,152,25,268
5121218,0,0,0,50,6,0,56,93,14,163
5121301,0,0,0,92,19,12,123,191,18,332
5121302,0,0,0,105,30,6,141,230,23,394
5121303,0,0,0,82,43,6,131,275,15,421
5121304,0,0,0,56,21,3,80,186,25,291
5121305,3,0,3,60,28,7,95,244,15,354
5121306,3,0,3,46,21,0,67,305,27,399
5121307,0,0,0,73,13,9,95,179,33,307
5121308,3,3,6,109,40,3,152,284,41,477
5121309,0,0,0,115,31,3,149,162,25,336
5121310,7,0,7,70,27,3,100,208,28,336
5121311,0,3,3,106,32,4,142,213,29,384
5121312,0,0,0,83,24,6,113,229,21,363
5121313,5,0,5,95,37,6,138,284,35,457
5121314,6,6,12,41,15,0,56,159,23,238
5121315,0,0,0,123,20,10,153,163,24,340
5121316,4,0,4,162,31,12,205,237,21,463
5121317,0,0,0,46,13,0,59,107,13,179
5121318,0,0,0,87,18,0,105,141,20,266
5121319,0,0,0,99,29,0,128,229,21,378
5121320,0,0,0,65,16,6,87,168,12,267
5121401,3,0,3,28,6,6,40,62,12,114
5121402,12,0,12,79,35,3,117,271,46,434
5121403,0,0,0,0,0,0,0,0,0,0
5121404,0,0,0,84,22,3,109,278,30,417
5121405,0,0,0,67,24,4,95,244,22,361
5121406,8,8,16,53,12,4,69,231,38,338
5121407,8,0,8,62,19,7,88,182,21,291
5121408,0,0,0,82,16,0,98,211,22,331
5121409,0,0,0,59,15,0,74,147,24,245
5121410,3,4,7,54,12,3,69,200,12,281
5121501,0,0,0,23,3,0,26,57,3,86
5121502,0,0,0,12,6,0,18,19,0,37
5121503,3,0,3,55,26,6,87,209,88,384
5121504,0,0,0,21,17,0,38,100,48,186
5121505,0,0,0,7,10,3,20,38,0,58
5121506,0,0,0,51,30,6,87,123,0,210
5121507,0,0,0,61,14,0,75,212,64,351
5121508,3,0,3,15,3,0,18,121,46,185
5121509,0,0,0,42,18,4,64,296,46,406
5121510,0,0,0,125,31,6,162,468,141,771
5121511,0,0,0,75,28,3,106,310,101,517
5121512,0,0,0,3,0,0,3,23,11,37
5121513,0,0,0,7,0,0,7,69,18,94
5121514,0,0,0,13,0,0,13,71,31,115
5121601,9,4,13,55,12,4,71,199,41,311
5121602,8,4,12,66,22,7,95,190,20,305
5121603,0,0,0,37,3,6,46,110,26,182
5121604,3,0,3,46,19,0,65,113,9,187
5121605,0,0,0,34,9,4,47,79,9,135
5121606,3,3,6,48,20,0,68,148,22,238
5121607,3,0,3,35,6,0,41,165,17,223
5121608,0,0,0,30,7,3,40,54,13,107
5121609,0,0,0,10,4,0,14,62,15,91
5121610,3,0,3,111,21,4,136,430,80,646
5121611,0,0,0,52,12,3,67,70,3,140
5121612,0,0,0,55,12,4,71,84,3,158
5121613,3,0,3,24,7,0,31,88,6,125
5121614,3,0,3,54,9,3,66,165,0,231
5121615,0,0,0,37,18,7,62,213,16,291
5121616,0,0,0,19,18,4,41,156,35,232
5121701,0,3,6,15,4,0,19,84,15,118
5121702,0,0,0,6,6,0,12,15,3,30
5121703,3,0,3,20,15,0,35,142,12,189
5121704,6,3,9,29,10,3,42,89,18,149
5121705,14,0,14,43,9,0,52,226,39,317
5121706,0,0,0,37,10,3,50,60,18,128
5121707,0,3,3,42,15,3,60,150,39,249
5121708,0,0,0,51,18,0,69,152,3,224
5121709,0,0,0,70,16,7,93,131,12,236
5121710,0,0,0,51,4,4,59,104,15,178
5121711,3,3,6,47,20,6,73,155,21,249
5121712,3,0,3,61,21,3,85,193,20,298
5121713,3,0,3,39,24,0,63,145,24,232
5121714,0,0,3,40,28,0,68,202,27,297
5121715,0,0,0,58,10,0,68,69,15,152
5121716,3,0,3,62,29,0,91,271,44,406
5121717,0,5,5,55,21,0,76,250,35,361
5121718,0,0,0,73,9,0,82,189,8,279
5121719,0,0,0,0,0,0,0,3,0,3
5121720,4,0,4,39,17,0,56,159,59,274
5121721,0,0,0,33,0,0,33,102,18,153
5121722,0,0,0,38,12,3,53,71,6,130
5121801,0,0,0,103,21,3,127,141,9,277
5121802,0,0,0,72,8,0,80,191,24,295
5121803,0,0,0,154,22,9,185,184,10,379
5121804,0,0,0,83,6,3,92,111,26,229
5121805,0,0,0,85,7,0,92,155,35,282
5121806,0,0,0,150,25,5,180,283,30,493
5121807,0,0,0,332,76,7,415,1163,681,2259
5121808,0,0,0,138,22,3,163,258,23,444
5121809,0,0,0,133,24,9,166,141,11,318
5121810,0,0,0,133,16,9,158,111,15,284
5121811,4,0,4,99,15,0,114,147,21,282
5121812,0,0,0,154,39,3,196,1075,413,1684
5121813,0,0,0,156,22,12,190,250,28,468
5121814,0,0,0,97,45,6,148,298,66,512
5121901,0,0,0,21,18,0,39,76,9,124
5121902,0,0,0,13,33,22,68,39,0,107
5121903,0,0,0,0,0,0,0,6,3,9
5121904,0,0,0,9,28,11,48,40,3,91
5121905,0,0,0,37,74,23,134,73,38,245
5121906,0,0,0,0,3,0,3,15,3,21
5121907,0,0,0,24,7,3,34,86,23,143
5121908,0,0,0,15,9,6,30,41,6,77
5121909,0,0,0,3,22,5,30,18,112,160
5121910,0,0,0,8,12,4,24,23,10,57
5121911,0,0,0,146,36,6,188,575,121,884
5121912,0,0,0,28,55,6,89,17,9,115
5121913,0,0,0,240,61,4,305,1032,511,1848
5121914,0,0,0,7,0,3,10,48,6,64
5121915,0,0,0,173,35,4,212,797,322,1331
5121916,0,0,0,87,19,0,106,447,237,790
5121917,3,0,3,132,45,3,180,594,301,1075
5122001,0,0,0,90,16,0,106,168,29,303
5122002,0,0,0,74,11,8,93,223,67,383
5122003,0,0,0,46,3,4,53,95,47,195
5122004,0,0,0,22,6,0,28,64,43,135
5122005,0,0,0,43,3,9,55,82,21,158
5122006,0,0,0,67,9,4,80,140,29,249
5122007,0,0,0,0,0,0,0,0,0,0
5122008,0,0,0,3,0,0,3,7,0,10
5122009,0,0,0,73,13,0,86,198,98,382
5122010,0,0,0,307,42,17,366,372,93,831
5122011,0,0,0,50,10,7,67,112,34,213
5122012,0,0,0,49,6,0,55,152,58,265
5122013,0,0,0,35,13,0,48,368,60,476
5122014,0,0,0,10,6,0,16,239,76,331
5122015,0,0,0,0,0,0,0,4,0,4
5122016,0,0,0,28,9,0,37,409,409,855
5122017,0,0,0,195,33,17,245,365,113,723
5122018,0,0,0,67,11,4,82,122,73,277
5122019,0,0,0,32,9,0,41,92,39,172
5122020,0,0,0,62,11,4,77,163,70,310
5122021,0,0,0,53,15,0,68,131,41,240
5122022,0,0,0,49,15,0,64,147,42,253
5122023,0,0,0,40,13,0,53,107,30,190
5122024,0,0,0,53,15,6,74,187,84,345
5122025,0,0,0,56,4,4,64,101,26,191
5122026,0,0,0,75,13,0,88,148,109,345
5122027,0,0,0,11,4,0,15,114,39,168
5122028,0,0,0,77,16,0,93,192,60,345
5122029,0,0,0,50,9,3,62,185,44,291
5122030,0,0,0,47,21,6,74,107,32,213
5122031,0,0,0,44,7,0,51,116,38,205
5122032,0,0,0,32,3,0,35,81,25,141
5122033,0,0,0,92,24,0,116,222,80,418
5122034,0,0,0,50,6,0,56,163,29,248
5122035,0,0,0,33,4,0,37,108,77,222
5122036,0,0,0,164,15,7,186,162,44,392
5122037,0,0,0,69,11,10,90,88,43,221
5122038,0,0,0,84,20,6,110,167,45,322
5122039,0,0,0,103,21,6,130,277,54,461
5122040,0,0,0,48,7,7,62,106,46,214
5122041,0,0,0,69,7,3,79,138,45,262
5122042,0,0,0,90,9,5,104,188,89,381
5122043,0,0,0,106,12,0,118,217,105,440
5122101,0,0,0,0,0,0,0,4,0,4
5122102,0,0,0,20,7,0,27,133,50,210
5122103,0,0,0,63,0,4,67,225,203,495
5122104,0,0,0,82,17,9,108,224,98,430
5122105,0,0,0,92,6,3,101,119,81,301
5122106,0,0,0,60,21,5,86,192,33,311
5122107,0,0,0,0,0,0,0,0,0,0
5122108,0,0,0,0,0,0,0,0,0,0
5122109,0,0,0,88,9,3,100,127,25,252
5122110,0,0,0,88,24,3,115,224,64,403
5122111,0,0,0,63,20,6,89,134,52,275
5122112,0,0,0,77,21,7,105,148,64,317
5122113,0,0,0,71,10,3,84,143,62,289
5122114,0,0,0,79,10,0,89,107,81,277
5122115,0,0,0,115,11,0,126,136,30,292
5122116,0,3,3,105,6,0,111,133,33,277
5122117,0,0,0,0,0,0,0,0,0,0
5122201,0,0,0,0,0,0,0,0,0,0
5122202,0,0,0,87,18,3,108,281,90,479
5122203,0,4,4,80,7,6,93,177,36,306
5122204,0,0,0,74,12,3,89,209,74,372
5122205,0,0,0,12,11,9,32,30,3,65
5122206,0,0,0,5,5,0,10,77,70,157
5122207,3,0,3,48,7,0,55,389,155,599
5122208,0,0,0,115,15,11,141,129,33,303
5122209,0,0,0,20,3,0,23,147,90,260
5122210,4,0,4,35,0,0,35,144,71,250
5122211,3,0,3,113,10,6,129,226,77,432
5122212,0,0,0,30,0,0,30,76,49,155
5122213,0,0,0,43,16,0,59,85,33,177
5122214,0,0,0,0,0,0,0,0,0,0
5122215,0,0,0,0,0,0,0,0,0,0
5122301,3,0,3,30,26,0,56,50,47,153
5122302,0,0,0,0,0,0,0,0,0,0
5122303,0,0,0,28,18,3,49,121,34,204
5122304,3,0,3,39,14,9,62,155,74,291
5122305,0,0,0,81,15,3,99,104,18,221
5122306,0,0,0,66,12,4,82,70,27,179
5122307,0,0,0,62,11,9,82,92,28,202
5122308,0,0,0,41,3,0,44,79,60,183
5122309,0,0,0,66,13,6,85,210,92,387
5122310,0,0,0,79,19,3,101,160,65,326
5122311,3,0,3,65,9,0,74,135,32,241
5122312,0,0,0,37,12,3,52,149,48,249
5122313,0,0,0,69,15,6,90,877,735,1702
5122314,0,0,0,69,15,0,84,148,41,273
5122315,0,0,0,29,6,0,35,89,30,154
5122316,0,0,0,0,0,0,0,0,0,0
5122317,0,0,0,3,0,0,3,40,36,79
5122318,0,0,0,30,17,6,53,255,255,563
5122401,0,0,0,3,3,0,6,15,0,21
5122402,0,0,0,39,17,3,59,125,67,251
5122403,12,0,12,12,0,0,12,134,69,215
5122404,0,0,0,11,0,3,14,67,36,117
5122405,0,0,0,56,4,3,63,131,62,256
5122406,0,0,0,32,9,0,41,96,66,203
5122407,0,0,0,89,21,0,110,149,63,322
5122408,0,0,0,56,22,0,78,147,62,287
5122409,0,0,0,41,5,3,49,119,71,239
5122410,0,0,0,0,0,0,0,0,0,0
5122411,0,0,0,107,24,0,131,266,62,459
5122412,0,0,0,121,22,9,152,226,25,403
5122413,0,0,0,77,22,0,99,205,43,347
5122414,4,0,4,100,35,3,138,248,102,488
5122415,0,0,0,55,8,4,67,194,54,315
5122416,0,0,0,97,24,3,124,183,77,384
5122417,0,0,0,49,18,0,67,157,108,332
5122418,0,4,4,54,4,0,58,179,89,326
5122419,0,0,0,68,18,0,86,150,88,324
5122420,0,0,0,61,9,0,70,106,46,222
5122421,0,0,0,34,14,3,51,181,73,305
5122422,0,0,0,100,10,6,116,201,39,356
5122423,0,0,0,57,3,6,66,255,111,432
5122424,0,0,0,40,3,0,43,155,32,230
5122425,0,0,0,48,9,3,60,158,65,283
5122501,0,7,7,84,35,10,129,256,20,405
5122502,7,0,7,30,12,0,42,162,15,219
5122503,10,4,14,70,21,3,94,219,18,331
5122504,18,7,25,40,21,0,61,219,48,328
5122505,13,4,17,69,30,6,105,399,35,539
5122506,24,0,24,45,20,3,68,207,19,294
5122507,14,3,17,49,23,4,76,153,9,238
5122508,21,0,21,43,13,4,60,200,8,268
5122509,6,4,10,88,29,0,117,295,33,445
5122510,21,5,26,57,25,9,91,174,29,294
5122511,9,0,9,57,24,0,81,212,28,321
5122512,42,4,46,65,23,5,93,293,8,394
5122513,18,22,40,21,11,4,36,187,55,278
5122514,6,0,6,57,34,3,94,220,32,346
5122515,19,0,19,96,32,9,137,299,26,462
5122516,12,0,12,50,28,3,81,188,15,284
5122517,3,0,6,56,18,9,83,172,22,277
5122518,9,0,9,46,19,6,71,225,25,321
5122519,16,0,16,74,45,0,119,323,24,466
5122520,6,0,6,25,15,0,40,128,8,176
5122521,14,3,17,89,34,0,123,388,32,543
5122522,30,15,45,52,25,6,83,222,36,341
5122523,16,3,19,87,25,6,118,282,24,424
5122524,8,0,8,120,35,7,162,296,21,479
5122525,0,0,0,65,8,6,79,77,6,162
5122526,44,4,48,52,15,4,71,227,22,320
5122527,66,0,66,34,4,3,41,201,22,264
5122528,19,7,26,19,15,0,34,135,26,195
5122529,0,3,3,33,4,0,37,97,18,152
5122530,7,3,10,64,25,3,92,254,30,376
5122531,0,0,0,0,0,0,0,10,0,10
5122532,6,0,6,47,20,3,70,161,4,235
5122533,17,6,23,67,28,3,98,306,41,445
5122534,10,0,10,39,17,6,62,212,12,286
5122535,0,0,0,54,12,0,66,211,18,295
5122536,0,0,0,12,5,4,21,80,0,101
5122601,0,0,0,50,19,0,69,170,15,254
5122602,0,0,0,80,24,7,111,260,15,386
5122603,3,0,3,55,23,4,82,154,8,244
5122604,0,0,0,52,8,3,63,124,0,187
5122605,0,0,0,49,24,9,82,191,8,281
5122606,0,0,0,56,21,6,83,118,3,204
5122607,3,0,3,49,14,0,63,195,27,285
5122608,0,0,0,33,16,3,52,155,22,229
5122609,3,0,3,44,16,0,60,137,17,214
5122610,4,0,4,26,9,3,38,72,6,116
5122701,3,0,3,41,15,0,56,136,12,204
5122702,3,0,3,124,16,9,149,232,22,403
5122703,13,0,13,62,16,0,78,200,11,289
5122704,3,0,3,63,16,0,79,92,12,183
5122705,0,4,4,82,18,9,109,241,28,378
5122706,0,0,0,81,25,6,112,193,18,323
5122707,0,0,0,3,9,0,12,21,0,33
5122708,0,0,0,77,25,0,102,273,36,411
5122709,0,0,0,48,27,4,79,155,33,267
5122710,3,6,9,47,18,0,65,175,34,274
5122711,3,0,3,97,9,9,115,126,7,248
5122712,0,0,0,87,20,0,107,169,15,291
5122801,7,0,7,56,16,0,72,124,10,206
5122802,3,0,3,65,12,3,80,143,9,232
5122803,0,0,0,0,0,0,0,0,0,0
5122804,0,0,0,0,0,0,0,0,0,0
5122805,0,0,0,0,0,0,0,0,0,0
5122806,0,0,0,31,15,3,49,156,7,212
5122807,6,3,9,15,15,6,36,128,12,176
5122808,6,0,6,42,3,3,48,84,9,141
5122809,3,0,3,49,12,12,73,205,6,284
5122810,3,0,3,43,14,5,62,145,10,217
5122811,5,0,5,53,3,0,56,143,19,218
5122812,6,0,6,51,27,4,82,205,17,304
5122813,0,0,0,25,5,0,30,111,0,141
5122814,10,4,14,53,16,6,75,215,39,329
5122815,12,4,16,51,16,0,67,146,10,223
5122816,6,0,6,51,18,6,75,126,3,204
5122817,3,0,3,57,9,9,75,157,4,236
5122818,0,4,4,27,14,7,48,143,11,202
5122819,19,4,23,27,16,0,43,165,27,235
5122820,0,0,0,74,22,5,101,239,14,354
5122821,0,0,0,62,21,6,89,166,18,273
5122901,0,0,0,44,6,3,53,84,6,143
5122902,0,0,0,59,18,0,77,96,3,176
5122903,0,0,0,54,16,0,70,138,8,216
5122904,3,0,3,42,24,6,72,121,6,199
5122905,3,0,3,45,18,0,63,101,6,170
5122906,0,0,0,79,15,0,94,146,27,267
5122907,0,0,0,26,8,6,40,118,12,170
5122908,0,0,0,43,25,7,75,94,6,175
5122909,9,6,15,58,29,6,93,149,12,254
5122910,0,0,0,46,12,4,62,98,16,176
5122911,0,0,0,41,19,3,63,112,19,194
5123001,0,0,0,90,17,3,110,202,31,343
5123002,3,0,3,27,17,0,44,120,27,191
5123003,7,3,10,48,22,5,75,185,18,278
5123004,0,0,0,46,12,3,61,150,16,227
5123005,0,6,6,55,19,9,83,147,30,260
5123006,8,0,8,39,9,4,52,121,11,184
5123007,0,0,0,42,18,0,60,146,7,213
5123008,0,0,0,59,18,0,77,169,26,272
5123009,3,0,3,106,18,0,124,192,10,326
5123010,3,0,3,85,17,7,109,174,22,305
5123011,0,0,0,36,7,0,43,103,12,158
5123012,0,0,0,43,0,4,47,140,17,204
5123013,0,11,11,78,13,0,91,170,38,299
5123014,13,3,16,39,11,0,50,134,21,205
5123101,0,5,5,30,6,7,43,140,19,202
5123102,4,6,10,69,30,5,104,227,41,372
5123103,0,0,0,67,10,4,81,167,29,277
5123104,0,5,5,54,6,3,63,134,38,235
5123105,3,3,6,54,9,9,72,126,12,210
5123106,0,0,0,39,9,0,48,122,8,178
5123107,3,0,3,61,21,0,82,116,12,210
5123108,22,3,25,94,38,0,132,294,32,458
5123109,6,0,6,85,53,9,147,263,41,451
5123110,0,0,0,41,12,0,53,83,3,139
5123111,0,0,0,56,16,7,79,108,0,187
5123112,0,0,0,35,6,0,41,75,9,125
5123113,0,0,0,44,21,4,69,121,6,196
5123201,3,0,3,43,18,3,64,138,18,220
5123202,3,0,3,44,17,0,61,138,12,211
5123203,4,0,4,70,29,6,105,194,18,317
5123204,0,0,0,76,12,3,91,127,9,227
5123205,3,3,6,46,16,4,66,151,27,244
5123206,9,0,9,46,27,5,78,212,6,296
5123207,3,0,3,36,12,3,51,122,12,185
5123208,0,0,0,70,18,3,91,171,21,283
5123209,0,0,0,36,12,0,48,130,9,187
5123210,0,0,0,9,3,0,12,30,305,347
5123211,4,0,4,24,11,3,38,149,6,193
5123301,5,0,5,55,41,0,96,197,25,318
5123302,5,0,5,79,29,7,115,219,18,352
5123303,0,0,0,55,9,0,64,130,11,205
5123304,0,0,0,52,15,6,73,124,17,214
5123305,3,3,6,109,27,7,143,267,32,442
5123306,0,0,0,83,27,9,119,164,18,301
5123307,0,0,0,30,13,4,47,121,22,190
5123308,7,0,7,123,38,7,168,256,39,463
5123309,6,0,6,82,48,3,133,265,33,431
5123310,6,3,9,65,36,4,105,197,15,317
5123311,3,3,6,53,27,4,84,216,29,329
5123312,4,0,4,97,28,4,129,236,25,390
5123313,5,0,5,40,12,0,52,156,12,220
5123314,0,5,5,306,62,23,391,486,33,910
5123315,0,0,0,73,21,6,100,194,46,340
5123316,3,0,3,35,24,8,67,120,22,209
5123317,6,3,9,69,26,0,95,219,36,350
5123318,0,0,0,56,25,7,88,184,21,293
5123319,6,0,6,58,32,3,93,226,28,347
5123320,3,0,3,73,33,13,119,220,15,354
5123321,0,0,0,50,16,7,73,131,15,219
5123401,0,0,0,37,18,3,58,137,4,199
5123402,0,0,0,30,10,0,40,165,14,219
5123403,0,0,0,53,7,0,60,124,10,194
5123404,0,0,0,55,10,6,71,187,26,284
5123405,0,0,0,25,6,3,34,71,12,117
5123406,38,4,42,28,0,3,31,135,22,188
5123407,6,0,6,83,18,6,107,160,22,289
5123408,0,0,0,44,13,0,57,131,12,200
5123409,3,0,3,34,15,0,49,155,15,219
5123410,3,4,7,32,16,0,48,146,11,205
5123411,0,0,0,52,18,0,70,166,10,246
5123412,6,3,9,76,24,0,100,227,34,361
5123413,6,0,6,55,20,6,81,211,19,311
5123414,3,3,6,52,15,3,70,205,25,300
5123415,3,0,3,69,14,0,83,174,18,275
5123416,6,0,6,51,15,0,66,148,98,312
5123501,0,0,0,0,0,0,0,0,0,0
5123601,0,0,0,31,11,0,42,115,24,181
5123602,0,0,0,32,6,0,38,167,18,223
5123603,3,4,7,63,17,3,83,149,37,269
5123604,0,0,0,71,29,6,106,205,10,321
5123605,6,0,6,52,12,3,67,108,27,202
5123606,0,0,0,59,29,0,88,165,12,265
5123607,0,0,0,154,58,6,218,330,38,586
5123608,3,0,3,50,15,0,65,120,12,197
5123609,3,0,6,110,40,6,156,209,26,391
5123610,6,0,6,98,30,0,128,245,19,392
5123611,0,3,3,30,0,0,30,151,10,191
5123612,0,0,0,43,12,0,55,156,24,235
5123701,0,0,0,29,11,0,40,76,12,128
5123702,3,0,3,54,18,5,77,74,18,169
5123703,13,0,13,28,11,0,39,178,9,226
5123704,12,0,12,52,10,0,62,226,20,308
5123705,23,3,26,71,27,0,98,313,43,454
5123706,0,0,0,57,24,3,84,138,12,234
5123707,0,0,0,81,19,0,100,195,7,302
5123708,18,7,25,96,32,8,136,351,48,535
5123709,4,0,4,44,25,3,72,152,9,233
5123710,0,3,3,41,6,0,47,154,15,216
5123711,3,0,3,48,22,0,70,228,13,311
5123801,8,3,11,63,22,4,89,195,22,306
5123802,9,0,9,72,17,7,96,175,20,291
5123803,13,3,16,80,40,3,123,269,24,416
5123804,0,0,0,90,22,3,115,198,27,340
5123805,7,3,10,31,9,0,40,188,34,262
5123806,0,0,0,35,12,0,47,67,12,126
5123807,4,0,4,43,15,0,58,149,9,216
5123808,0,0,0,65,9,0,74,154,15,243
5123809,7,9,16,58,26,4,88,178,24,290
5123810,6,0,6,65,21,0,86,138,3,227
5123811,8,0,8,46,3,6,55,93,9,157
5123812,0,0,0,75,21,0,96,149,7,252
5123901,0,0,0,24,9,3,36,114,21,171
5123902,3,0,3,35,12,0,47,147,21,215
5123903,0,0,0,25,3,6,34,118,21,173
5123904,3,0,3,48,6,6,60,197,41,298
5123905,5,0,5,82,21,3,106,293,61,460
5123906,3,0,3,35,15,0,50,87,48,185
5123907,0,4,4,74,16,3,93,259,52,404
5123908,7,0,7,47,3,3,53,117,16,186
5123909,0,0,0,7,0,0,7,58,9,74
5123910,6,0,6,46,18,4,68,197,30,295
5123911,0,0,0,50,6,6,62,61,3,126
5123912,5,3,8,138,51,7,196,333,28,557
5123913,3,0,3,10,13,0,23,93,15,131
5123914,0,0,0,49,8,0,57,102,21,180
5123915,3,4,7,43,19,0,62,203,138,403
5123916,4,0,4,63,16,0,79,183,12,274
5123917,3,0,3,58,35,3,96,253,39,388
5123918,3,0,3,65,26,4,95,227,8,330
5123919,10,0,10,66,41,8,115,360,58,533
5123920,0,0,0,79,43,3,125,352,32,509
5123921,0,0,0,50,15,3,68,152,13,233
5123922,3,0,3,44,16,0,60,136,21,217
5124001,15,13,31,62,24,5,91,242,35,368
5124002,15,9,24,71,39,7,117,265,45,427
5124003,8,0,8,57,33,6,96,253,22,371
5124004,6,3,9,33,19,0,52,157,15,224
5124005,4,0,4,112,14,9,135,301,43,479
5124006,6,0,6,111,21,6,138,400,48,586
5124007,13,3,16,75,28,3,106,231,38,375
5124008,0,0,0,53,9,0,62,110,6,178
5124009,3,0,3,25,6,0,31,93,0,124
5124010,3,0,3,64,8,0,72,157,12,241
5124011,0,0,0,56,10,6,72,106,3,181
5124012,0,0,0,42,10,6,58,75,0,133
5124013,0,0,0,25,12,0,37,101,9,147
5124014,0,0,0,34,13,0,47,95,6,148
5124101,0,6,6,62,15,6,83,152,25,260
5124102,0,3,3,40,17,6,63,95,8,166
5124103,3,0,3,53,6,0,59,112,7,178
5124104,6,0,6,87,33,0,120,248,19,387
5124105,22,10,32,63,39,6,108,306,64,478
5124106,0,0,0,37,3,0,40,93,0,133
5124107,0,0,0,58,4,0,62,107,4,173
5124108,4,0,4,94,33,6,133,265,21,419
5124109,0,0,0,48,15,3,66,64,7,137
5124110,3,0,3,60,17,0,77,171,9,257
5124111,0,0,0,49,20,0,69,115,0,184
5124112,6,0,6,61,35,7,103,168,15,286
5124113,6,3,9,20,8,0,28,140,6,174
5124114,0,3,3,46,12,0,58,134,18,210
5124115,0,0,0,37,9,0,46,127,15,188
5124201,0,0,0,3,4,0,7,35,3,45
5124202,0,0,0,47,15,0,62,219,86,367
5124203,3,0,3,24,4,0,28,96,4,128
5124204,0,0,0,50,9,0,59,150,18,227
5124205,3,0,3,29,15,0,44,132,19,195
5124206,0,0,0,39,20,6,65,134,6,205
5124207,3,0,3,54,5,4,63,160,4,227
5124208,3,0,3,27,10,4,41,124,12,177
5124209,6,0,6,57,6,6,69,187,22,278
5124210,0,0,0,69,10,7,86,198,26,310
5124211,4,0,4,66,10,0,76,143,31,250
5124212,0,0,0,34,3,7,44,95,3,142
5124213,0,0,0,49,12,0,61,102,7,170
5124214,3,0,3,16,3,0,19,41,3,63
5124301,4,0,4,49,24,0,73,148,26,247
5124302,8,3,11,50,5,0,55,184,61,300
5124303,4,0,4,54,18,9,81,153,15,249
5124304,5,0,5,38,18,6,62,129,17,208
5124305,25,4,29,35,12,3,50,189,43,282
5124306,0,3,3,51,13,3,67,122,18,207
5124307,11,0,11,39,14,0,53,162,92,307
5124308,11,0,11,49,23,3,75,206,38,319
5124309,0,0,0,40,21,0,61,157,19,237
5124310,3,3,6,40,9,3,52,118,24,194
5124311,3,0,3,55,15,6,76,128,15,219
5124312,3,0,3,36,17,10,63,102,17,182
5124313,10,0,10,50,31,9,90,187,43,320
5124314,5,0,5,25,13,3,41,149,21,211
5124315,19,3,22,52,24,4,80,181,31,292
5124316,0,0,3,48,25,0,73,131,36,240
5124317,7,3,10,24,13,0,37,132,34,203
5124318,0,0,0,45,13,0,58,154,24,236
5124319,4,0,4,36,10,3,49,153,46,248
5124320,0,0,3,72,17,4,93,196,37,326
5124321,3,0,3,69,26,3,98,197,42,337
5124322,4,0,4,64,14,3,81,142,35,258
5124323,0,0,0,42,16,3,61,145,11,217
5124324,0,3,3,28,19,0,47,150,9,206
5124325,0,0,0,42,17,3,62,164,13,239
5124326,0,0,0,34,15,0,49,100,3,152
5124327,3,0,3,43,3,0,46,107,0,153
5124328,6,0,6,28,20,0,48,123,9,180
5124329,0,0,0,46,18,0,64,157,12,233
5124330,0,0,0,37,15,6,58,141,18,217
5124331,3,0,3,42,15,0,57,160,48,265
5124332,0,0,0,36,17,3,56,128,3,187
5124333,0,0,0,61,21,3,85,133,18,236
5124334,0,0,0,12,3,3,18,51,18,87
5124335,3,0,3,45,20,10,75,187,18,280
5124401,6,0,6,55,23,0,78,197,24,299
5124402,9,4,13,36,20,3,59,219,43,321
5124403,3,3,6,34,4,0,38,120,16,174
5124404,0,0,0,56,21,0,77,207,13,297
5124405,3,0,3,63,28,0,91,197,10,298
5124406,0,0,0,52,27,0,79,187,21,287
5124407,0,0,0,37,19,9,65,248,29,342
5124408,0,0,0,23,7,0,30,97,25,152
5124409,0,4,4,57,19,4,80,197,26,303
5124410,4,0,4,45,19,0,64,155,27,246
5124411,3,0,3,45,21,0,66,219,60,345
5124412,0,0,0,32,10,0,42,129,21,192
5124413,0,0,0,56,36,5,97,227,30,354
5124501,7,3,10,26,15,0,41,175,14,230
5124502,19,0,19,26,16,6,48,203,18,269
5124503,0,0,0,26,9,0,35,153,31,219
5124504,0,0,0,75,33,8,116,273,48,437
5124505,5,0,5,29,18,6,53,123,27,203
5124506,3,4,7,47,41,0,88,206,33,327
5124507,9,3,12,60,27,4,91,158,18,267
5124508,9,7,16,35,12,9,56,193,25,274
5124509,4,0,4,45,21,0,66,175,15,256
5124510,3,0,3,64,32,0,96,240,29,365
5124511,0,0,0,39,9,0,48,160,6,214
5124512,0,0,0,40,8,0,48,175,14,237
5124513,0,0,0,29,10,3,42,82,4,128
5124514,3,0,3,39,4,0,43,147,19,209
5124515,3,0,3,54,14,3,71,136,24,231
5124516,3,0,3,38,21,0,59,136,10,205
5124601,3,0,3,72,15,4,91,193,25,309
5124602,13,3,16,49,29,3,81,221,31,333
5124603,12,0,12,23,22,6,51,158,13,222
5124604,6,0,6,32,13,3,48,75,12,135
5124605,0,0,0,47,6,3,56,122,9,187
5124606,3,0,3,91,23,3,117,203,27,347
5124607,3,0,3,70,32,11,113,122,9,244
5124608,19,4,23,42,25,0,67,243,22,332
5124609,3,3,6,59,26,0,85,219,31,335
5124610,26,6,32,73,31,0,104,288,44,436
5124701,0,0,0,22,9,0,31,79,13,123
5124702,4,0,4,20,15,6,41,89,6,136
5124703,0,3,3,78,20,0,98,148,9,255
5124704,0,0,0,34,0,0,34,73,4,111
5124705,3,0,3,62,9,3,74,124,6,204
5124706,7,0,7,29,9,3,41,137,11,189
5124707,3,0,3,46,7,9,62,107,3,172
5124708,7,0,7,53,19,4,76,156,10,242
5124709,6,0,6,61,27,3,91,121,6,218
5124710,6,3,9,40,8,0,48,143,19,210
5124711,0,0,0,59,21,3,83,130,12,225
5124712,4,0,4,44,9,4,57,81,9,147
5124713,0,0,0,58,8,0,66,88,7,161
5124714,0,0,0,75,23,6,104,142,58,304
5124715,7,0,7,21,11,3,35,123,15,173
5124716,0,0,0,86,28,9,123,180,6,309
5124717,6,0,6,49,21,0,70,128,14,212
5124718,3,3,6,38,20,0,58,124,18,200
5124801,0,0,0,72,17,5,94,172,23,289
5124802,0,0,0,102,20,9,131,217,25,373
5124803,9,0,9,79,18,3,100,187,26,313
5124804,0,0,0,21,12,3,36,94,19,149
5124805,0,0,0,154,39,8,201,399,305,905
5124806,6,0,6,27,9,0,36,65,6,107
5124807,0,0,0,42,35,3,80,173,14,267
5124901,6,0,6,48,22,3,73,112,10,195
5124902,5,0,5,57,28,4,89,199,20,308
5124903,0,0,0,38,6,3,47,167,3,217
5124904,0,0,0,57,15,0,72,107,15,194
5124905,6,0,6,72,37,16,125,297,54,476
5124906,3,0,3,26,12,3,41,79,6,126
5124907,0,3,3,34,12,3,49,95,6,150
5124908,3,0,3,88,24,7,119,187,14,320
5124909,0,0,0,24,21,3,48,107,7,162
5124910,4,0,4,47,23,0,70,166,23,259
5124911,46,5,51,70,26,10,106,339,29,474
5124912,0,0,0,66,24,10,100,204,49,353
5124913,25,6,31,75,42,7,124,264,22,410
5125001,3,0,3,54,19,3,76,211,11,298
5125002,6,0,6,63,23,6,92,185,18,295
5125003,4,0,4,24,16,3,43,171,20,234
5125004,3,0,3,36,10,0,46,135,11,192
5125005,24,9,33,67,31,3,101,278,30,409
5125006,3,0,3,52,20,3,75,161,25,261
5125007,0,0,0,44,14,0,58,115,6,179
5125008,3,0,3,68,10,3,81,100,4,185
5125009,3,0,3,59,11,6,76,90,7,173
5125010,3,0,3,55,6,0,61,144,12,217
5125011,0,0,0,67,29,3,99,185,12,296
5125012,0,0,0,94,42,7,143,272,18,433
5125013,5,0,5,29,16,0,45,112,17,174
5125014,3,0,3,66,11,6,83,114,12,209
5125015,4,0,4,75,21,0,96,190,14,300
5949999,9,8,17,561,249,30,840,4551,1299,6690
5979991,0,0,0,0,0,0,0,0,0,0
5979992,0,0,0,30,4,0,34,193,43,270
5979993,0,0,0,0,3,0,3,119,20,142
6100101,0,0,0,39,10,0,49,95,18,162
6100102,4,0,4,67,18,0,85,156,31,272
6100103,0,0,0,66,12,9,87,101,25,213
6100104,0,0,0,28,9,3,40,88,29,157
6100105,3,0,3,42,9,0,51,132,40,223
6100106,0,0,0,57,13,0,70,138,6,214
6100107,4,0,4,41,10,0,51,127,9,187
6100108,6,3,9,55,13,5,73,157,26,256
6100109,0,0,0,52,14,3,69,128,32,229
6100110,0,3,3,51,13,0,64,99,19,182
6100111,0,0,0,63,12,3,78,115,40,233
6100112,3,0,3,69,9,0,78,123,47,248
6100113,0,0,0,56,23,0,79,164,47,290
6100114,6,0,6,55,30,0,85,147,64,296
6100115,3,0,3,57,20,3,80,148,34,262
6100116,0,0,0,26,7,3,36,90,42,168
6100117,0,0,0,51,6,3,60,72,31,163
6100118,0,0,0,59,22,12,93,172,69,334
6100119,0,0,0,30,31,3,64,163,19,246
6100120,3,0,3,89,29,0,118,246,33,397
6100121,0,0,0,36,12,3,51,94,24,169
6100122,0,0,0,72,22,3,97,173,21,291
6100123,0,0,0,34,3,0,37,80,3,120
6100201,12,0,12,78,28,4,110,228,23,361
6100202,6,0,6,85,10,3,98,162,18,278
6100203,6,0,6,59,25,0,84,168,8,260
6100204,0,0,0,101,21,6,128,177,16,321
6100205,0,0,0,68,36,7,111,136,0,247
6100206,0,4,4,94,29,3,126,261,19,406
6100207,6,3,9,199,48,11,258,394,31,683
6100208,3,0,3,115,34,6,155,211,24,390
6100209,3,0,3,97,21,6,124,249,32,405
6100210,0,0,0,80,22,6,108,184,10,302
6100301,0,0,0,0,0,0,0,0,0,0
6100302,3,0,3,135,36,7,178,350,18,546
6100303,0,0,0,101,35,6,142,226,5,373
6100304,0,0,0,37,18,0,55,108,3,166
6100305,0,3,3,66,28,0,94,127,6,227
6100306,49,0,49,33,10,0,43,170,0,213
6100307,6,0,6,84,43,0,127,314,14,455
6100308,0,0,0,95,25,6,126,268,27,421
6100309,0,6,6,154,47,11,212,338,26,576
6100401,0,0,0,0,0,0,0,0,0,0
6100402,7,4,11,27,13,6,46,143,14,203
6100403,0,0,0,0,4,0,4,12,0,16
6100404,9,3,12,77,52,0,129,222,24,375
6100405,10,3,13,43,32,0,75,214,15,304
6100406,10,0,10,50,16,3,69,244,23,336
6100407,6,0,6,56,24,0,80,208,15,303
6100408,6,3,9,42,21,6,69,169,15,253
6100409,15,3,18,47,28,0,75,162,15,252
6100410,10,5,15,28,47,3,78,271,23,372
6100411,9,5,14,24,19,0,43,146,17,206
6100412,16,5,21,79,36,0,115,335,66,516
6100413,17,0,17,53,33,0,86,181,18,285
6100414,12,0,12,31,28,3,62,154,16,232
6100415,8,4,12,42,23,0,65,135,16,216
6100416,0,0,0,40,23,0,63,174,15,252
6100417,11,4,15,77,22,6,105,269,37,411
6100418,6,0,6,34,24,0,58,165,12,235
6100419,8,0,8,35,26,0,61,157,4,222
6100501,0,0,0,69,44,0,113,208,7,328
6100502,0,0,0,140,23,0,163,233,13,409
6100503,0,0,0,85,17,3,105,193,15,313
6100504,3,0,3,46,14,0,60,108,9,177
6100505,6,3,9,62,36,3,101,264,12,377
6100506,6,0,6,38,27,5,70,161,8,239
6100507,0,0,0,3,3,0,6,13,0,19
6100508,0,0,0,51,24,0,75,189,10,274
6100509,0,0,0,0,0,0,0,0,0,0
6100510,3,0,3,77,34,12,123,173,13,309
6100511,17,4,21,80,41,0,121,290,30,441
6100512,0,0,0,61,24,9,94,139,15,248
6100513,8,0,8,59,24,7,90,219,9,318
6100514,0,0,0,54,18,6,78,141,8,227
6100515,0,0,0,31,17,9,57,117,4,178
6100516,0,3,3,82,18,7,107,170,3,280
6100517,3,0,3,81,22,5,108,247,12,367
6100518,6,0,6,46,19,8,73,213,26,312
6100519,0,0,0,50,14,0,64,142,9,215
6100520,0,0,0,95,21,3,119,188,8,315
6100521,0,0,0,39,13,0,52,112,12,176
6100522,0,0,0,0,0,0,0,3,0,3
6100523,0,0,0,10,0,0,10,6,0,16
6100524,3,0,3,48,9,3,60,117,15,192
6100601,3,0,3,57,22,6,85,250,16,351
6100602,12,0,12,50,35,0,85,240,14,339
6100603,6,0,6,46,30,0,76,183,28,287
6100604,9,3,12,78,28,7,113,222,22,357
6100605,3,0,3,118,41,6,165,262,12,439
6100606,0,0,0,60,26,0,86,204,22,312
6100607,3,4,7,81,44,9,134,203,18,355
6100608,0,0,0,34,17,6,57,140,9,206
6100701,4,3,7,33,18,6,57,124,9,190
6100702,24,0,24,82,39,0,121,254,29,404
6100703,11,0,11,42,33,9,84,204,16,304
6100704,9,3,12,60,31,4,95,219,21,335
6100705,8,3,11,59,41,0,100,244,30,374
6100706,9,3,12,111,75,9,195,373,16,584
6100707,3,3,6,56,33,6,95,228,21,344
6100708,7,0,7,50,44,3,97,232,13,342
6100709,7,0,7,142,47,5,194,340,31,565
6100710,28,4,32,58,45,6,109,309,31,449
6100711,7,0,7,43,35,3,81,196,17,294
6100712,12,3,15,169,73,14,256,477,38,771
6100713,8,0,8,69,48,3,120,239,30,389
6100714,10,0,10,55,34,0,89,231,12,332
6100715,6,3,9,61,26,3,90,161,16,267
6100716,4,0,4,107,38,6,151,288,12,451
6100717,6,0,6,93,27,3,123,238,9,370
6100718,4,0,4,48,15,0,63,148,9,220
6100719,14,7,21,47,28,3,78,211,23,312
6100720,6,0,6,59,39,3,101,195,5,301
6100721,8,0,8,82,26,9,117,193,9,319
6100801,18,0,18,67,53,0,120,288,24,432
6100802,8,0,8,118,46,4,168,293,23,484
6100803,9,0,9,28,16,0,44,140,0,184
6100804,16,0,16,63,34,3,100,259,22,381
6100805,13,6,22,92,64,8,164,349,27,540
6100806,4,0,4,64,47,3,114,292,18,424
6100807,9,0,9,78,48,3,129,243,11,383
6100808,8,3,11,79,30,10,119,245,6,370
6100809,108,9,117,42,36,0,78,354,22,454
6100810,11,0,11,73,46,6,125,287,14,426
6100811,161,11,175,23,29,3,55,325,23,403
6100812,8,0,8,55,32,3,90,195,11,296
6100813,0,3,3,59,13,3,75,167,6,248
6100814,0,0,0,6,0,0,6,12,0,18
6100815,8,3,11,26,26,3,55,173,18,246
6100816,10,0,10,38,26,0,64,142,13,219
6100817,13,6,19,27,24,6,57,139,13,209
6100901,3,0,3,42,16,0,58,119,26,203
6100902,7,0,7,52,18,0,70,164,20,254
6100903,3,0,3,76,38,6,120,318,53,491
6100904,0,3,3,68,30,0,98,189,21,308
6100905,0,0,0,50,13,0,63,116,14,193
6100906,52,6,58,59,36,4,99,356,33,488
6100907,0,0,0,0,0,0,0,3,0,3
6100908,0,0,0,81,30,7,118,175,22,315
6100909,28,0,28,45,12,0,57,244,25,326
6100910,0,0,0,0,0,0,0,0,0,0
6100911,6,0,6,78,22,3,103,229,38,370
6100912,3,3,6,42,19,0,61,137,18,216
6100913,6,0,6,66,14,0,80,224,48,352
6100914,3,3,6,40,11,0,51,128,15,194
6101001,0,0,0,58,18,0,76,161,27,264
6101002,0,0,0,42,7,0,49,95,6,150
6101003,0,0,0,70,36,9,115,221,30,366
6101004,0,0,0,0,0,0,0,7,0,7
6101005,4,0,7,50,10,0,60,125,10,195
6101006,4,6,10,53,18,0,71,161,30,262
6101007,0,0,0,51,24,3,78,159,21,258
6101008,0,0,0,29,11,3,43,113,24,180
6101009,0,3,3,0,0,0,0,0,404,404
6101010,0,0,0,55,10,9,74,149,20,243
6101101,0,0,0,43,12,0,55,100,27,182
6101102,3,0,3,52,23,0,75,148,8,231
6101103,0,0,0,66,9,4,79,131,27,237
6101104,6,0,6,198,61,9,268,430,58,756
6101105,3,0,3,75,27,6,108,128,12,248
6101106,0,0,0,50,19,3,72,129,12,213
6101107,0,0,3,21,12,0,33,50,9,92
6101108,0,0,0,87,23,6,116,184,43,343
6101109,4,0,4,50,20,5,75,153,18,246
6101110,0,0,0,43,15,5,63,145,13,221
6101111,0,0,0,4,0,0,4,12,0,16
6101112,0,5,5,45,22,4,71,146,24,241
6101113,0,0,0,65,22,0,87,126,22,235
6101114,0,0,0,67,27,3,97,130,32,259
6101115,0,0,0,79,22,0,101,139,33,273
6101116,0,0,0,41,34,0,75,171,20,266
6101201,0,0,0,40,25,3,68,104,8,180
6101202,3,0,3,54,17,0,71,128,9,208
6101203,3,0,3,78,9,3,90,157,15,262
6101204,0,0,0,58,29,0,87,233,26,346
6101205,3,0,3,89,47,5,141,206,19,366
6101206,0,3,3,52,18,0,70,144,9,223
6101207,0,0,0,42,18,7,67,116,4,187
6101208,0,0,0,82,15,6,103,199,15,317
6101209,0,0,0,13,16,0,29,72,6,107
6101210,3,0,3,122,21,0,143,235,19,397
6101211,0,0,0,22,5,0,27,45,6,78
6101212,6,0,6,49,30,0,79,179,21,279
6101213,0,0,0,48,21,0,69,198,6,273
6101301,3,0,3,40,12,0,52,212,21,285
6101302,0,0,0,89,16,0,105,133,9,247
6101303,6,3,9,92,38,9,139,325,23,487
6101304,0,0,0,67,22,7,96,181,9,286
6101305,0,0,0,0,0,0,0,0,0,0
6101306,0,0,0,30,12,0,42,124,18,184
6101307,0,0,0,0,0,0,0,0,0,0
6101308,0,0,0,0,0,0,0,0,0,0
6101309,0,0,0,47,17,0,64,128,3,195
6101310,0,0,0,93,21,0,114,145,12,271
6101311,0,3,3,116,48,9,173,264,30,467
6101312,7,0,7,75,59,6,140,230,25,395
6101313,0,3,3,24,9,0,33,113,15,161
6101401,0,0,0,45,20,4,69,124,6,199
6101402,6,0,6,51,29,3,83,230,10,323
6101403,3,0,3,42,21,0,63,169,27,259
6101404,3,0,3,46,27,3,76,168,23,267
6101405,0,0,0,50,26,3,79,181,19,279
6101406,0,0,0,63,27,4,94,195,24,313
6101407,7,0,7,57,22,4,83,170,36,289
6101408,5,0,5,52,13,3,68,160,9,237
6101409,5,3,8,94,32,7,133,229,33,395
6101410,6,0,6,68,24,3,95,236,21,352
6101411,0,0,0,50,35,0,85,159,13,257
6101412,3,0,3,39,7,0,46,123,6,175
6101413,0,0,0,53,13,0,66,102,9,177
6101414,3,0,3,71,25,0,96,176,7,279
6101415,9,0,9,34,12,10,56,183,19,258
6101416,0,0,0,0,0,0,0,12,0,12
6101417,19,3,22,24,19,0,43,154,13,210
6101501,3,0,3,55,23,3,81,174,16,271
6101502,3,0,3,91,49,10,150,303,24,477
6101503,0,0,0,0,0,0,0,0,0,0
6101504,5,0,5,34,28,6,68,109,0,177
6101505,56,26,82,14,12,3,29,240,75,344
6101506,0,0,0,41,6,0,47,110,24,181
6101507,17,9,26,38,16,0,54,219,33,306
6101508,21,3,27,15,23,3,41,214,42,297
6101509,22,3,25,26,22,0,48,199,22,269
6101510,7,0,7,87,39,3,129,305,24,458
6101511,0,0,0,54,36,10,100,187,21,308
6101512,11,0,11,98,35,10,143,317,20,480
6101513,0,0,0,79,17,0,96,167,13,276
6101514,0,0,0,42,12,3,57,112,12,181
6101515,3,0,3,71,20,0,91,179,21,291
6101516,6,0,6,61,21,9,91,171,22,284
6101517,3,0,6,105,43,9,157,244,21,422
6101518,0,0,0,75,39,6,120,221,26,367
6101519,0,0,0,97,27,4,128,266,16,410
6101520,3,0,3,66,24,3,93,271,22,386
6101601,6,3,9,39,33,3,75,194,20,289
6101602,0,0,0,3,0,0,3,0,0,3
6101603,3,0,3,48,18,6,72,150,6,228
6101604,3,0,3,54,39,4,97,222,28,347
6101605,0,3,3,60,41,3,104,232,24,360
6101606,3,0,3,66,32,6,104,250,23,377
6101607,6,3,9,53,25,3,81,230,23,334
6101608,4,0,4,38,12,3,53,99,20,172
6101609,7,3,10,66,31,0,97,193,20,310
6101610,0,0,0,3,0,0,3,0,0,3
6101611,5,0,5,70,39,14,123,286,33,442
6101612,16,6,22,104,26,3,133,275,42,450
6101701,8,0,8,56,26,3,85,235,6,326
6101702,13,0,13,87,29,9,125,238,24,387
6101703,7,5,12,60,18,3,81,207,29,317
6101704,4,0,4,60,24,3,87,178,30,295
6101705,3,0,3,57,18,4,79,166,21,266
6101706,6,0,6,54,18,3,75,184,30,289
6101707,7,0,7,40,7,0,47,132,27,206
6101708,5,3,8,30,9,0,39,140,37,216
6101709,71,6,77,49,9,0,58,279,41,378
6101710,0,0,0,36,21,3,60,171,33,264
6101711,21,4,25,21,16,0,37,134,23,194
6101712,14,3,17,40,25,0,65,258,33,356
6101713,6,4,10,44,36,9,89,232,22,343
6101714,0,0,0,0,0,0,0,0,0,0
6101715,0,0,0,48,33,10,91,241,29,361
6101716,15,3,18,100,45,0,145,315,51,511
6101717,6,3,9,23,4,0,27,73,15,115
6101718,0,0,0,68,19,0,87,133,17,237
6101719,5,0,5,65,14,4,83,165,12,260
6101720,0,6,6,103,43,9,155,304,30,489
6101721,5,3,8,45,27,0,72,200,30,302
6101722,6,0,6,55,24,3,82,228,34,344
6101723,0,0,0,27,12,0,39,109,9,157
6101724,4,0,4,59,27,0,86,182,12,280
6101725,3,0,3,66,16,3,85,221,23,329
6101726,0,0,0,0,0,0,0,0,0,0
6101727,3,0,3,0,0,0,0,6,4,10
6101728,7,0,10,51,31,4,86,219,32,337
6101729,6,3,9,57,27,0,84,246,37,367
6101730,10,8,18,43,21,0,64,127,30,221
6101731,10,0,10,36,20,0,56,149,7,212
6101732,12,0,12,33,18,0,51,137,12,200
6101801,37,0,37,15,18,0,33,168,6,207
6101802,18,6,24,42,29,4,75,224,30,329
6101803,3,4,7,79,41,9,129,250,18,397
6101804,0,0,0,0,0,0,0,0,0,0
6101805,10,0,10,24,27,3,54,153,23,230
6101806,7,3,10,50,26,3,79,237,15,331
6101807,0,0,0,71,19,6,96,249,6,351
6101808,3,7,10,56,29,0,85,231,10,326
6101809,12,0,12,30,34,0,64,210,20,294
6101810,10,8,18,46,38,0,84,267,14,365
6101811,4,3,7,73,27,0,100,189,27,316
6101812,3,0,6,44,21,0,65,190,10,265
6101813,3,0,3,27,23,0,50,142,13,205
6101814,6,3,9,39,28,0,67,166,18,251
6101901,18,7,25,76,26,3,105,258,28,391
6101902,9,0,9,55,36,5,96,245,17,358
6101903,13,0,13,63,21,6,90,254,31,375
6101904,5,0,5,72,26,12,110,194,21,325
6101905,5,4,9,77,13,6,96,260,39,395
6101906,3,6,9,70,18,3,91,238,30,359
6101907,9,0,9,91,25,12,128,282,27,437
6101908,18,0,18,90,48,6,144,351,12,507
6101909,5,0,5,36,10,6,52,165,12,229
6101910,23,4,27,97,44,0,141,336,43,520
6101911,6,0,6,65,27,0,92,141,13,246
6102001,38,3,41,18,6,6,30,124,12,166
6102002,0,0,0,44,5,0,49,111,6,166
6102003,0,0,0,48,19,0,67,122,3,192
6102004,3,0,3,59,27,3,89,234,12,335
6102005,4,3,7,70,35,6,111,274,37,422
6102006,3,0,3,54,16,0,70,197,29,296
6102007,3,0,3,65,25,3,93,130,19,242
6102008,17,6,23,54,25,3,82,250,50,382
6102009,4,0,4,45,15,3,63,164,19,246
6102010,4,0,4,31,21,3,55,194,15,264
6102011,0,0,0,79,20,5,104,201,36,341
6102012,0,0,0,55,37,3,95,184,9,288
6102013,0,0,0,18,12,0,30,92,0,122
6102014,0,5,5,48,16,0,64,176,11,251
6102015,0,0,0,85,20,0,105,205,27,337
6102016,6,0,6,66,32,3,101,276,31,408
6102017,4,0,4,57,18,0,75,167,8,250
6102018,3,3,6,41,12,0,53,105,24,182
6102019,6,0,6,48,10,0,58,111,7,176
6102101,0,0,0,51,20,9,80,228,30,338
6102102,3,3,6,43,43,4,90,206,18,314
6102103,3,0,3,86,33,5,124,282,11,417
6102104,3,3,6,103,41,6,150,305,17,472
6102105,6,3,9,76,35,4,115,246,34,395
6102106,10,3,13,66,20,0,86,220,31,337
6102107,9,0,9,63,32,6,101,203,23,327
6102108,8,0,8,26,13,0,39,124,18,181
6102109,8,6,14,45,18,0,63,227,30,320
6102201,8,3,11,49,17,3,69,173,15,257
6102202,0,0,0,0,0,0,0,0,0,0
6102203,3,0,3,69,32,4,105,172,25,302
6102204,0,0,0,17,3,3,23,39,9,71
6102205,9,0,9,90,43,3,136,242,25,403
6102206,3,0,3,90,51,3,144,337,14,495
6102207,6,0,6,62,22,4,88,152,11,251
6102208,0,0,0,178,37,7,222,363,12,597
6102209,0,0,0,50,9,3,62,102,15,179
6102210,0,0,0,120,49,3,172,298,27,497
6102211,4,0,4,72,39,0,111,195,12,318
6102212,0,0,0,68,32,8,108,253,24,385
6102213,0,0,0,39,19,0,58,81,17,156
6102214,3,0,3,39,24,0,63,137,10,210
6102215,4,0,4,27,13,0,40,129,6,175
6102216,0,0,0,68,31,7,106,126,13,245
6102217,6,0,6,209,62,9,280,402,28,710
6102218,0,0,0,97,42,6,145,152,8,305
6102219,0,0,0,0,0,0,0,3,0,3
6102220,0,0,0,40,24,3,67,129,6,202
6102221,5,0,5,29,16,0,45,146,7,198
6102222,4,0,4,35,18,3,56,107,15,178
6102223,0,0,0,61,25,7,93,181,9,283
6102224,7,3,10,100,45,12,157,280,27,464
6102225,0,3,3,75,24,3,102,190,15,307
6102226,5,0,5,41,28,0,69,163,20,252
6102227,96,8,107,30,41,3,74,436,28,538
6102228,3,0,6,85,23,0,108,174,9,291
6102229,0,0,0,44,12,0,56,127,6,189
6102301,3,0,3,85,27,6,118,159,6,283
6102302,3,6,9,67,20,0,87,129,9,225
6102303,0,0,0,32,26,3,61,86,9,156
6102304,11,3,17,37,23,4,64,198,31,293
6102305,9,0,9,45,32,4,81,146,8,235
6102306,10,6,19,35,38,0,73,145,9,227
6102307,7,0,7,58,28,6,92,173,7,272
6102308,6,0,6,76,36,10,122,276,18,416
6102309,6,0,6,49,49,9,107,190,6,303
6102310,4,0,4,59,36,0,95,189,9,293
6102311,6,0,6,55,9,0,64,164,18,246
6102312,3,0,3,42,8,0,50,145,9,204
6102313,4,0,4,57,19,6,82,156,6,244
6102314,8,0,8,69,51,3,123,322,19,464
6102315,36,3,39,97,27,7,131,275,12,418
6102316,10,3,13,96,52,8,156,308,26,490
6102317,0,0,0,65,33,5,103,210,8,321
6102318,0,0,0,65,37,8,110,202,9,321
6102319,10,0,10,82,58,3,143,229,11,383
6102320,0,0,0,27,32,3,62,124,16,202
6102321,0,0,0,67,28,0,95,167,7,269
6102322,3,3,6,62,47,6,115,202,19,336
6102323,0,3,3,55,44,3,102,201,6,309
6102324,3,0,3,87,29,6,122,264,12,398
6102325,3,0,3,42,25,0,67,133,9,209
6102326,7,0,7,83,37,6,126,260,9,395
6102401,0,0,0,115,32,9,156,221,18,395
6102402,0,0,0,80,30,12,122,250,19,391
6102403,3,0,3,14,13,3,30,77,6,113
6102404,3,0,3,66,15,4,85,184,12,281
6102405,3,0,3,60,32,12,104,159,17,280
6102406,0,0,0,33,10,0,43,100,6,149
6102407,0,0,0,104,34,3,141,211,11,363
6102408,0,0,0,55,20,0,75,145,9,229
6102409,3,0,3,33,6,4,43,59,0,102
6102410,6,0,6,35,6,6,47,63,12,122
6102411,4,0,4,174,55,20,249,296,27,572
6102412,5,0,5,103,46,7,156,217,33,406
6102413,0,0,0,42,6,3,51,125,15,191
6102414,0,0,0,123,28,12,163,153,3,319
6102415,0,0,0,98,23,8,129,209,10,348
6102416,3,0,3,56,28,7,91,145,11,247
6102417,3,0,3,51,20,9,80,102,3,185
6102418,3,0,3,24,3,0,27,44,0,71
6102419,33,5,38,132,41,16,189,370,30,589
6102501,0,0,0,0,0,0,0,0,0,0
6102601,6,0,6,102,31,11,144,229,7,380
6102602,0,0,0,0,0,0,0,13,0,13
6102603,6,0,6,46,11,9,66,142,15,223
6102604,5,0,5,93,34,3,130,214,6,350
6102605,6,0,6,67,19,9,95,240,11,346
6102606,3,7,10,85,35,0,120,142,13,275
6102607,11,48,59,29,27,0,56,163,99,318
6102608,6,0,6,23,14,0,37,102,5,144
6102609,4,0,4,54,27,0,81,155,16,252
6102610,4,3,7,46,18,3,67,120,3,190
6102611,8,3,11,77,29,3,109,207,14,330
6102701,0,0,0,35,18,0,53,180,22,255
6102702,9,3,12,39,18,3,60,196,33,289
6102703,3,3,6,36,17,0,53,208,12,273
6102704,3,0,3,33,22,0,55,186,9,250
6102705,3,0,3,37,12,9,58,184,21,263
6102706,3,0,3,35,20,6,61,173,31,265
6102707,0,3,3,39,29,4,72,262,31,365
6102708,3,0,3,70,29,0,99,263,33,395
6102709,0,0,0,52,11,6,69,231,15,315
6102710,0,0,0,33,14,0,47,142,24,213
6102711,3,0,3,31,15,0,46,173,15,234
6102712,8,0,8,50,34,4,88,318,21,427
6102713,5,3,8,14,25,3,42,254,31,327
6102714,6,6,12,42,28,13,83,352,39,474
6102715,13,4,17,31,33,4,68,262,42,372
6102716,69,4,73,16,8,0,24,259,11,294
6102717,6,0,6,28,32,0,60,297,48,405
6102718,0,0,0,18,23,0,41,178,39,258
6102719,5,0,5,29,32,0,61,286,120,467
6102720,0,0,0,47,21,0,68,406,69,543
6102721,0,0,0,3,6,0,9,18,3,30
6102801,13,6,19,84,42,3,129,269,30,428
6102802,7,0,7,77,36,7,120,275,30,425
6102803,10,0,10,102,49,6,157,346,24,527
6102804,0,0,0,76,20,5,101,235,15,351
6102805,0,0,0,9,6,0,15,37,3,55
6102806,0,3,6,41,22,3,66,132,6,204
6102807,4,0,4,60,21,0,81,176,15,272
6102808,12,0,12,51,28,3,82,290,18,390
6102809,3,6,9,78,31,8,117,188,12,317
6102810,3,6,9,110,32,3,145,283,15,443
6102811,7,4,11,71,17,0,88,180,8,276
6102812,21,0,21,74,29,6,109,312,17,438
6102813,3,0,3,54,21,0,75,259,23,357
6102814,3,3,6,100,25,12,137,259,24,420
6102815,6,0,6,87,44,12,143,251,9,403
6102816,3,0,3,49,16,3,68,110,10,188
6102817,6,0,6,60,17,5,82,180,11,273
6102818,6,0,6,65,32,6,103,298,12,413
6102819,9,0,9,79,42,3,124,333,24,481
6102901,0,6,6,59,32,3,94,254,21,369
6102902,0,3,6,46,31,6,83,328,25,436
6102903,6,7,13,98,36,7,141,305,30,476
6102904,3,3,6,72,26,12,110,262,15,387
6102905,6,0,6,75,35,7,117,371,32,520
6102906,10,3,13,31,27,3,61,201,9,271
6102907,0,0,0,118,20,3,141,209,15,365
6102908,0,0,0,9,9,0,18,303,12,333
6102909,5,0,5,107,33,12,152,359,36,547
6103001,4,0,4,73,22,5,100,219,9,328
6103002,7,3,10,68,26,6,100,192,17,309
6103003,16,0,16,88,40,3,131,368,31,530
6103004,12,6,18,85,25,3,113,312,33,458
6103005,9,3,12,56,18,0,74,219,30,323
6103006,6,0,6,35,3,9,47,231,44,322
6103007,65,7,72,57,3,4,64,244,24,332
6103008,5,0,5,23,15,0,38,155,21,214
6103009,37,0,37,59,38,3,100,262,11,373
6103010,10,0,10,96,39,4,139,301,14,454
6103011,4,4,8,52,17,0,69,223,28,320
6103012,55,6,61,90,27,8,125,377,15,517
6103013,8,4,12,98,47,0,145,357,30,532
6103014,0,0,0,0,0,0,0,0,0,0
6103101,10,0,10,71,34,6,111,299,13,423
6103102,7,3,13,58,54,0,112,295,30,437
6103103,10,0,10,79,57,0,136,413,20,569
6103104,11,0,14,36,28,3,67,180,9,256
6103105,23,51,74,88,43,0,131,376,90,597
6103106,6,3,9,43,18,3,64,168,12,244
6103107,15,6,21,49,41,0,90,230,27,347
6103108,28,36,64,74,44,3,121,390,80,591
6103109,3,3,6,44,10,3,57,186,9,252
6103110,12,0,12,54,21,3,78,260,25,363
6103111,0,0,0,0,0,0,0,0,0,0
6103112,4,0,4,42,13,0,55,226,11,292
6103113,12,0,12,59,12,6,77,221,12,310
6103114,3,0,3,65,25,0,90,233,15,338
6103115,4,0,4,27,20,0,47,257,31,335
6103116,4,3,7,52,23,3,78,317,25,420
6103117,0,0,0,0,0,0,0,36,0,36
6103118,11,0,11,52,25,0,77,330,18,425
6103119,7,0,7,35,35,4,74,304,22,400
6103120,0,0,0,32,15,3,50,268,21,339
6103121,3,0,3,34,26,0,60,186,34,280
6103122,12,0,15,28,24,3,55,274,54,383
6103123,0,0,0,22,12,0,34,201,12,247
6103124,6,3,9,30,15,0,45,146,18,209
6103125,6,0,6,81,35,3,119,393,47,559
6103126,8,0,8,43,15,4,62,213,19,294
6103127,57,12,69,55,35,4,94,417,45,556
6103128,14,0,14,56,17,0,73,210,11,294
6103201,10,0,10,75,28,12,115,318,35,468
6103202,6,0,6,43,17,0,60,196,12,268
6103203,7,0,7,45,18,0,63,158,9,230
6103204,8,0,8,57,32,12,101,302,25,428
6103205,11,0,11,64,23,4,91,321,14,426
6103206,3,0,3,39,22,6,67,126,12,205
6103207,3,0,3,47,28,6,81,148,6,235
6103208,3,0,3,71,24,3,98,185,6,289
6103209,0,0,0,0,0,0,0,4,0,4
6103210,0,0,0,69,20,3,92,144,9,245
6103211,5,0,5,100,14,6,120,164,12,296
6103212,4,0,4,49,17,3,69,154,6,229
6103213,3,0,3,33,9,3,45,115,3,163
6103214,0,0,0,39,7,0,46,76,9,131
6103215,3,0,3,67,16,0,83,159,11,253
6103216,0,0,0,61,23,9,93,184,10,287
6103217,0,0,0,20,23,0,43,367,37,447
6103218,98,26,124,27,7,0,34,256,44,334
6103301,0,0,0,31,18,3,52,166,26,244
6103302,3,0,3,67,19,0,86,137,6,229
6103303,7,0,7,44,25,0,69,183,12,264
6103304,3,0,3,98,26,3,127,253,36,416
6103305,15,9,27,69,24,6,99,240,48,387
6103306,7,0,7,75,30,8,113,261,21,395
6103307,0,0,0,47,18,4,69,128,14,211
6103308,6,0,6,44,13,6,63,153,15,231
6103309,6,0,6,58,21,16,95,224,6,325
6103310,0,0,0,36,7,3,46,189,23,258
6103311,6,0,6,50,15,7,72,164,9,245
6103312,0,0,0,84,27,12,123,246,17,386
6103313,3,0,3,40,9,0,49,124,4,177
6103314,0,0,0,49,9,6,64,145,4,213
6103315,0,0,0,40,14,3,57,134,21,212
6103316,0,0,0,6,0,0,6,0,0,6
6103317,10,0,10,82,28,4,114,218,18,350
6103318,0,0,0,40,16,3,59,179,11,249
6103401,3,3,6,98,39,3,140,216,24,380
6103402,6,0,6,79,26,12,117,195,29,341
6103403,3,0,3,72,15,3,90,177,19,286
6103404,0,5,5,69,41,0,110,196,25,331
6103405,0,0,0,49,23,6,78,163,0,241
6103406,0,0,0,78,21,7,106,218,13,337
6103407,4,0,4,61,28,3,92,201,17,310
6103408,3,0,3,38,19,3,60,211,16,287
6103409,0,0,0,85,22,3,110,139,9,258
6103410,0,0,0,52,12,7,71,139,10,220
6103411,3,0,3,75,22,17,114,199,18,331
6103412,6,0,6,26,12,0,38,98,23,159
6103413,0,6,6,59,10,0,69,233,48,350
6103414,0,0,0,12,12,0,24,118,15,157
6103415,5,0,5,68,15,3,86,123,18,227
6103416,3,0,3,34,12,3,49,111,10,170
6103417,3,0,3,32,18,0,50,169,9,228
6103418,0,0,0,61,20,3,84,148,3,235
6103419,0,0,0,71,19,7,97,170,7,274
6103420,0,3,3,57,24,3,84,144,27,255
6103421,0,0,0,65,16,0,81,159,23,263
6103501,12,0,12,28,12,0,40,151,15,206
6103502,8,0,8,57,29,7,93,223,17,333
6103503,6,0,6,60,26,0,86,249,39,374
6103504,3,0,3,55,23,6,84,204,33,321
6103505,3,6,9,124,25,6,155,220,25,400
6103506,6,0,6,37,17,0,54,108,21,183
6103507,0,0,0,75,19,6,100,164,12,276
6103508,3,0,3,59,24,7,90,180,13,283
6103509,0,0,0,50,22,6,78,215,17,310
6103510,3,0,3,81,27,11,119,198,18,335
6103511,3,3,6,59,20,0,79,201,19,299
6103512,4,0,4,50,28,3,81,139,16,236
6103513,0,0,0,38,24,0,62,179,10,251
6103514,3,4,7,36,20,5,61,115,7,183
6103515,4,0,4,47,28,6,81,152,27,260
6103516,0,0,0,72,32,0,104,202,11,317
6103517,47,6,53,25,6,0,31,153,9,193
6103518,8,0,8,60,22,7,89,187,15,291
6103519,6,0,6,56,36,0,92,130,13,235
6103520,5,0,5,74,19,12,105,199,20,324
6103521,12,0,12,90,45,3,138,247,22,407
6103522,13,8,21,22,13,3,38,199,37,274
6103601,0,3,3,49,24,4,77,337,31,445
6103602,0,0,0,4,0,0,4,0,0,4
6103603,5,0,5,85,23,6,114,306,61,481
6103604,4,0,4,60,16,6,82,265,43,390
6103605,4,0,4,30,18,3,51,142,12,205
6103606,0,0,0,51,16,8,75,183,27,285
6103607,0,0,0,0,0,0,0,0,0,0
6103608,0,0,0,7,0,0,7,29,0,36
6103609,0,0,0,45,16,3,64,151,23,238
6103610,8,0,8,60,18,6,84,196,23,303
6103611,0,0,0,0,0,0,0,0,0,0
6103612,6,3,9,32,9,0,41,151,21,213
6103701,5,3,8,93,35,4,132,306,18,456
6103702,113,11,124,51,19,0,70,387,32,489
6103703,8,0,8,73,32,4,109,196,13,318
6103704,0,0,0,0,0,0,0,0,0,0
6103705,5,0,5,34,15,0,49,142,13,204
6103706,4,6,10,85,26,3,114,265,31,410
6103707,0,0,0,0,0,0,0,0,0,0
6103708,14,0,14,60,15,6,81,234,27,342
6103709,15,4,19,65,21,8,94,272,20,386
6103710,0,0,0,40,18,0,58,131,8,197
6103711,4,3,7,64,26,6,96,223,30,349
6103801,4,0,4,42,11,4,57,106,7,170
6103802,9,0,9,110,51,6,167,275,20,462
6103803,6,0,6,55,19,4,78,179,12,269
6103804,10,0,10,34,18,0,52,173,18,243
6103805,3,7,10,41,15,3,59,195,28,282
6103806,7,0,7,62,30,0,92,325,5,422
6103807,12,0,12,46,26,0,72,295,27,394
6103808,0,0,0,33,29,0,62,232,9,303
6103809,0,0,0,26,5,0,31,155,9,195
6103810,3,0,3,34,25,0,59,120,6,185
6103811,0,0,0,22,26,0,48,178,62,288
6103812,0,0,0,26,9,4,39,155,4,198
6103813,0,0,0,0,0,0,0,9,0,9
6103814,4,0,4,113,27,4,144,206,21,371
6103815,6,3,9,34,19,3,56,203,32,291
6103816,3,0,3,47,22,0,69,181,16,266
6103901,3,0,3,44,9,4,57,105,6,168
6103902,0,0,0,72,24,0,96,224,0,320
6103903,8,0,8,93,23,0,116,258,13,387
6103904,0,0,0,94,35,0,129,186,13,328
6103905,5,54,59,121,24,3,148,222,115,485
6103906,3,0,3,49,18,0,67,91,3,161
6103907,0,0,0,25,13,0,38,92,9,139
6103908,3,0,3,20,10,0,30,96,6,132
6103909,3,3,6,96,21,4,121,258,15,394
6103910,20,0,20,96,25,3,124,203,8,335
6104001,9,0,9,60,39,9,108,280,17,405
6104002,10,0,10,29,12,6,47,150,15,212
6104003,5,0,5,97,18,9,124,222,31,377
6104004,0,0,0,30,6,3,39,57,9,105
6104005,9,7,16,85,37,0,122,269,18,409
6104006,3,3,6,58,20,4,82,190,33,305
6104007,0,0,0,0,0,0,0,0,0,0
6104008,0,0,0,0,0,0,0,0,0,0
6104009,22,0,22,79,32,6,117,309,34,460
6104010,3,0,3,38,15,6,59,288,28,375
6104011,5,0,5,51,30,0,81,286,20,387
6104101,10,0,10,76,33,0,109,283,44,436
6104102,40,4,44,57,28,0,85,316,50,451
6104103,7,0,7,31,26,0,57,175,24,256
6104104,6,0,6,66,14,0,80,183,19,282
6104105,4,4,8,84,39,7,130,311,26,467
6104106,9,6,15,47,37,0,84,296,23,403
6104107,0,0,0,53,12,4,69,157,16,242
6104108,0,4,4,37,6,3,46,162,25,233
6104109,4,0,4,86,30,6,122,282,58,462
6104110,6,0,6,80,15,6,101,188,21,310
6104111,3,3,6,44,23,3,70,220,12,302
6104112,11,0,11,85,49,4,138,388,50,576
6104113,0,0,0,30,12,0,42,121,15,178
6104114,0,0,0,6,11,0,17,297,29,343
6104115,8,0,8,158,32,0,190,407,41,638
6104116,0,0,0,33,4,6,43,113,6,162
6104117,0,0,0,57,22,3,82,120,24,226
6104118,6,0,6,62,30,8,100,159,29,288
6104119,3,0,3,53,7,4,64,148,27,239
6104120,0,0,0,0,0,0,0,7,0,7
6104121,0,0,0,62,35,9,106,231,24,361
6104122,0,0,0,3,0,0,3,6,3,12
6104123,0,0,0,0,0,0,0,0,0,0
6104201,29,11,43,81,46,3,130,467,34,631
6104202,0,0,0,0,0,0,0,0,0,0
6104203,0,0,0,0,0,0,0,0,0,0
6104204,84,5,89,46,29,3,78,311,25,414
6104205,0,0,0,80,25,0,105,162,9,276
6104206,10,0,10,62,12,6,80,163,12,255
6104207,12,0,12,79,23,0,102,247,12,361
6104208,15,0,15,65,16,0,81,296,34,411
6104209,5,0,5,59,20,0,79,161,9,249
6104210,0,0,0,47,13,0,60,111,19,190
6104211,11,0,11,105,32,0,137,297,36,470
6104212,14,4,18,115,33,0,148,224,10,382
6104213,14,0,14,76,31,6,113,231,21,365
6104301,6,0,6,103,34,3,140,296,13,449
6104302,82,17,99,62,31,3,96,333,44,473
6104303,3,0,3,36,19,0,55,123,6,184
6104304,63,9,72,38,23,3,64,228,24,316
6104305,9,0,9,78,44,0,122,344,14,480
6104306,9,0,9,95,33,8,136,261,9,406
6104307,14,0,14,57,55,3,115,322,37,474
6104308,6,0,6,41,33,0,74,148,9,231
6104309,4,0,4,34,17,0,51,107,15,173
6104401,6,0,6,57,23,0,80,126,20,226
6104402,3,0,3,81,32,6,119,196,6,321
6104403,0,0,0,61,12,3,76,158,5,239
6104404,0,0,0,71,23,3,97,187,6,290
6104405,0,0,0,39,15,0,54,118,0,172
6104406,7,0,7,51,31,0,82,193,6,281
6104407,48,3,51,29,21,3,53,254,12,319
6104408,13,0,13,46,26,3,75,222,21,318
6104409,3,6,9,64,31,0,95,234,21,350
6104410,6,0,9,89,40,3,132,273,4,409
6104411,6,0,6,58,34,0,92,255,24,371
6104412,3,0,3,112,29,9,150,298,32,480
6104413,0,0,0,0,0,0,0,0,0,0
6104414,3,6,9,25,27,0,52,144,21,217
6104415,3,0,3,85,13,6,104,241,21,366
6104416,3,0,3,78,11,3,92,161,7,260
6104417,13,0,13,39,33,0,72,260,16,348
6104418,15,3,18,21,21,3,45,158,15,218
6104501,0,3,3,24,13,0,37,121,26,184
6104502,0,0,0,0,0,0,0,3,0,3
6104503,3,0,3,115,23,9,147,208,31,386
6104504,6,0,6,59,22,3,84,227,30,341
6104505,6,0,6,63,26,7,96,215,38,349
6104506,3,3,6,60,34,3,97,238,41,376
6104507,0,3,3,50,30,0,80,140,24,244
6104508,5,0,5,43,24,0,67,137,18,222
6104509,4,0,4,26,11,6,43,134,20,197
6104510,4,0,4,75,34,0,109,219,64,392
6104511,0,0,0,0,0,0,0,0,6,6
6104512,0,0,0,63,21,0,84,163,23,270
6104601,0,0,0,56,14,0,70,106,0,176
6104602,4,4,8,58,15,6,79,203,25,307
6104603,0,0,0,114,38,8,160,240,18,418
6104604,12,3,15,64,24,6,94,228,27,349
6104605,8,0,8,32,17,3,52,135,15,202
6104606,19,6,25,89,34,7,130,282,33,445
6104607,6,3,9,27,19,0,46,202,12,260
6104608,3,0,3,80,40,3,123,253,18,394
6104609,0,0,0,33,14,0,47,56,19,122
6104610,12,0,12,94,44,13,151,257,18,426
6104611,10,0,10,41,20,0,61,161,6,228
6104612,14,3,17,64,35,3,102,220,14,336
6104613,0,0,0,0,0,0,0,0,0,0
6104614,4,3,7,68,36,4,108,310,15,433
6104615,3,0,3,37,14,4,55,100,3,158
6104616,12,0,12,51,37,5,93,147,0,240
6104617,8,3,11,85,30,0,115,259,31,405
6104701,5,0,5,60,30,3,93,238,25,356
6104702,43,3,46,54,10,3,67,228,9,304
6104703,3,0,3,47,16,5,68,142,9,219
6104704,3,5,8,47,19,6,72,152,11,235
6104705,6,0,6,39,20,5,64,151,3,218
6104706,6,4,10,91,34,3,128,274,25,427
6104707,3,3,6,71,20,0,91,277,19,387
6104708,3,3,6,56,19,3,78,249,36,363
6104709,0,0,0,63,22,3,88,216,15,319
6104710,0,0,0,70,6,3,79,223,32,334
6104711,0,3,3,23,17,3,43,146,3,192
6104712,92,10,102,46,12,3,61,315,30,406
6104801,11,4,15,52,26,0,78,252,37,367
6104802,9,3,12,31,23,0,54,189,23,266
6104803,6,0,6,81,23,0,104,209,21,334
6104804,0,0,0,0,0,0,0,0,0,0
6104805,7,0,7,77,17,3,97,238,38,373
6104806,0,0,0,86,28,0,114,217,7,338
6104807,3,0,3,90,31,5,126,272,12,410
6104808,4,4,8,69,24,3,96,199,26,321
6104809,0,3,3,59,24,0,83,174,20,277
6104810,4,0,4,40,17,0,57,173,25,255
6104811,0,0,0,20,3,3,26,59,6,91
6104812,0,0,0,39,16,9,64,115,9,188
6104813,4,0,4,52,35,0,87,222,25,334
6104814,5,3,8,48,13,3,64,115,13,192
6104901,3,0,3,121,36,9,166,308,21,495
6104902,3,3,6,51,10,0,61,137,9,207
6104903,3,0,3,63,17,4,84,205,18,307
6104904,3,0,3,74,40,8,122,232,9,363
6104905,3,0,3,59,9,0,68,178,11,257
6104906,6,6,12,67,28,3,98,299,10,407
6104907,9,0,9,62,33,9,104,325,28,457
6104908,7,0,7,113,43,11,167,376,16,559
6104909,8,0,8,79,34,0,113,209,22,344
6104910,5,0,5,86,30,10,126,244,8,378
6104911,0,0,0,0,0,0,0,0,0,0
6105001,6,3,9,80,34,4,118,216,53,387
6105002,0,0,0,34,10,3,47,99,19,165
6105003,0,0,3,57,12,0,69,128,21,218
6105004,40,3,43,109,46,4,159,273,15,447
6105005,3,3,6,27,16,0,43,123,6,172
6105006,0,3,3,76,18,0,94,175,24,293
6105007,4,0,4,57,29,0,86,219,34,339
6105008,6,3,9,59,24,0,83,206,30,319
6105009,6,6,12,79,39,6,124,259,21,404
6105101,0,0,0,4,0,0,4,0,0,4
6105102,3,0,3,44,13,6,63,151,10,224
6105103,4,0,4,46,3,0,49,155,13,217
6105104,3,0,3,39,12,0,51,141,6,198
6105105,0,0,0,59,13,0,72,141,9,222
6105106,4,0,4,49,27,0,76,181,13,270
6105107,6,0,9,82,30,5,117,202,16,335
6105108,0,3,3,43,9,3,55,108,12,175
6105109,0,0,0,77,33,0,110,171,12,293
6105110,8,0,8,66,25,6,97,226,7,330
6105111,0,0,0,48,9,0,57,144,9,210
6105112,6,3,9,58,22,0,80,202,21,303
6105113,6,0,6,31,23,6,60,193,12,265
6105114,0,3,3,40,19,0,59,158,18,235
6105201,7,3,10,72,23,0,95,275,20,390
6105202,3,0,3,60,24,3,87,170,3,260
6105203,0,0,0,57,24,0,81,180,11,272
6105204,72,28,100,13,6,0,19,242,55,316
6105205,10,0,10,63,22,6,91,199,21,311
6105206,3,0,3,61,38,0,99,205,11,315
6105207,3,0,3,69,21,0,90,152,10,252
6105208,6,0,6,71,14,7,92,176,23,291
6105209,0,0,0,142,57,6,205,270,6,481
6105210,3,0,3,98,43,7,148,284,14,446
6105211,10,0,10,109,34,6,149,307,35,491
6105301,0,0,0,31,6,0,37,146,14,197
6105302,7,6,13,44,22,3,69,290,37,396
6105303,6,4,10,69,30,0,99,330,28,457
6105304,6,0,6,23,15,0,38,148,0,186
6105305,0,0,0,38,18,0,56,81,16,153
6105306,0,0,0,54,9,0,63,149,19,231
6105307,11,0,11,22,11,3,36,141,13,190
6105308,0,0,0,45,13,3,61,127,23,211
6105309,0,0,0,34,13,0,47,128,6,181
6105310,0,3,3,28,6,0,34,104,25,163
6105311,0,0,0,0,0,0,0,3,0,3
6105312,5,0,5,63,14,0,77,282,21,380
6105313,6,0,6,20,26,0,46,238,16,300
6105314,0,0,0,17,6,0,23,64,6,93
6105401,0,0,0,26,3,6,35,126,18,179
6105402,0,3,3,19,15,3,37,115,21,173
6105403,4,3,7,65,22,4,91,174,12,277
6105404,19,3,22,29,11,6,46,137,15,198
6105405,11,3,14,53,30,0,83,161,24,268
6105406,31,3,34,22,9,6,37,128,17,182
6105407,0,0,0,0,0,0,0,6,0,6
6105408,10,3,13,66,16,3,85,212,24,321
6105409,4,0,4,22,13,6,41,100,18,159
6105410,6,0,6,49,13,3,65,174,7,246
6105411,4,0,4,70,32,0,102,221,18,341
6105412,4,0,4,71,17,0,88,248,22,358
6105413,3,0,3,55,21,0,76,215,17,308
6105414,0,0,0,0,0,0,0,0,0,0
6105415,3,0,3,49,23,0,72,191,11,274
6105416,0,0,0,52,22,4,78,170,10,258
6105417,3,0,3,25,22,3,50,128,10,188
6105418,4,0,4,46,23,0,69,192,16,277
6105419,8,0,8,28,12,0,40,125,18,183
6105420,5,3,8,94,20,0,114,188,15,317
6105501,10,0,10,99,36,0,135,284,19,438
6105502,8,0,8,52,16,6,74,194,26,294
6105503,8,0,8,29,15,6,50,174,34,258
6105504,6,0,6,42,24,4,70,180,22,272
6105505,6,0,6,67,30,3,100,283,9,392
6105506,0,0,0,66,21,3,90,199,12,301
6105507,3,0,3,97,26,3,126,211,24,361
6105508,6,0,6,47,11,3,61,181,13,255
6105509,0,0,0,72,27,0,99,207,30,336
6105510,0,0,0,31,9,0,40,93,10,143
6105511,0,0,0,75,24,6,105,202,34,341
6105512,4,0,4,97,21,6,124,254,13,391
6105513,17,0,17,49,21,5,75,221,13,309
6105514,3,0,3,57,17,3,77,139,9,225
6105515,4,0,4,24,6,6,36,106,3,145
6105601,0,0,0,65,18,6,89,174,9,272
6105602,3,3,6,104,11,0,115,180,18,313
6105603,4,0,4,53,18,0,71,188,3,262
6105604,0,0,0,73,20,0,93,136,4,233
6105605,0,0,0,54,11,0,65,126,6,197
6105606,4,0,4,57,17,0,74,119,14,207
6105607,8,0,8,66,33,3,102,224,28,354
6105608,0,0,0,50,22,7,79,243,32,354
6105609,12,0,12,65,21,3,89,200,20,309
6105701,6,0,6,43,9,0,52,208,31,291
6105702,9,3,12,34,23,0,57,175,31,263
6105703,0,0,0,76,16,7,99,176,15,290
6105704,8,3,11,48,31,3,82,207,25,314
6105705,0,0,0,49,28,4,81,131,7,219
6105706,3,0,3,55,18,0,73,98,12,183
6105707,3,0,3,63,20,0,83,156,13,252
6105708,4,6,10,79,20,0,99,230,24,353
6105709,4,0,4,58,21,6,85,203,23,311
6105710,0,0,0,68,12,6,86,185,15,286
6105711,0,0,0,39,18,6,63,138,9,210
6105712,3,3,6,35,14,0,49,181,17,247
6105801,7,0,7,46,10,0,56,147,21,224
6105802,0,0,0,59,14,0,73,170,3,246
6105803,3,0,3,23,14,0,37,96,25,158
6105804,4,0,4,71,20,3,94,166,21,281
6105805,0,0,0,88,20,0,108,190,24,322
6105806,0,0,0,75,24,0,99,185,20,304
6105807,0,0,0,65,9,0,74,142,29,245
6105808,0,0,0,51,14,3,68,218,36,322
6105809,0,0,0,86,30,7,123,262,13,398
6105810,6,0,6,46,23,3,72,182,16,270
6105811,0,0,0,34,12,0,46,145,12,203
6105812,0,0,0,46,14,0,60,149,9,218
6105901,32,4,36,22,12,0,34,145,11,190
6105902,3,0,3,63,18,3,84,193,27,304
6105903,6,0,6,69,25,7,101,221,20,342
6105904,0,0,0,74,25,3,102,149,22,273
6105905,0,0,0,44,16,0,60,154,15,229
6105906,10,0,10,31,15,3,49,159,18,226
6105907,0,0,0,55,23,3,81,158,13,252
6105908,0,3,3,38,31,0,69,189,35,293
6105909,0,0,0,74,28,3,105,221,24,350
6105910,7,0,7,37,26,0,63,121,18,202
6105911,6,0,6,81,28,0,109,225,32,366
6105912,3,0,3,67,28,0,95,187,18,300
6105913,0,0,0,59,22,3,84,202,22,308
6105914,0,0,0,0,0,0,0,0,0,0
6105915,0,0,0,76,20,9,105,246,18,369
6105916,0,0,0,37,17,0,54,89,3,146
6105917,0,0,0,21,16,0,37,83,6,126
6105918,0,4,4,22,13,0,35,151,13,199
6105919,6,0,6,29,18,3,50,138,9,197
6105920,0,0,0,22,18,3,43,135,15,193
6105921,0,0,0,35,12,0,47,97,9,153
6105922,4,0,4,60,15,3,78,176,27,281
6106001,3,3,6,59,20,4,83,229,18,330
6106002,6,0,6,36,13,3,52,137,16,205
6106003,11,3,14,46,15,0,61,241,19,321
6106004,4,0,4,61,26,9,96,189,28,313
6106005,6,3,9,68,31,4,103,312,22,437
6106006,0,0,0,60,13,3,76,132,7,215
6106007,12,3,15,90,47,3,140,325,30,495
6106008,0,0,0,90,24,6,120,261,15,396
6106009,37,0,37,18,7,0,25,161,13,199
6106010,0,0,0,51,3,3,57,104,3,164
6106101,3,3,6,32,12,0,44,199,18,261
6106102,21,0,21,49,15,9,73,309,24,406
6106103,7,0,7,22,12,0,34,188,24,246
6106104,4,0,4,37,9,3,49,118,13,180
6106105,0,0,0,57,12,6,75,181,17,273
6106106,0,3,3,51,19,0,70,236,32,338
6106107,0,0,0,38,0,0,38,65,12,115
6106108,7,0,7,112,65,4,181,356,31,568
6106109,3,3,6,49,23,3,75,165,21,261
6106110,4,0,4,48,16,0,64,157,17,238
6106111,0,0,0,14,0,0,14,34,6,54
6106201,0,0,0,55,31,7,93,132,13,238
6106202,6,3,9,49,10,0,59,172,19,250
6106203,3,3,6,45,16,3,64,159,18,241
6106204,0,0,0,34,12,0,46,69,3,118
6106205,4,3,7,78,35,6,119,252,34,405
6106206,0,0,0,74,34,4,112,164,19,295
6106207,3,0,3,47,27,6,80,140,19,239
6106208,0,0,0,57,12,0,69,151,9,229
6106209,4,0,4,54,24,3,81,144,6,231
6106210,0,0,0,17,10,0,27,125,0,152
6106211,4,0,4,95,30,9,134,276,34,444
6106212,0,0,0,44,14,3,61,186,12,259
6106213,6,0,6,112,23,6,141,249,25,415
6106214,6,0,6,36,17,3,56,185,29,270
6106301,7,0,7,64,15,0,79,174,15,268
6106302,48,4,52,23,12,0,35,213,24,272
6106303,4,3,7,60,25,0,85,238,18,341
6106304,9,0,9,46,30,3,79,277,18,374
6106305,13,0,13,48,17,6,71,254,29,354
6106306,5,0,5,67,20,3,90,219,18,327
6106307,6,0,6,27,12,0,39,123,11,173
6106308,0,3,3,83,21,3,107,222,31,360
6106309,0,0,0,43,18,0,61,201,27,289
6106310,0,0,0,51,14,0,65,148,18,231
6106311,0,0,0,64,21,0,85,108,18,211
6106312,0,0,0,43,11,0,54,77,4,135
6106313,0,0,0,20,3,0,23,79,8,110
6106314,0,0,0,38,17,0,55,149,12,216
6106315,0,0,0,0,0,0,0,0,0,0
6106316,0,0,0,26,15,9,50,164,12,226
6106317,9,0,9,68,24,0,92,266,22,380
6106318,0,0,0,3,0,0,3,44,4,51
6106319,3,0,3,29,0,0,29,110,23,162
6106320,3,0,3,59,15,3,77,129,22,228
6106321,4,0,4,40,21,9,70,130,3,203
6106322,4,0,4,65,36,3,104,299,18,421
6106323,3,3,6,45,13,0,58,136,15,209
6106324,0,0,0,58,26,0,84,102,12,198
6106325,0,0,0,29,0,0,29,121,22,172
6106326,5,0,5,46,26,9,81,158,5,244
6106401,6,0,6,34,12,3,49,235,25,309
6106402,0,0,0,37,9,6,52,159,18,229
6106403,0,0,3,24,12,0,36,119,15,170
6106404,3,3,6,45,10,0,55,107,11,173
6106405,0,0,0,33,3,0,36,100,3,139
6106406,0,0,0,0,0,0,0,0,0,0
6106407,5,0,5,31,15,0,46,183,24,253
6106408,7,4,11,59,9,0,68,209,21,298
6106409,15,0,15,44,22,0,66,230,18,314
6106410,4,0,4,18,5,0,23,131,31,185
6106411,0,0,0,48,23,3,74,198,37,309
6106412,3,0,3,15,9,0,24,92,3,119
6106413,0,0,0,24,12,0,36,140,21,197
6106414,3,3,6,70,18,0,88,231,32,351
6106415,3,0,3,80,27,3,110,277,31,418
6106416,4,0,4,47,19,3,69,210,21,300
6106417,0,0,0,52,0,0,52,152,25,229
6106418,0,0,0,0,0,0,0,0,0,0
6106419,5,6,11,41,6,0,47,184,37,268
6106420,0,0,0,45,11,6,62,154,19,235
6106421,52,5,57,45,23,0,68,318,37,423
6106422,6,0,6,25,9,3,37,183,22,242
6106501,8,3,11,43,29,3,75,227,21,323
6106502,3,3,6,57,23,3,83,197,36,316
6106503,3,0,3,79,19,0,98,233,38,369
6106504,0,0,0,0,0,0,0,0,0,0
6106505,0,3,3,58,6,0,64,188,33,285
6106506,0,0,0,35,15,0,50,137,15,202
6106507,0,0,0,24,9,0,33,208,31,272
6106601,0,0,0,58,9,3,70,116,9,195
6106602,4,0,4,65,23,0,88,197,18,303
6106603,4,0,4,21,16,0,37,95,6,138
6106604,5,0,5,32,10,6,48,113,13,174
6106605,0,0,0,30,3,0,33,73,7,113
6106606,0,0,0,67,14,6,87,158,19,264
6106607,0,0,0,48,9,0,57,123,3,183
6106608,0,0,0,56,17,10,83,140,15,238
6106609,0,0,0,29,23,0,52,134,62,248
6106610,0,0,0,70,13,0,83,184,6,273
6106611,3,0,3,69,25,3,97,191,19,307
6106612,0,0,0,0,0,0,0,0,0,0
6106701,0,0,0,74,26,0,100,197,16,313
6106702,4,0,4,42,15,3,60,163,16,239
6106703,0,0,0,52,17,0,69,150,12,231
6106704,3,0,3,56,33,3,92,190,32,314
6106705,4,0,4,53,23,0,76,160,13,249
6106706,4,0,4,62,20,0,82,189,21,292
6106707,3,0,3,45,22,0,67,174,13,254
6106708,0,0,0,36,6,0,42,117,18,177
6106709,0,0,0,104,27,6,137,283,36,456
6106710,16,5,21,28,10,0,38,156,26,220
6106711,3,0,3,70,16,0,86,160,15,261
6106712,3,0,3,100,29,4,133,254,17,404
6106713,6,0,6,46,15,3,64,219,34,317
6106714,7,0,7,47,24,3,74,166,7,247
6106715,3,0,3,49,10,0,59,104,13,176
6106716,0,0,0,55,21,6,82,205,25,312
6106717,0,0,0,82,25,3,110,219,27,356
6106801,0,0,0,0,0,0,0,6,3,9
6106901,0,0,0,39,18,3,60,101,12,173
6106902,4,0,4,55,21,3,79,153,9,241
6106903,0,0,0,66,34,6,106,232,30,368
6106904,5,0,5,71,32,9,112,232,24,368
6106905,0,0,0,19,6,6,31,137,9,177
6106906,7,3,10,73,38,0,111,332,21,464
6106907,3,0,3,20,5,0,25,89,15,129
6106908,4,0,4,32,17,3,52,127,21,200
6106909,7,0,7,31,24,0,55,136,15,206
6107001,3,0,3,27,20,3,50,136,24,210
6107002,6,4,10,59,35,0,94,163,16,273
6107003,3,0,3,35,10,6,51,120,18,189
6107004,0,0,0,65,21,3,89,237,3,329
6107005,12,0,12,95,28,18,141,289,27,457
6107006,0,0,0,38,15,0,53,180,10,243
6107007,4,0,4,64,9,3,76,171,12,259
6107008,0,0,0,33,17,4,54,157,21,232
6107009,0,0,0,34,12,0,46,154,12,212
6107010,0,0,0,41,24,0,65,144,12,221
6107011,0,0,0,32,9,6,47,129,25,201
6107012,0,0,0,63,22,0,85,193,18,296
6107101,0,4,4,62,26,6,94,231,31,356
6107102,0,0,0,51,19,0,70,217,18,305
6107103,5,6,11,49,25,0,74,277,32,383
6107104,0,0,0,43,15,3,61,198,19,278
6107105,5,0,5,101,25,4,130,318,18,466
6107106,0,0,0,67,32,3,102,152,28,282
6107107,0,0,0,77,9,3,89,177,16,282
6107108,0,0,0,0,0,0,0,0,0,0
6107109,3,0,3,50,23,3,76,186,28,290
6107110,3,0,3,41,10,4,55,142,10,207
6107201,0,0,0,55,15,3,73,105,11,189
6107202,3,0,3,34,0,0,34,82,5,121
6107203,6,0,6,60,23,3,86,170,12,268
6107204,0,0,0,74,18,6,98,162,9,269
6107205,0,0,0,50,15,3,68,148,12,228
6107206,6,0,6,114,38,9,161,266,13,440
6107207,0,0,0,84,38,0,122,244,24,390
6107208,52,0,52,29,22,6,57,227,15,299
6107209,6,0,6,100,20,3,123,241,24,388
6107210,3,0,3,51,25,0,76,176,23,275
6107211,10,0,10,64,19,0,83,201,13,297
6107212,0,0,0,73,25,9,107,172,18,297
6107213,6,3,9,105,16,3,124,250,30,404
6107214,0,0,0,49,6,3,58,157,4,219
6107215,4,0,4,57,28,3,88,166,5,259
6107216,4,0,4,57,9,3,69,148,7,224
6107217,3,0,3,75,14,7,96,103,8,207
6107218,9,0,9,54,38,6,98,226,22,346
6107219,6,0,6,57,37,6,100,225,28,353
6107220,4,0,4,86,23,6,115,247,6,368
6107221,0,0,0,63,23,0,86,168,15,269
6107301,0,0,0,41,23,3,67,222,13,302
6107302,3,3,6,45,25,0,70,139,35,244
6107303,0,0,0,0,0,0,0,0,0,0
6107304,6,0,6,44,7,0,51,164,21,236
6107305,3,0,3,51,29,5,85,178,29,292
6107306,0,0,0,47,14,3,64,144,18,226
6107307,14,3,17,30,3,4,37,159,35,231
6107308,0,0,0,13,12,3,28,37,3,68
6107309,0,0,0,37,14,3,54,95,9,158
6107310,4,0,4,26,21,0,47,161,15,223
6107401,6,0,6,31,19,6,56,162,19,237
6107402,0,0,0,0,0,0,0,0,0,0
6107403,0,0,0,28,0,6,34,137,11,182
6107404,4,4,8,43,22,0,65,239,21,325
6107405,0,0,0,0,0,0,0,0,0,0
6107406,3,3,6,3,6,0,9,90,12,111
6107407,0,0,0,20,24,0,44,214,18,276
6107408,0,0,0,39,7,0,46,106,12,164
6107409,0,14,14,30,8,0,38,143,18,199
6107410,0,0,0,17,9,3,29,98,6,133
6107411,0,0,0,16,9,0,25,86,9,120
6107412,3,6,9,27,14,6,47,124,15,186
6107413,3,0,3,26,10,0,36,98,4,138
6107414,36,6,42,29,24,0,53,275,25,353
6107415,7,3,10,47,19,0,66,154,8,228
6107416,0,0,0,0,3,0,3,0,0,3
6107417,7,4,11,42,23,3,68,222,16,306
6107418,4,0,4,41,13,0,54,129,25,208
6107419,7,0,7,41,18,0,59,156,22,237
6107420,0,0,0,19,16,0,35,127,3,165
6107501,3,0,3,35,12,3,50,166,32,248
6107502,7,3,10,38,18,5,61,229,28,318
6107503,3,0,3,49,6,6,61,127,21,209
6107504,0,0,0,38,26,3,67,150,28,245
6107505,4,7,11,83,28,3,114,354,34,502
6107506,3,0,3,111,33,3,147,264,42,453
6107507,0,0,0,52,14,0,66,191,34,291
6107508,20,0,20,81,25,3,109,294,10,413
6107601,3,3,6,84,21,12,117,214,27,358
6107602,0,3,3,71,20,5,96,208,20,324
6107603,0,3,3,77,18,6,101,186,40,327
6107604,7,0,7,60,5,3,68,225,25,318
6107605,5,0,5,29,22,3,54,152,8,214
6107606,6,3,9,70,28,0,98,233,18,349
6107607,0,0,0,56,20,0,76,197,19,292
6107608,4,0,4,75,15,7,97,222,12,331
6107609,6,6,12,72,16,9,97,201,22,320
6107610,4,0,4,61,13,0,74,166,10,250
6107611,0,0,0,75,24,3,102,209,17,328
6107612,3,0,3,76,27,3,106,177,4,287
6107613,0,0,0,48,16,3,67,168,13,248
6107614,0,0,0,14,15,3,32,60,6,98
6107701,6,0,6,69,18,3,90,191,23,304
6107702,9,0,9,15,18,0,33,114,14,161
6107703,3,0,3,53,16,0,69,262,31,362
6107704,0,0,0,3,6,0,9,59,0,68
6107705,0,0,0,0,0,0,0,0,0,0
6107706,0,0,0,0,0,0,0,3,0,3
6107707,4,0,4,24,18,0,42,156,30,228
6107708,6,0,6,38,21,0,59,158,23,240
6107709,5,0,5,79,39,0,118,230,21,369
6107710,5,0,5,56,0,6,62,212,20,294
6107711,11,0,11,62,20,3,85,144,16,245
6107712,8,3,11,70,36,3,109,235,21,365
6107713,7,0,7,76,38,12,126,274,42,442
6107801,10,8,18,80,26,3,109,238,37,384
6107802,0,0,0,68,14,0,82,146,24,252
6107803,15,83,98,6,0,0,6,69,147,222
6107804,0,0,0,59,14,0,73,146,18,237
6107805,0,0,0,27,11,3,41,111,3,155
6107806,6,3,9,46,27,14,87,162,9,258
6107807,6,0,6,119,32,9,160,294,30,484
6107808,6,3,9,40,24,3,67,223,15,305
6107809,7,0,7,53,38,0,91,198,10,299
6107810,6,0,6,38,18,0,56,117,13,186
6107811,3,0,3,37,32,0,69,173,5,247
6107812,7,6,13,71,29,5,105,270,27,402
6107813,12,3,15,41,12,6,59,209,26,294
6107814,0,0,0,46,3,0,49,106,7,162
6107815,6,3,9,43,7,4,54,135,6,195
6107816,8,3,11,65,38,0,103,237,19,359
6107817,4,0,4,75,40,0,115,193,28,336
6107818,0,0,0,75,21,0,96,115,20,231
6107901,0,7,7,23,15,0,38,107,19,164
6107902,4,0,4,33,7,3,43,77,4,124
6107903,0,3,3,93,41,3,137,234,21,392
6107904,0,0,0,46,13,3,62,139,18,219
6107905,3,0,3,31,11,3,45,132,7,184
6107906,6,0,6,63,14,3,80,150,7,237
6107907,0,0,0,34,15,0,49,117,23,189
6107908,6,0,6,44,24,0,68,141,22,231
6107909,27,0,27,37,19,3,59,182,23,264
6107910,4,0,4,71,21,0,92,253,21,366
6107911,0,0,0,118,49,6,173,244,8,425
6107912,0,0,0,37,8,0,45,114,15,174
6107913,0,3,3,38,32,3,73,167,34,274
6107914,3,0,3,25,21,3,49,109,12,170
6107915,3,0,3,41,15,0,56,97,0,153
6107916,3,0,3,37,24,0,61,140,6,207
6107917,12,0,12,24,8,0,32,165,34,231
6108001,5,0,5,51,26,7,84,185,19,288
6108002,3,0,3,43,8,0,51,155,11,217
6108003,0,0,0,66,39,0,105,151,24,280
6108004,3,3,6,48,9,3,60,109,15,184
6108005,0,0,0,85,27,3,115,178,12,305
6108006,3,0,3,67,19,0,86,217,23,326
6108007,0,0,0,24,6,9,39,112,12,163
6108008,0,3,3,77,33,0,110,232,18,360
6108009,3,0,3,58,9,0,67,107,5,179
6108010,0,3,3,28,24,0,52,131,12,195
6108011,6,0,6,49,12,3,64,191,6,261
6108101,0,0,0,17,12,0,29,46,6,81
6108102,3,0,3,68,32,0,100,125,15,240
6108103,10,0,10,28,18,5,51,128,12,191
6108104,0,0,0,36,16,0,52,128,9,189
6108105,3,0,3,42,7,0,49,123,11,183
6108106,4,0,4,55,21,3,79,160,10,249
6108107,42,6,51,65,30,0,95,295,28,418
6108108,9,0,9,88,24,0,112,277,32,421
6108109,9,3,12,34,23,3,60,170,28,258
6108110,9,7,16,58,16,3,77,232,15,324
6108111,3,3,6,66,31,9,106,236,30,372
6108112,4,0,4,68,24,3,95,208,15,318
6108201,0,0,0,13,0,0,13,12,0,25
6108202,13,0,13,61,23,0,84,267,40,391
6108203,6,7,13,39,29,0,68,182,42,292
6108204,7,6,13,34,20,0,54,170,19,243
6108205,10,3,13,34,14,0,48,166,19,233
6108206,4,0,4,40,18,5,63,131,15,209
6108207,8,0,8,18,21,0,39,144,4,187
6108208,6,3,9,65,30,3,98,213,31,342
6108209,0,0,0,25,9,0,34,69,9,112
6108210,3,0,3,27,3,0,30,64,3,97
6108211,6,0,6,58,16,0,74,139,17,230
6108212,5,0,5,25,11,0,36,98,5,139
6108213,5,0,5,33,18,0,51,150,15,216
6108214,4,0,4,60,28,6,94,245,21,360
6108215,11,3,14,48,20,3,71,181,17,269
6108216,3,4,7,73,28,0,101,202,14,317
6108217,6,0,6,52,19,0,71,217,23,311
6108218,11,4,15,38,24,6,68,197,28,293
6108219,11,6,17,74,18,6,98,227,53,378
6108220,22,6,28,46,28,10,84,282,52,418
6108221,6,0,6,97,40,5,142,301,38,481
6108301,8,3,11,32,13,3,48,154,27,229
6108302,4,0,4,42,26,3,71,183,19,273
6108303,9,3,12,62,20,3,85,208,15,308
6108304,3,0,3,70,24,3,97,272,23,392
6108305,0,0,0,57,27,0,84,139,31,254
6108306,0,0,0,44,17,0,61,115,9,185
6108307,5,0,5,34,32,0,66,154,18,238
6108308,0,0,0,12,4,0,16,46,9,71
6108309,0,34,34,50,23,7,80,196,86,362
6108310,7,0,7,84,28,6,118,233,23,374
6108311,48,0,48,41,27,0,68,272,13,353
6108312,0,3,3,75,26,3,104,189,13,306
6108313,0,0,0,29,16,4,49,92,4,145
6108401,0,0,0,0,0,0,0,3,0,3
6108402,3,0,3,36,12,4,52,135,15,202
6108403,4,0,4,34,9,0,43,157,18,218
6108404,0,0,0,20,21,0,41,146,0,187
6108405,0,0,0,63,15,3,81,128,3,212
6108406,0,0,0,64,20,3,87,188,18,293
6108407,5,0,5,17,24,0,41,128,10,179
6108408,3,4,7,56,45,0,101,303,25,429
6108409,5,7,12,61,12,0,73,219,51,343
6108410,0,0,0,74,20,4,98,189,3,290
6108411,0,0,0,74,10,0,84,178,19,281
6108412,0,0,0,52,24,3,79,147,4,230
6108413,13,0,13,61,24,4,89,199,19,307
6108414,10,8,18,32,20,0,52,147,16,215
6108415,6,0,6,40,11,3,54,178,26,258
6108416,6,3,12,42,15,0,57,182,27,266
6108417,6,0,6,45,14,6,65,195,18,278
6108418,0,0,0,35,27,3,65,159,10,234
6108419,4,0,4,33,23,0,56,157,13,226
6108420,28,4,32,29,21,3,53,192,27,272
6108501,8,6,14,44,8,0,52,107,23,182
6108502,14,7,21,33,20,0,53,180,29,262
6108503,12,0,12,56,22,0,78,212,24,314
6108504,4,0,4,81,23,6,110,197,11,318
6108505,12,0,12,58,33,7,98,204,18,320
6108506,10,0,10,60,25,0,85,279,29,393
6108507,0,0,0,0,0,0,0,0,0,0
6108508,0,0,0,57,22,0,79,162,25,266
6108509,19,6,25,68,26,6,100,269,30,399
6108510,6,4,10,52,26,3,81,201,12,294
6108511,7,0,7,119,28,8,155,290,48,493
6108512,11,6,17,103,28,3,134,236,30,400
6108513,4,6,10,55,25,3,83,221,25,329
6108514,16,4,20,67,41,6,114,277,35,426
6108515,9,3,12,66,25,9,100,267,18,385
6108516,50,29,79,24,20,0,44,247,82,373
6108517,9,6,15,78,28,7,113,263,65,441
6108518,25,6,31,36,19,0,55,213,38,306
6108519,10,0,10,31,19,0,50,177,16,243
6108520,10,0,10,53,26,4,83,279,16,378
6108521,0,3,3,88,26,6,120,242,40,402
6108522,3,3,6,73,24,6,103,218,36,357
6108523,7,3,10,63,21,3,87,219,19,325
6108524,3,0,3,52,37,8,97,175,15,287
6108525,5,0,5,66,43,0,109,236,22,367
6108526,0,3,3,45,22,3,70,185,29,284
6108527,3,7,10,32,10,3,45,189,14,248
6108528,85,3,88,30,19,9,58,267,20,345
6108529,12,6,18,39,25,6,70,207,28,305
6108530,7,3,10,93,26,3,122,241,25,388
6108531,9,3,12,45,19,6,70,181,19,270
6108532,0,0,0,0,0,0,0,0,0,0
6108533,11,0,11,41,18,6,65,231,26,322
6108534,15,3,18,58,16,0,74,214,26,314
6108535,3,0,3,82,28,6,116,246,13,375
6108536,7,0,7,76,30,3,109,234,21,364
6108601,6,0,6,51,7,3,61,176,13,250
6108602,0,3,3,35,17,0,52,142,23,217
6108603,3,7,10,36,6,0,42,189,29,260
6108604,6,3,9,53,20,3,76,260,44,380
6108605,3,0,3,19,3,0,22,61,21,104
6108606,3,3,6,63,38,3,104,155,27,286
6108607,3,3,6,20,12,9,41,103,18,162
6108608,0,0,0,71,11,0,82,135,34,251
6108609,8,0,8,12,18,0,30,47,0,77
6108610,4,4,8,52,26,6,84,159,19,262
6108611,3,0,3,57,13,3,73,163,25,261
6108612,6,0,6,56,29,0,85,221,14,320
6108613,0,3,3,53,25,0,78,106,36,220
6108614,0,0,0,58,24,3,85,116,15,216
6108615,24,3,27,39,15,0,54,179,24,257
6108616,8,0,8,56,32,4,92,220,29,341
6108701,24,3,27,44,12,3,59,191,12,262
6108702,0,0,0,44,16,0,60,132,10,202
6108703,0,0,0,42,19,0,61,105,12,178
6108704,0,0,0,38,29,0,67,149,9,225
6108705,0,3,3,60,20,3,83,164,10,257
6108706,3,0,3,56,24,3,83,166,12,261
6108707,7,0,7,107,36,8,151,336,31,518
6108708,11,3,14,27,18,0,45,205,22,272
6108709,4,0,4,53,11,0,64,126,18,208
6108710,11,3,14,47,26,0,73,216,19,308
6108711,0,0,0,67,19,0,86,153,27,266
6108712,11,0,11,63,31,5,99,297,31,427
6108801,3,0,3,38,7,7,52,98,0,150
6108802,4,3,7,146,44,16,206,382,25,613
6108803,9,3,12,107,37,7,151,303,33,487
6108804,3,0,3,64,42,6,112,263,21,396
6108805,9,0,9,84,40,0,124,378,14,516
6108806,3,0,3,68,26,0,94,198,9,301
6108901,3,3,6,66,19,3,88,285,6,379
6108902,0,0,0,40,15,3,58,118,12,188
6108903,0,0,0,36,9,6,51,100,10,161
6108904,0,0,0,26,14,0,40,107,6,153
6108905,11,0,11,85,30,3,118,325,31,474
6108906,41,0,41,85,32,0,117,332,22,471
6108907,12,6,18,128,49,14,191,512,55,758
6108908,0,3,3,70,18,0,88,215,19,322
6108909,8,0,8,45,12,0,57,144,16,217
6108910,3,3,6,59,22,4,85,256,14,355
6108911,5,0,5,52,19,3,74,217,23,314
6108912,3,0,3,55,10,3,68,167,15,250
6108913,0,0,0,31,11,0,42,81,3,126
6109001,0,0,0,93,28,9,130,197,23,350
6109002,0,0,0,94,31,0,125,275,21,421
6109003,3,0,6,35,15,0,50,76,7,133
6109004,3,0,3,85,31,6,122,226,10,358
6109005,0,0,0,35,25,0,60,106,14,180
6109006,0,0,0,94,32,10,136,210,24,370
6109007,3,3,6,39,6,3,48,103,15,166
6109008,0,0,0,53,24,0,77,109,13,199
6109101,0,0,0,3,0,0,3,3,0,6
6109102,0,0,0,45,9,3,57,149,13,219
6109103,0,0,0,42,16,0,58,161,18,237
6109104,6,3,9,43,12,0,55,175,15,245
6109105,38,0,38,55,21,3,79,323,27,429
6109106,0,0,0,56,27,0,83,260,13,356
6109107,0,0,0,41,13,3,57,116,24,197
6109108,3,4,7,52,19,0,71,210,27,308
6109109,3,3,6,55,20,3,78,186,16,280
6109110,0,0,0,115,30,8,153,203,10,366
6109111,3,0,3,59,13,3,75,153,19,247
6109112,0,0,0,54,24,0,78,278,13,369
6109113,0,0,0,63,26,0,89,206,18,313
6109114,3,0,3,78,25,11,114,202,18,334
6109115,0,0,0,56,8,5,69,189,9,267
6109116,0,0,0,59,20,0,79,144,18,241
6109117,0,3,3,37,11,4,52,210,20,282
6109118,0,0,0,33,15,6,54,139,10,203
6109201,0,0,0,39,19,3,61,162,17,240
6109202,0,0,0,62,37,6,105,251,12,368
6109203,4,0,4,93,25,6,124,240,12,376
6109204,4,0,4,36,12,0,48,111,13,172
6109205,3,0,3,58,29,0,87,208,17,312
6109206,0,0,0,46,28,3,77,162,23,262
6109207,4,0,4,49,28,0,77,160,22,259
6109208,0,0,0,74,23,4,101,173,23,297
6109209,0,0,0,31,15,3,49,113,21,183
6109301,3,0,3,46,20,4,70,261,19,350
6109302,5,0,5,39,13,3,55,159,18,232
6109303,20,6,26,24,12,0,36,201,24,261
6109304,3,3,6,55,22,9,86,201,27,314
6109305,3,3,6,24,12,0,36,122,9,167
6109401,0,0,0,61,20,0,81,178,34,293
6109402,4,0,4,47,18,0,65,136,28,229
6109403,0,0,0,33,9,3,45,100,17,162
6109404,3,0,3,36,17,6,59,178,18,255
6109405,0,0,0,99,33,4,136,291,30,457
6109406,3,0,3,67,15,3,85,134,0,219
6109407,3,0,3,77,14,0,91,114,5,210
6109408,0,3,3,78,22,3,103,154,3,260
6109409,3,0,3,57,9,0,66,152,20,238
6109410,0,0,0,43,18,0,61,97,7,165
6109411,9,3,12,61,33,4,98,236,46,380
6109412,0,0,0,3,0,0,3,3,0,6
6109413,0,0,0,63,17,4,84,124,12,220
6109501,7,0,7,41,29,0,70,211,20,301
6109502,0,0,0,33,12,9,54,93,3,150
6109503,6,0,6,55,13,3,71,167,9,247
6109504,7,3,10,84,30,4,118,214,18,350
6109505,0,0,0,68,30,0,98,192,12,302
6109506,14,3,17,66,41,6,113,174,12,299
6109507,0,0,0,45,18,0,63,103,10,176
6109508,47,3,50,31,23,3,57,219,25,301
6109509,0,0,0,42,12,0,54,89,3,146
6109510,4,0,4,61,16,3,80,97,14,191
6109511,3,0,3,56,18,6,80,123,15,218
6109512,3,0,3,94,21,9,124,213,35,372
6109601,0,3,3,29,7,3,39,139,20,198
6109602,0,0,0,82,28,9,119,201,17,337
6109603,3,0,3,66,33,3,102,221,19,342
6109604,0,0,0,30,3,3,36,121,6,163
6109605,3,0,3,49,13,0,62,194,9,265
6109606,5,0,5,67,25,3,95,169,22,286
6109607,3,0,3,55,25,3,83,199,9,291
6109608,0,0,0,55,16,0,71,179,16,266
6109609,0,0,0,48,10,0,58,117,6,181
6109610,0,0,0,57,14,3,74,147,9,230
6109611,0,0,0,71,17,3,91,185,10,286
6109612,0,0,0,12,6,0,18,27,3,48
6109613,0,0,0,21,5,3,29,62,5,96
6109701,0,0,0,65,20,4,89,206,13,308
6109702,0,3,3,28,0,3,31,105,22,158
6109703,0,0,0,31,3,0,34,102,9,145
6109704,8,6,14,101,45,3,149,355,43,547
6109705,0,0,0,61,15,3,79,156,26,261
6109706,0,0,0,0,0,0,0,0,0,0
6109707,0,0,0,58,10,0,68,138,12,218
6109708,0,0,0,38,15,0,53,152,25,230
6109709,3,0,3,38,9,0,47,73,10,130
6109710,3,0,3,63,21,6,90,156,36,282
6109711,3,3,6,60,19,0,79,213,26,318
6109712,6,0,6,56,13,0,69,225,28,322
6109713,4,0,4,105,16,6,127,209,24,360
6109714,0,0,0,22,6,0,28,81,28,137
6109715,0,0,0,0,6,0,6,27,3,36
6109716,0,0,0,0,0,0,0,0,0,0
6109717,6,0,6,36,19,0,55,200,17,272
6109718,0,0,0,0,0,0,0,0,0,0
6109719,0,0,0,0,0,0,0,0,0,0
6109720,0,0,0,0,0,0,0,0,0,0
6109801,0,0,0,0,0,0,0,0,0,0
6949999,0,0,0,111,59,3,173,653,149,975
6979991,0,0,0,0,0,0,0,0,0,0
6979992,0,0,0,0,0,0,0,0,0,0
6979993,0,0,0,6,9,0,15,62,12,89
6979994,0,0,0,0,0,0,0,27,0,27
7100101,0,0,0,0,3,0,3,34,335,372
7100201,14,0,14,79,42,6,127,832,225,1184
7100202,3,0,3,65,41,0,106,557,141,804
7100203,3,0,3,49,30,3,82,439,114,635
7100204,0,0,0,23,4,0,27,200,22,249
7100205,0,0,0,38,21,0,59,594,161,814
7100206,0,0,0,0,0,0,0,6,3,9
7100207,0,0,0,21,0,0,21,120,54,195
7100208,0,0,0,23,10,0,33,203,80,316
7100301,0,0,0,0,0,0,0,24,17,41
7100401,0,0,0,73,32,4,109,471,61,641
7100402,11,3,14,55,22,3,80,331,83,494
7100403,5,0,5,71,32,0,103,208,47,358
7100404,4,0,4,109,33,3,145,274,19,438
7100405,3,0,3,69,26,0,95,446,79,620
7100406,0,0,0,35,18,6,59,100,20,179
7100501,0,0,0,61,12,0,73,121,14,208
7100502,4,0,4,58,17,0,75,355,58,488
7100503,0,0,0,58,27,0,85,476,126,687
7100504,0,0,0,29,13,0,42,267,67,376
7100505,0,0,0,60,18,0,78,253,48,379
7100506,0,0,0,55,4,0,59,139,5,203
7100507,0,3,3,38,15,0,53,360,73,486
7100601,3,0,3,73,18,0,91,201,64,356
7100602,0,0,0,12,12,0,24,27,3,54
7100603,0,0,0,30,18,0,48,104,9,161
7100604,0,0,0,0,0,0,0,0,0,0
7100605,0,0,0,54,19,9,82,161,38,281
7100606,3,0,3,104,36,7,147,298,32,477
7100607,3,0,3,97,23,3,123,331,57,511
7100608,0,0,0,141,14,8,163,197,16,376
7100701,0,0,0,46,14,0,60,122,15,197
7100702,0,0,0,23,9,0,32,109,18,159
7100703,0,0,0,53,19,3,75,270,28,373
7100704,0,0,0,32,6,0,38,152,110,300
7100705,0,0,0,91,21,0,112,158,18,288
7100706,3,0,3,57,12,0,69,221,16,306
7100801,3,0,3,63,27,4,94,532,132,758
7100802,0,3,3,58,28,3,89,355,61,505
7100803,0,0,0,65,24,6,95,243,30,368
7100804,0,6,6,56,25,0,81,260,26,367
7100805,3,0,3,81,21,0,102,519,112,733
7100806,0,0,0,16,12,0,28,141,5,174
7100807,0,0,0,56,22,5,83,255,40,378
7100901,0,0,0,82,20,3,105,249,55,409
7100902,0,0,0,103,27,0,130,562,49,741
7100903,0,0,0,78,39,6,123,310,40,473
7100904,0,0,0,3,0,0,3,7,0,10
7100905,0,0,0,89,13,3,105,218,32,355
7100906,0,0,0,27,9,0,36,176,32,244
7101001,3,0,3,48,18,0,66,143,30,239
7101002,0,0,0,71,29,3,103,206,52,361
7101003,0,0,0,84,25,6,115,294,58,467
7101004,0,0,0,57,27,3,87,156,54,297
7101005,0,0,0,40,25,0,65,175,54,294
7101006,0,0,0,0,0,0,0,3,3,6
7101101,0,0,0,99,31,3,133,242,47,422
7101102,0,0,0,53,7,3,63,133,18,214
7101103,0,0,0,68,42,6,116,159,44,319
7101104,0,0,0,94,25,4,123,242,50,415
7101105,3,0,3,99,31,6,136,280,24,440
7101201,0,0,0,45,40,3,88,284,57,429
7101202,0,0,0,0,0,0,0,0,702,702
7101203,0,0,0,36,32,0,68,109,25,202
7101204,0,0,0,106,12,6,124,162,437,723
7101205,0,0,0,26,8,3,37,119,16,172
7101301,0,0,0,61,33,0,94,333,37,464
7101302,0,0,0,91,30,5,126,348,34,508
7101303,0,0,0,71,28,3,102,237,9,348
7101304,0,0,0,84,36,0,120,277,33,430
7101305,4,0,4,80,18,3,101,238,67,406
7101306,3,0,3,73,22,0,95,198,18,311
7101307,0,0,0,0,0,0,0,11,3,14
7101401,0,0,0,0,0,0,0,0,3,3
7101501,0,0,0,0,0,0,0,6,3,9
7101601,13,0,13,70,30,4,104,272,75,451
7101602,0,0,0,58,21,6,85,340,44,469
7101603,3,3,6,71,34,0,105,441,121,667
7101604,3,0,3,63,21,6,90,231,65,386
7101605,0,0,0,79,23,0,102,243,52,397
7101606,0,0,0,6,0,3,9,26,0,35
7101701,0,0,0,0,0,0,0,6,0,6
7101801,3,0,3,84,35,10,129,241,42,412
7101802,0,0,0,82,31,3,116,214,42,372
7101803,0,0,0,72,22,5,99,170,19,288
7101804,0,0,0,69,34,7,110,188,17,315
7101901,0,0,0,108,26,9,143,287,33,463
7101902,0,0,0,74,25,6,105,212,39,356
7101903,0,0,0,90,33,4,127,240,34,401
7101904,0,0,0,64,29,3,96,190,55,341
7101905,0,0,0,43,16,3,62,161,41,264
7101906,0,0,0,57,23,4,84,254,43,381
7101907,0,0,0,60,30,6,96,129,33,258
7101908,0,0,0,62,22,3,87,217,56,360
7101909,6,0,6,103,28,6,137,278,44,459
7101910,0,0,0,69,23,0,92,188,43,323
7102001,3,0,3,112,43,9,164,305,70,539
7102002,0,0,0,96,32,0,128,292,145,565
7102003,6,6,12,103,23,4,130,307,77,514
7102004,0,0,0,63,26,3,92,232,32,356
7102005,0,0,0,89,30,3,122,187,24,333
7102006,4,0,4,100,27,0,127,322,55,504
7102007,3,0,3,117,45,6,168,328,24,520
7102008,0,0,0,60,27,0,87,262,42,391
7102101,0,0,0,217,40,9,266,352,27,645
7102102,0,0,0,0,0,0,0,0,0,0
7102103,0,0,0,0,3,0,3,112,22,137
7102104,0,0,0,245,24,11,280,366,24,670
7102201,3,0,3,58,24,6,88,162,0,250
7102202,0,0,0,71,40,3,114,415,44,573
7102203,0,0,0,69,29,0,98,228,12,338
7102204,0,6,6,76,29,9,114,218,36,368
7102205,0,0,0,46,22,9,77,132,95,304
7102206,0,0,0,62,28,6,96,188,38,322
7102207,0,0,0,6,0,0,6,4,0,10
7102208,0,0,0,3,0,0,3,9,0,12
7102209,0,0,0,49,15,12,76,218,52,346
7102210,0,0,0,70,23,0,93,149,62,304
7102211,0,0,0,41,19,0,60,175,61,296
7102212,0,3,3,68,29,3,100,180,57,337
7102213,0,0,0,41,23,0,64,145,53,262
7102301,3,0,3,64,24,3,91,259,105,455
7102302,3,3,6,93,36,13,142,362,60,564
7102303,0,0,0,54,23,0,77,115,41,233
7102304,0,0,0,69,19,3,91,177,18,286
7102305,3,0,3,76,33,14,123,297,44,464
7102401,3,0,3,59,29,0,88,197,47,332
7102402,3,0,3,79,25,8,112,220,33,365
7102403,6,0,6,57,22,0,79,178,23,280
7102404,0,0,0,49,26,3,78,132,26,236
7102405,0,0,0,84,24,7,115,169,43,327
7102501,3,0,3,47,9,6,62,136,39,237
7102502,0,0,0,80,20,3,103,178,19,300
7102503,0,0,0,30,12,0,42,160,20,222
7102504,3,0,3,52,6,0,58,204,70,332
7102505,3,3,6,75,34,7,116,364,125,605
7102506,0,0,0,42,31,3,76,268,40,384
7102507,0,0,0,63,22,3,88,246,39,373
7102508,0,0,0,40,10,0,50,232,45,327
7102509,0,0,0,64,21,6,91,179,20,290
7102601,3,0,3,93,36,6,135,247,51,433
7102602,0,0,0,0,0,0,0,0,0,0
7102603,3,0,3,72,31,6,109,425,225,759
7102604,3,0,3,62,21,9,92,232,52,376
7102605,0,0,0,119,33,6,158,296,33,487
7102606,6,3,9,93,21,9,123,380,142,645
7102701,0,0,3,77,26,6,109,227,36,372
7102702,59,6,65,29,27,0,56,303,39,398
7102703,0,0,0,59,19,9,87,147,37,271
7102704,0,0,0,87,37,6,130,290,57,477
7102705,3,0,3,93,16,3,112,248,24,384
7102706,0,3,3,17,0,0,17,67,28,112
7102707,0,0,0,0,0,0,0,0,3,3
7102801,0,0,0,59,28,5,92,226,72,390
7102802,0,0,0,87,24,3,114,177,56,347
7102803,4,0,4,82,33,0,115,227,35,377
7102804,0,3,3,93,25,6,124,310,70,504
7102805,0,0,0,0,0,0,0,0,0,0
7102901,3,0,3,92,30,6,128,286,37,451
7102902,0,0,0,57,17,0,74,171,31,276
7102903,0,0,0,79,25,0,104,229,25,358
7102904,0,0,0,65,26,0,91,176,32,299
7103001,3,0,3,89,18,6,113,143,48,304
7103002,3,3,6,78,24,6,108,143,34,285
7103003,0,0,0,70,13,0,83,118,79,280
7103004,0,0,0,68,17,4,89,213,73,375
7103005,0,0,0,73,30,3,106,219,31,356
7103006,3,0,3,23,15,3,41,83,37,161
7103007,0,0,0,44,19,8,71,127,3,201
7103101,0,0,0,62,19,4,85,145,157,387
7103102,0,0,0,19,3,3,25,36,6,67
7103103,0,0,0,29,6,3,38,115,9,162
7103104,0,0,0,40,18,0,58,162,40,260
7103105,0,0,0,62,40,0,102,195,27,324
7103106,6,0,6,80,33,0,113,339,50,502
7103107,0,0,0,16,23,0,39,764,63,866
7103108,0,0,0,0,0,0,0,0,0,0
7103109,0,3,3,62,27,6,95,184,36,315
7103110,3,0,3,45,19,0,64,130,32,226
7103111,0,0,0,42,13,0,55,115,25,195
7103112,3,0,3,56,21,0,77,189,59,325
7103201,0,0,0,46,20,5,71,196,31,298
7103202,0,0,0,88,30,3,121,235,34,390
7103203,0,0,0,148,27,4,179,309,59,547
7103204,0,0,0,244,52,15,311,452,57,820
7103205,3,0,3,60,20,9,89,187,72,348
7103206,0,0,0,95,35,6,136,238,55,429
7103207,0,0,0,74,24,0,98,190,34,322
7103208,0,0,0,58,13,9,80,153,16,249
7103209,0,3,3,82,39,3,124,223,48,395
7103210,0,0,0,109,26,4,139,194,65,398
7103211,4,3,7,144,44,7,195,279,35,509
7103212,3,0,3,96,26,6,128,182,107,417
7103213,0,0,0,80,31,3,114,177,26,317
7103214,0,0,0,114,23,4,141,287,47,475
7103301,0,0,0,0,0,0,0,16,3,19
7103401,0,0,0,45,27,6,78,207,65,350
7103402,3,0,3,63,13,0,76,209,32,317
7103403,0,0,0,79,22,0,101,140,57,298
7103404,0,0,0,97,29,3,129,300,77,506
7103405,3,3,6,51,27,6,84,149,34,267
7103406,0,0,0,102,31,6,139,361,63,563
7103501,0,0,0,0,0,0,0,6,0,6
7103502,0,0,0,42,6,0,48,111,33,192
7103503,0,0,0,97,31,12,140,314,114,568
7103504,3,0,3,87,37,0,124,285,122,531
7103505,0,0,0,96,14,6,116,198,105,419
7103506,0,0,0,88,29,7,124,271,91,486
7103507,0,0,0,60,30,9,99,192,126,417
7103508,0,0,0,35,9,0,44,117,16,177
7103601,0,0,0,115,34,9,158,311,31,500
7103602,0,0,0,68,8,0,76,176,17,269
7103603,0,0,0,101,26,0,127,227,40,394
7103604,0,0,0,128,32,5,165,297,43,505
7103605,0,0,0,80,23,3,106,137,18,261
7103606,0,0,0,106,32,9,147,263,52,462
7103701,0,0,0,111,38,0,149,277,62,488
7103702,3,0,3,121,35,4,160,300,75,535
7103703,0,0,0,85,33,0,118,178,44,340
7103704,0,0,0,78,18,3,99,151,50,300
7103705,0,0,0,79,12,9,100,126,76,302
7103706,0,0,0,52,9,6,67,118,21,206
7103801,0,0,0,138,44,19,201,282,57,540
7103802,3,0,3,119,28,6,153,271,71,495
7103803,0,0,0,137,41,7,185,246,28,459
7103804,0,0,0,115,18,3,136,194,3,333
7103805,0,3,3,95,30,8,133,195,13,341
7103806,0,0,0,45,7,0,52,101,10,163
7103807,0,0,0,12,0,0,12,44,4,60
7103808,0,0,0,3,3,0,6,9,12,27
7103809,0,0,0,77,24,6,107,157,5,269
7103901,0,0,0,43,25,4,72,183,50,305
7103902,0,3,3,52,20,3,75,135,49,259
7103903,0,0,0,73,25,3,101,183,48,332
7103904,0,3,3,76,22,12,110,215,55,380
7103905,3,3,6,93,23,9,125,294,45,464
7103906,0,0,0,100,19,0,119,202,24,345
7103907,0,0,0,106,42,0,148,223,63,434
7104001,3,0,3,52,21,0,73,185,27,285
7104002,0,0,0,61,12,6,79,135,48,262
7104003,0,0,0,104,28,7,139,219,99,457
7104004,0,0,0,94,24,6,124,196,33,353
7104005,4,0,4,78,32,6,116,193,88,397
7104006,0,3,3,110,33,10,153,239,102,494
7104101,0,0,0,70,15,6,91,155,17,263
7104102,0,3,3,99,21,3,123,271,21,415
7104103,21,0,21,317,52,22,391,566,38,995
7104104,0,0,0,3,7,0,10,51,0,61
7104105,0,0,0,80,18,3,101,176,21,298
7104106,0,0,0,94,20,4,118,185,9,312
7104107,0,0,0,62,13,7,82,77,8,167
7104108,0,0,0,112,17,3,132,199,24,355
7104109,0,0,0,47,12,0,59,70,9,138
7104110,0,0,0,6,0,0,6,10,0,16
7104201,0,0,0,0,0,0,0,6,0,6
7104301,0,0,0,78,25,6,109,160,12,281
7104302,4,0,4,76,32,0,108,214,34,356
7104303,0,0,0,38,9,4,51,66,40,157
7104304,0,0,0,104,19,14,137,201,32,370
7104305,3,0,3,273,45,8,326,439,51,816
7104306,0,0,0,210,35,16,261,327,74,662
7104401,3,3,6,121,37,10,168,229,74,471
7104402,0,0,0,125,28,12,165,249,82,496
7104403,0,0,0,68,19,7,94,177,50,321
7104404,3,0,3,31,9,3,43,99,16,158
7104405,0,0,0,38,27,9,74,163,51,288
7104406,0,0,0,148,38,6,192,279,48,519
7104407,0,0,0,74,12,3,89,153,41,283
7104501,0,0,0,3,0,0,3,16,11,30
7104502,3,0,3,81,21,7,109,189,36,334
7104503,0,0,0,56,17,6,79,185,48,312
7104504,3,0,3,95,29,0,124,275,49,448
7104505,0,0,0,78,26,9,113,249,48,410
7104506,0,0,0,7,90,0,97,24,0,121
7104507,0,0,0,44,6,0,50,142,27,219
7104508,0,0,0,53,15,4,72,148,38,258
7104509,0,0,0,80,36,10,126,186,58,370
7104510,0,0,0,23,15,0,38,176,93,307
7104511,0,0,0,52,22,3,77,188,36,301
7104512,0,0,0,25,4,3,32,173,22,227
7104513,0,0,0,25,9,0,34,53,6,93
7104514,0,0,0,6,3,0,9,56,0,65
7104601,3,0,3,36,32,6,74,167,67,308
7104602,0,0,0,30,14,6,50,209,44,303
7104603,0,0,0,79,22,7,108,238,33,379
7104604,0,0,0,42,14,6,62,138,14,214
7104605,0,0,0,64,30,6,100,161,21,282
7104606,0,0,0,58,28,6,92,218,30,340
7104607,0,0,0,6,3,0,9,8,0,17
7104608,0,0,0,65,26,6,97,197,31,325
7104609,0,0,0,78,25,4,107,231,31,369
7104610,0,0,0,59,18,3,80,235,83,398
7104611,3,0,3,55,33,6,94,204,32,330
7104612,0,0,0,106,26,9,141,217,32,390
7104613,0,0,0,38,7,3,48,101,4,153
7104614,0,0,0,21,10,6,37,96,12,145
7104615,0,0,0,43,10,6,59,83,14,156
7104701,0,0,0,0,0,0,0,0,0,0
7104702,0,0,0,8,6,0,14,15,29,58
7104703,4,0,4,97,38,12,147,205,30,382
7104704,0,0,0,91,27,3,121,182,23,326
7104705,0,3,3,103,32,9,144,230,45,419
7104706,6,0,6,79,26,12,117,240,49,406
7104707,3,0,3,90,24,10,124,203,14,341
7104708,0,0,0,64,33,5,102,316,77,495
7104709,0,0,0,115,28,3,146,335,47,528
7104710,0,0,0,110,28,3,141,289,46,476
7104801,0,0,0,0,0,0,0,0,0,0
7104802,0,0,0,81,35,0,116,229,68,413
7104803,0,0,0,82,41,30,153,240,140,533
7104804,3,3,6,91,29,7,127,314,88,529
7104805,0,0,0,70,24,5,99,154,47,300
7104806,0,0,0,89,30,3,122,226,26,374
7104807,0,6,6,158,30,12,200,317,79,596
7104808,0,0,0,54,20,3,77,139,37,253
7104809,0,0,0,64,18,6,88,198,13,299
7104810,0,0,0,62,10,6,78,121,0,199
7104811,0,3,3,77,24,3,104,152,28,284
7104812,0,0,0,0,0,0,0,3,0,3
7104813,0,0,0,0,0,0,0,0,0,0
7104901,0,0,0,27,9,3,39,179,30,248
7104902,0,0,0,15,12,0,27,121,57,205
7104903,3,3,6,87,9,3,99,245,19,363
7104904,3,0,3,106,19,4,129,265,21,415
7104905,3,0,3,60,21,3,84,259,38,381
7104906,0,0,0,0,0,0,0,0,0,0
7104907,0,0,0,57,16,6,79,176,25,280
7104908,0,0,0,47,25,9,81,197,32,310
7104909,0,0,0,33,19,0,52,240,79,371
7104910,3,0,3,69,15,3,87,256,52,395
7105001,0,0,0,9,0,0,9,32,3,44
7105002,3,0,3,79,21,3,103,486,160,749
7105003,0,0,0,39,21,6,66,114,42,222
7105004,0,0,0,39,8,0,47,113,61,221
7105005,4,0,4,39,6,0,45,79,13,137
7105006,0,0,0,22,22,6,50,45,15,110
7105007,0,0,0,22,13,3,38,140,52,230
7105008,0,0,0,6,0,0,6,16,27,49
7105009,0,0,0,0,0,0,0,0,0,0
7105101,0,0,0,73,16,3,92,214,30,336
7105102,0,0,0,0,0,0,0,0,0,0
7105103,0,0,3,17,19,0,36,89,16,141
7105104,7,0,7,49,26,7,82,273,35,390
7105105,0,0,0,56,17,3,76,144,24,244
7105106,7,29,36,36,12,0,48,287,130,465
7105107,3,0,3,22,9,0,31,81,23,135
7105108,3,0,3,0,4,0,4,27,0,31
7105109,0,0,0,16,20,0,36,37,4,77
7105201,0,0,0,15,9,0,24,46,6,76
7105202,0,0,0,0,0,0,0,0,559,559
7105203,0,0,3,29,29,6,64,88,43,195
7105204,3,0,3,93,49,4,146,209,14,369
7105205,0,0,0,0,0,0,0,0,0,0
7105206,3,0,3,20,28,3,51,79,20,150
7105207,0,0,0,39,0,0,39,81,5,125
7105208,0,3,3,3,0,0,3,11,88,102
7105209,0,0,0,78,49,0,127,65,47,239
7105210,0,0,0,21,11,0,32,19,6,57
7105211,0,0,3,19,6,0,25,9,19,53
7105212,0,0,0,12,9,0,21,12,0,33
7105213,6,0,6,116,50,0,166,138,48,352
7105214,0,0,0,0,8,0,8,6,4,18
7105215,0,0,0,19,6,0,25,89,30,144
7105216,3,0,3,57,50,4,111,152,48,311
7105301,0,0,0,40,21,0,61,170,28,259
7105302,0,0,0,27,31,6,64,54,28,146
7105303,0,0,0,45,91,66,202,69,38,309
7105304,0,0,0,9,9,0,18,6,0,24
7105305,0,0,0,41,40,11,92,103,99,294
7105306,0,0,0,38,9,0,47,47,4,98
7105307,0,0,0,17,6,0,23,19,0,42
7105308,0,0,0,24,28,10,62,40,9,111
7105309,0,0,0,6,0,0,6,3,0,9
7105310,0,0,0,25,9,0,34,13,7,54
7105311,0,0,0,0,0,0,0,0,0,0
7105312,0,0,0,38,28,9,75,79,27,181
7105313,6,0,6,125,30,0,155,232,33,420
7105314,0,0,0,45,6,3,54,121,5,180
7105401,6,0,6,115,103,46,264,180,45,489
7105402,0,0,0,0,0,0,0,0,0,0
7105403,0,0,3,24,44,15,83,43,20,146
7105404,0,0,0,17,17,30,64,54,18,136
7105405,0,0,0,44,61,0,105,66,12,183
7105406,0,0,0,15,10,0,25,69,9,103
7105407,0,0,0,26,3,0,29,89,6,124
7105408,0,0,0,27,3,0,30,30,6,66
7105409,0,0,0,19,18,0,37,40,12,89
7105410,3,0,3,24,10,0,34,86,12,132
7105501,0,0,0,12,3,0,15,90,18,123
7105502,0,0,0,18,4,4,26,182,29,237
7105503,0,0,0,34,16,0,50,152,46,248
7105504,3,0,3,77,59,12,148,153,56,357
7105505,0,0,0,51,8,0,59,69,12,140
7105506,0,0,0,33,30,0,63,58,0,121
7105507,6,0,6,48,76,34,158,156,3,317
7105508,0,0,0,20,23,0,43,10,0,53
7105509,0,0,0,6,4,3,13,13,10,36
7105510,3,0,3,62,12,0,74,116,59,249
7105601,4,0,4,21,9,0,30,154,42,226
7105602,0,0,0,44,35,6,85,234,58,377
7105603,0,0,0,102,35,8,145,235,65,445
7105604,0,0,0,70,38,11,119,233,49,401
7105605,3,0,3,51,45,0,96,111,74,281
7105606,0,3,3,23,17,0,40,65,69,174
7105607,0,0,0,0,3,0,3,7,3,13
7105608,0,0,0,15,12,0,27,24,38,89
7105609,0,0,0,12,3,0,15,55,36,106
7105610,4,0,4,48,20,0,68,108,43,219
7105611,0,0,0,0,0,0,0,0,0,0
7105701,0,0,0,3,25,0,28,11,3,42
7105702,0,0,0,11,41,0,52,65,10,127
7105703,0,0,0,46,26,0,72,221,31,324
7105704,0,0,0,43,14,0,57,102,23,182
7105705,0,0,0,87,12,0,99,186,41,326
7105706,0,0,0,20,6,6,32,88,23,143
7105707,0,0,0,54,18,4,76,128,24,228
7105708,0,0,0,50,17,0,67,345,72,484
7105709,0,0,0,71,22,6,99,240,56,395
7105710,0,0,0,28,12,6,46,147,81,274
7105711,0,0,0,64,16,3,83,280,79,442
7105712,0,0,0,15,18,0,33,124,27,184
7105713,0,0,0,33,23,0,56,165,50,271
7105801,0,0,0,72,47,3,122,168,9,299
7105802,0,0,0,20,19,6,45,7,3,55
7105803,0,0,0,54,27,9,90,173,26,289
7105804,0,0,0,121,28,0,149,81,6,236
7105805,0,0,0,40,14,3,57,56,8,121
7105806,0,0,0,16,3,0,19,31,0,50
7105807,0,0,0,36,0,0,36,87,6,129
7105808,0,0,0,30,7,0,37,98,33,168
7105901,3,0,3,440,344,132,916,381,38,1335
7105902,0,0,0,39,38,9,86,26,6,118
7106001,0,0,0,18,11,0,29,21,3,53
7106002,0,0,0,17,14,0,31,54,3,88
7106003,0,0,0,250,131,24,405,671,34,1110
7106004,0,0,0,62,30,0,92,166,14,272
7106005,0,0,0,69,53,12,134,169,9,312
7106101,3,0,3,199,130,61,390,374,48,812
7106102,3,0,3,25,79,52,156,34,10,200
7106103,0,3,9,253,581,369,1203,314,76,1593
7106104,0,0,0,47,84,32,163,17,0,180
7106105,0,0,0,3,19,15,37,0,0,37
7106106,0,0,0,6,16,15,37,12,0,49
7106107,0,0,6,13,28,15,56,39,6,101
7106108,0,0,0,16,92,96,204,52,6,262
7106201,0,0,0,29,21,0,50,75,6,131
7106202,0,0,0,82,9,3,94,210,13,317
7106203,0,0,0,107,45,0,152,152,6,310
7106204,0,0,0,3,3,0,6,11,0,17
7106205,3,0,3,154,153,15,322,223,22,567
7106206,0,0,0,78,11,4,93,83,6,182
7106207,0,0,0,58,10,0,68,150,40,258
7106208,0,0,0,0,0,0,0,0,0,0
7106209,0,0,0,17,14,3,34,41,12,87
7106301,0,0,0,24,60,48,132,23,0,155
7106302,0,0,0,16,37,0,53,64,3,120
7106303,0,0,0,66,88,50,204,380,28,612
7106304,0,0,0,15,36,6,57,133,12,202
7106305,0,0,0,88,355,98,541,178,18,737
7106306,0,0,0,3,6,0,9,9,0,18
7106307,6,0,6,246,555,194,995,331,48,1374
7106308,3,0,3,158,89,9,256,287,101,644
7106309,0,0,0,105,236,91,432,157,10,599
7106310,0,0,0,16,51,29,96,122,13,231
7106311,0,0,0,22,30,12,64,45,9,118
7106312,0,0,0,22,10,0,32,25,20,77
7106313,0,0,0,6,9,0,15,71,6,92
7106314,0,0,0,0,18,0,18,29,0,47
7106315,0,0,0,6,21,0,27,47,6,80
7106316,0,0,0,0,0,0,0,4,0,4
7106317,0,0,0,0,3,0,3,18,0,21
7106401,0,0,0,8,0,0,8,94,17,119
7106402,0,0,0,87,28,0,115,205,25,345
7106403,0,0,0,163,22,10,195,433,119,747
7106404,0,0,0,161,24,8,193,221,44,458
7106405,0,0,0,190,24,4,218,167,14,399
7106406,0,0,0,182,19,16,217,125,24,366
7106407,0,0,0,171,29,6,206,103,15,324
7106501,0,0,0,53,40,13,106,106,3,215
7106502,4,0,4,84,77,38,199,147,6,352
7106503,0,0,0,13,10,3,26,48,15,89
7106504,0,0,0,55,62,14,131,57,4,192
7106505,0,0,0,16,19,12,47,21,6,74
7106506,0,3,3,28,9,6,43,104,54,201
7106507,0,0,0,12,110,0,122,30,9,161
7106508,0,0,0,24,8,0,32,115,19,166
7106601,0,0,0,37,22,3,62,175,42,279
7106602,0,0,0,40,33,0,73,181,82,336
7106603,0,0,0,4,0,0,4,31,4,39
7106604,3,3,9,74,94,30,198,204,73,475
7106605,0,0,0,4,0,0,4,19,17,40
7106606,3,0,6,116,71,0,187,89,12,288
7106607,0,0,0,19,4,15,38,13,0,51
7106608,0,0,6,179,158,86,423,245,26,694
7106609,0,0,0,0,0,0,0,0,0,0
7106610,0,0,0,0,0,3,3,0,0,3
7106611,0,0,0,33,22,0,55,95,4,154
7106612,0,0,0,18,6,0,24,86,13,123
7106613,0,0,0,3,3,0,6,135,4,145
7106614,0,0,0,0,12,0,12,3,93,108
7106701,6,0,6,60,33,0,93,245,37,375
7106702,0,0,0,81,28,4,113,279,61,453
7106703,0,0,0,45,16,6,67,197,51,315
7106704,0,0,0,58,23,3,84,211,131,426
7106705,0,0,0,48,19,6,73,187,41,301
7106706,0,0,0,48,15,0,63,130,37,230
7106707,0,0,0,103,24,0,127,228,30,385
7106708,10,0,10,58,23,3,84,289,39,412
7106709,0,0,0,26,15,0,41,75,15,131
7106710,0,0,0,3,0,0,3,23,3,29
7106711,0,0,0,66,25,3,94,137,12,243
7106712,3,0,3,41,20,9,70,142,21,233
7106713,0,0,0,32,7,0,39,33,6,78
7106714,0,0,0,44,16,0,60,85,11,156
7106715,0,0,0,56,13,3,72,182,39,293
7106716,0,0,0,34,14,0,48,182,16,246
7106717,0,0,0,174,18,14,206,260,37,503
7106718,0,0,0,44,16,6,66,160,28,254
7106719,0,0,0,154,31,14,199,240,18,457
7106720,0,0,0,50,18,3,71,160,75,306
7106721,0,0,0,6,3,0,9,13,12,34
7106722,0,0,0,81,19,4,104,196,58,358
7106723,3,0,3,48,16,9,73,139,23,235
7106724,0,0,0,56,17,3,76,180,19,275
7106725,0,0,0,35,15,0,50,86,35,171
7106801,0,0,0,13,6,0,19,34,24,77
7106802,0,0,0,28,6,0,34,113,18,165
7106803,0,0,0,12,24,0,36,21,3,60
7106804,0,0,0,27,15,7,49,14,0,63
7106805,0,0,0,44,21,0,65,36,10,111
7106806,0,0,0,56,41,0,97,122,27,246
7106807,0,0,0,101,98,46,245,122,38,405
7106808,0,0,0,13,6,0,19,83,18,120
7106809,0,0,0,59,39,0,98,73,4,175
7106810,3,0,3,9,18,9,36,37,8,81
7106811,0,0,0,15,0,0,15,43,0,58
7106812,0,0,0,30,4,0,34,81,9,124
7949999,0,0,0,123,79,3,205,1256,263,1724
7979991,0,0,0,0,0,0,0,0,0,0
7979992,0,0,0,0,0,0,0,0,0,0
7979993,0,0,0,6,0,0,6,91,10,107
8100101,44,0,44,32,18,5,55,216,22,293
8100102,0,0,0,74,32,0,106,137,35,278
8100103,3,0,3,50,30,0,80,164,6,250
8100104,7,3,10,87,31,0,118,238,41,397
8100105,4,0,4,92,46,0,138,281,9,428
8100106,4,0,4,73,34,6,113,254,18,385
8100201,3,0,3,58,6,3,67,319,58,444
8100202,3,0,3,44,12,0,56,197,45,298
8100203,0,0,0,26,16,6,48,346,30,424
8100204,0,0,0,0,0,3,3,9,0,12
8100205,0,0,0,0,0,0,0,0,0,0
8100206,0,0,0,32,18,0,50,339,78,467
8100207,0,0,0,20,27,0,47,399,120,566
8100208,0,0,0,47,12,0,59,248,55,362
8100209,0,0,0,41,9,3,53,176,33,262
8100210,3,0,3,28,20,0,48,271,23,342
8100211,0,0,0,68,28,0,96,344,42,482
8100212,42,48,90,16,36,3,55,281,88,424
8100301,0,0,0,33,4,0,37,255,34,326
8100302,31,58,89,58,32,0,90,324,130,544
8100303,8,0,8,66,82,0,148,395,49,592
8100304,0,0,0,55,6,0,61,120,9,190
8100305,0,0,0,84,11,11,106,391,70,567
8100306,3,3,6,36,23,0,59,286,10,355
8100307,0,0,0,29,18,4,51,152,9,212
8100308,0,0,0,0,50,0,50,764,488,1302
8100309,0,0,0,32,6,0,38,186,15,239
8100310,0,0,0,29,3,0,32,170,3,205
8100311,0,0,0,37,16,3,56,170,18,244
8100312,0,0,0,69,15,0,84,238,20,342
8100313,0,0,0,33,20,0,53,402,69,524
8100314,4,0,4,3,3,0,6,126,9,141
8100401,3,0,6,48,19,3,70,120,6,196
8100402,6,0,6,72,34,3,109,240,18,367
8100403,3,3,6,78,15,8,101,203,53,357
8100404,3,0,3,63,24,0,87,163,23,273
8100405,0,0,0,73,33,3,109,214,12,335
8100406,6,0,6,89,28,8,125,285,36,446
8100407,6,0,6,85,25,6,116,265,36,417
8100501,6,3,9,46,17,0,63,168,12,243
8100502,3,0,3,75,30,0,105,206,23,334
8100503,3,0,3,64,21,0,85,176,15,276
8100504,0,0,0,49,15,0,64,190,6,260
8100505,13,0,13,56,18,0,74,245,21,340
8100506,8,0,8,20,18,3,41,114,9,164
8100507,3,3,6,60,27,6,93,173,18,284
8100508,3,0,3,46,9,3,58,114,3,175
8100509,0,0,0,66,30,3,99,210,19,328
8100601,3,0,3,182,44,6,232,304,37,573
8100602,0,0,0,41,12,6,59,85,15,159
8100603,0,0,0,147,29,3,179,280,18,477
8100604,0,0,0,64,13,9,86,127,0,213
8100605,0,0,0,105,20,6,131,162,3,296
8100606,0,0,0,79,21,0,100,129,12,241
8100607,0,0,0,102,26,5,133,202,6,341
8100608,0,0,0,83,29,0,112,207,12,331
8100609,3,0,3,76,31,6,113,149,6,268
8100610,0,0,0,76,11,6,93,160,15,268
8100611,0,3,3,80,32,3,115,225,29,369
8100612,0,0,0,125,36,6,167,214,13,394
8100613,0,0,0,62,5,0,67,108,12,187
8100614,0,0,0,69,12,3,84,159,9,252
8100615,0,0,0,35,10,4,49,97,13,159
8100616,0,0,0,125,24,3,152,204,3,359
8100617,0,0,0,99,23,0,122,217,9,348
8100701,3,3,6,100,34,10,144,244,15,403
8100702,0,0,0,47,6,0,53,131,15,199
8100703,3,0,3,84,37,3,124,283,4,411
8100704,3,0,3,33,22,0,55,103,6,164
8100705,3,0,3,86,29,3,118,222,15,355
8100706,6,0,6,58,19,6,83,223,9,315
8100707,0,0,0,82,49,4,135,232,6,373
8100708,0,0,0,47,31,3,81,154,13,248
8100709,3,0,3,65,21,0,86,167,12,265
8100710,3,0,3,66,18,4,88,207,6,301
8100711,3,3,6,118,36,8,162,284,27,473
8100712,0,0,0,79,34,12,125,174,19,318
8100713,0,0,0,73,24,0,97,129,12,238
8100714,3,0,3,51,20,4,75,135,12,222
8100801,6,0,6,54,23,0,77,226,9,312
8100802,3,0,3,83,34,0,117,267,15,399
8100803,0,0,0,73,22,0,95,252,10,357
8100804,3,0,3,42,7,0,49,169,18,236
8100805,0,0,0,84,31,6,121,239,29,389
8100806,0,0,0,62,36,0,98,192,6,296
8100807,6,3,9,100,39,3,142,365,20,527
8100808,4,0,4,39,15,0,54,212,51,317
8100809,3,0,3,76,27,6,109,335,11,455
8100810,5,0,5,70,35,0,105,168,12,285
8100811,5,0,5,48,15,0,63,135,0,198
8100812,0,3,3,62,36,10,108,223,13,344
8100901,0,3,3,70,32,7,109,170,23,302
8100902,0,0,0,43,22,0,65,140,11,216
8100903,6,0,6,67,35,3,105,196,58,359
8100904,3,0,3,67,22,3,92,187,0,279
8100905,8,0,8,58,17,6,81,179,11,271
8100906,3,0,3,74,41,3,118,262,16,396
8100907,0,0,0,44,17,4,65,145,31,241
8100908,0,0,0,55,27,3,85,178,0,263
8100909,0,0,0,50,22,8,80,115,27,222
8100910,0,0,0,52,23,3,78,171,58,307
8101001,6,0,6,70,27,0,97,197,3,297
8101002,0,0,0,72,30,13,115,182,0,297
8101003,0,0,0,90,46,11,147,201,5,353
8101004,0,0,0,55,35,3,93,200,3,296
8101005,0,0,0,82,52,6,140,285,15,440
8101101,0,3,3,98,22,11,131,359,26,516
8101102,5,0,5,57,23,6,86,198,7,291
8101103,4,0,4,103,39,6,148,345,15,508
8101104,3,0,3,76,34,4,114,253,10,377
8101105,0,3,3,42,35,3,80,137,24,241
8101106,0,0,0,40,24,0,64,111,21,196
8101107,0,0,0,0,0,0,0,0,0,0
8101108,3,0,3,27,24,0,51,106,4,161
8101109,0,0,0,39,24,0,63,142,3,208
8101110,3,3,6,39,15,3,57,137,15,209
8101201,0,0,0,0,0,0,0,0,3,3
8101301,8,0,8,20,14,3,37,142,6,185
8101302,3,0,3,79,23,0,102,292,54,448
8101303,3,0,3,60,39,3,102,172,9,283
8101304,3,0,3,52,21,0,73,156,12,241
8101305,3,0,3,57,46,3,106,233,3,342
8101306,3,0,3,58,32,7,97,168,6,271
8101307,10,0,10,16,12,0,28,151,6,185
8101308,0,0,0,40,37,7,84,144,3,231
8101309,0,0,0,0,0,0,0,0,0,0
8101310,3,3,6,29,24,5,58,131,21,210
8101401,6,0,6,46,11,0,57,141,21,219
8101402,3,3,6,98,24,3,125,234,18,377
8101403,3,0,3,104,50,10,164,289,15,468
8101404,0,0,0,88,38,15,141,247,11,399
8101405,0,0,0,80,36,6,122,184,0,306
8101406,0,0,0,49,27,0,76,121,11,208
8101407,0,3,3,100,46,6,152,278,29,459
8101501,3,0,3,102,65,3,170,368,18,556
8101502,0,0,0,38,22,9,69,143,7,219
8101503,0,3,3,67,23,0,90,148,17,255
8101504,0,0,0,50,25,3,78,195,20,293
8101505,4,0,7,89,33,9,131,245,15,391
8101506,12,0,12,63,21,0,84,188,3,275
8101507,64,7,71,87,33,0,120,416,73,609
8101508,6,0,6,66,27,3,96,158,3,257
8101509,0,0,0,81,23,7,111,173,14,298
8101510,8,0,8,56,36,3,95,196,12,303
8101511,0,0,0,54,9,3,66,125,12,203
8101512,3,0,3,51,18,6,75,144,24,243
8101601,3,0,3,62,19,7,88,252,18,358
8101602,0,0,0,28,18,0,46,115,3,164
8101603,3,3,6,48,43,4,95,296,14,405
8101604,0,0,0,82,33,0,115,215,3,333
8101605,0,0,0,66,19,0,85,219,19,323
8101606,3,0,3,88,20,5,113,256,12,381
8101607,6,0,6,48,19,3,70,137,6,213
8101608,0,0,0,0,0,0,0,0,0,0
8101609,3,0,3,69,24,6,99,279,9,387
8101610,3,0,3,32,15,6,53,141,9,203
8101611,3,0,6,56,23,6,85,202,12,299
8101612,0,0,0,78,49,3,130,295,15,440
8101613,10,3,13,49,18,0,67,268,22,357
8101614,3,0,3,61,36,3,100,248,9,357
8101615,0,3,3,67,33,6,106,278,16,400
8101616,0,0,0,71,52,3,126,268,17,411
8101617,6,3,9,68,27,5,100,221,20,341
8101618,0,3,3,61,22,6,89,234,3,326
8101619,3,0,3,77,29,6,112,226,9,347
8101701,3,0,3,62,40,6,108,128,9,245
8101702,4,0,4,91,40,10,141,277,20,438
8101703,0,4,4,98,66,3,167,301,12,480
8101704,3,0,3,48,24,3,75,152,12,239
8101705,6,0,6,56,22,0,78,188,22,288
8101706,0,0,0,113,35,10,158,261,17,436
8101707,7,0,7,73,44,0,117,213,25,355
8101708,0,0,0,27,24,0,51,89,6,146
8101709,3,0,3,52,35,4,91,179,9,279
8101801,0,0,0,0,0,0,0,0,0,0
8101901,0,0,0,112,20,0,132,247,11,390
8101902,0,0,0,124,24,3,151,302,14,467
8101903,0,0,0,27,4,0,31,81,0,112
8101904,0,0,0,93,27,0,120,185,9,314
8101905,0,0,0,87,12,10,109,240,21,370
8101906,0,0,0,45,24,6,75,167,12,254
8101907,0,0,0,97,53,12,162,255,7,424
8101908,3,0,3,79,38,10,127,276,10,413
8101909,0,0,0,76,58,0,134,182,12,328
8101910,0,3,3,74,38,0,112,158,15,285
8101911,3,0,3,81,39,10,130,217,22,369
8101912,6,0,6,49,21,9,79,205,9,293
8101913,4,0,4,80,33,6,119,185,13,317
8102001,5,0,5,55,21,3,79,138,15,232
8102002,3,0,3,57,24,3,84,199,15,298
8102003,3,0,3,53,32,0,85,129,9,223
8102004,3,0,3,42,15,6,63,143,9,215
8102005,3,0,6,46,19,0,65,222,28,315
8102006,8,0,8,45,29,0,74,144,15,233
8102007,6,0,6,53,17,3,73,207,20,300
8102008,3,0,3,63,17,4,84,229,0,313
8102101,3,0,3,87,53,3,143,344,21,508
8102102,0,0,0,66,41,0,107,212,0,319
8102103,3,0,3,79,51,0,130,314,31,475
8102104,0,0,0,91,41,3,135,272,7,414
8102105,0,0,0,123,53,8,184,351,18,553
8102201,3,0,3,45,26,3,74,106,3,183
8102202,0,0,0,47,39,0,86,143,3,232
8102203,10,0,10,60,29,5,94,274,21,389
8102204,3,3,6,101,44,7,152,248,34,434
8102205,4,0,4,91,41,8,140,296,17,453
8102206,4,0,4,63,25,6,94,131,15,240
8102207,6,0,6,90,41,6,137,216,16,369
8102208,0,0,0,49,7,3,59,190,12,261
8102301,6,0,6,73,28,3,104,279,15,398
8102302,3,0,3,41,24,6,71,132,3,206
8102303,9,0,9,61,22,13,96,253,16,365
8102304,4,0,4,59,27,6,92,255,28,375
8102305,0,0,0,56,24,6,86,155,12,253
8102306,6,0,6,64,23,0,87,206,18,311
8102307,143,47,190,21,22,0,43,390,101,534
8102401,4,0,4,44,18,6,68,133,12,213
8102402,6,0,6,82,35,0,117,246,23,386
8102403,3,0,3,53,29,3,85,205,6,296
8102404,6,0,6,46,21,3,70,148,4,222
8102405,4,0,4,40,20,0,60,148,11,219
8102406,0,0,0,72,33,6,111,211,28,350
8102407,0,0,0,42,13,0,55,141,24,220
8102408,6,0,6,85,31,3,119,256,24,399
8102501,4,0,4,61,13,0,74,166,24,264
8102502,0,0,0,81,19,6,106,214,18,338
8102503,4,0,4,89,26,9,124,253,27,404
8102504,0,0,0,83,27,0,110,225,17,352
8102505,3,0,3,49,20,0,69,142,6,217
8102506,0,0,0,77,57,3,137,281,18,436
8102601,6,0,6,55,39,0,94,169,9,272
8102602,3,0,3,30,6,3,39,107,12,158
8102603,3,0,3,86,30,4,120,182,12,314
8102604,3,0,3,86,21,11,118,211,14,343
8102605,6,0,6,45,9,0,54,134,12,200
8102606,8,0,8,82,53,3,138,293,18,449
8102607,0,0,0,72,20,0,92,214,10,316
8102701,0,0,0,86,28,6,120,238,20,378
8102801,0,0,0,3,0,3,6,21,0,27
8102901,0,0,0,0,0,0,0,23,0,23
8103001,0,0,0,14,15,5,34,186,63,283
8103002,0,0,0,36,15,3,54,159,13,226
8103003,0,0,0,6,3,0,9,28,7,44
8103004,0,0,0,0,0,0,0,12,3,15
8103005,0,3,3,19,12,0,31,178,32,241
8103006,0,0,0,3,0,0,3,9,0,12
8103101,0,0,0,0,0,0,0,6,302,308
8103201,0,0,0,9,0,0,9,20,0,29
8103301,0,3,3,46,19,0,65,124,10,199
8103401,4,0,4,87,19,7,113,155,16,284
8103402,0,0,0,65,15,3,83,71,9,163
8103403,0,0,0,89,29,0,118,200,17,335
8103404,3,0,3,107,16,6,129,168,9,306
8103405,0,0,0,140,11,3,154,150,0,304
8103406,0,3,3,65,16,7,88,208,18,314
8103407,3,3,6,74,14,0,88,110,6,204
8103408,0,0,0,106,31,3,140,209,9,358
8103409,0,0,0,75,5,0,80,100,3,183
8103410,0,0,0,138,28,0,166,155,4,325
8103411,0,3,3,151,21,6,178,208,9,395
8103412,0,0,0,128,20,9,157,139,0,296
8103413,0,0,0,93,23,3,119,188,9,316
8103414,0,0,0,67,3,3,73,72,6,151
8103501,0,0,0,57,18,0,75,99,8,182
8103502,0,0,0,128,22,0,150,166,6,322
8103503,0,0,0,112,17,0,129,207,7,343
8103504,0,0,0,73,12,0,85,129,6,220
8103601,0,0,0,78,7,0,85,174,18,277
8103602,0,0,0,113,14,0,127,235,8,370
8103603,3,0,3,129,34,0,163,313,28,504
8103701,0,0,0,113,24,3,140,319,7,466
8103801,0,0,0,209,50,3,262,415,23,700
8103802,0,0,0,235,37,3,275,294,25,594
8103803,0,0,0,131,17,15,163,176,11,350
8103901,0,0,0,112,17,0,129,290,20,439
8103902,3,0,3,176,29,7,212,330,29,571
8103903,0,0,0,167,35,0,202,281,25,508
8103904,0,0,0,106,15,3,124,270,6,400
8103905,0,0,0,101,21,3,125,324,34,483
8103906,0,0,0,160,25,4,189,289,45,523
8104001,0,0,0,89,24,3,116,300,41,457
8104002,3,0,3,74,14,0,88,147,9,244
8104003,0,0,0,93,11,9,113,325,10,448
8104004,0,0,0,165,36,6,207,295,6,508
8104005,6,0,6,84,19,9,112,167,14,293
8104006,0,0,0,58,12,5,75,141,0,216
8104007,0,0,0,110,28,4,142,195,19,356
8104008,0,0,0,124,13,6,143,208,27,378
8104009,0,0,0,107,17,3,127,319,81,527
8104010,0,0,0,68,19,3,90,320,18,428
8104011,0,0,0,0,0,0,0,0,0,0
8104012,3,0,3,102,9,0,111,370,33,514
8104101,0,0,0,3,6,0,9,26,0,35
8104201,0,0,0,0,0,0,0,6,0,6
8104301,3,0,6,52,25,0,77,165,13,255
8104401,0,0,0,115,27,3,145,220,26,391
8104402,0,0,0,119,30,4,153,238,23,414
8104403,0,0,0,175,30,0,205,293,41,539
8104404,0,0,0,137,9,13,159,198,23,380
8104405,4,0,4,134,15,8,157,135,12,304
8104406,3,0,3,159,22,16,197,243,20,460
8104407,0,0,0,0,0,0,0,0,0,0
8104408,0,0,0,149,15,3,167,248,6,421
8104409,0,0,0,74,6,3,83,134,19,236
8104501,0,0,0,0,0,0,0,6,0,6
8104601,0,0,0,45,15,0,60,112,11,183
8104602,3,0,3,73,16,0,89,253,9,351
8104603,3,0,3,42,15,6,63,118,8,189
8104604,0,0,0,56,19,3,78,129,6,213
8104605,4,0,4,56,10,3,69,119,6,194
8104606,0,0,0,71,20,6,97,171,6,274
8104607,0,4,7,35,18,6,59,124,4,187
8104608,3,0,3,121,25,3,149,218,29,396
8104609,0,0,0,59,15,6,80,123,11,214
8104610,0,0,0,138,18,3,159,257,21,437
8104611,0,0,0,128,28,8,164,315,7,486
8104612,0,0,0,43,4,0,47,117,6,170
8104613,0,0,0,88,24,8,120,174,7,301
8104614,0,0,0,53,18,10,81,119,6,206
8104615,3,0,3,143,35,7,185,277,26,488
8104616,3,0,3,44,9,3,56,103,0,159
8104617,0,0,0,113,17,3,133,208,21,362
8104618,0,0,0,93,21,4,118,145,18,281
8104619,0,0,0,53,17,5,75,130,9,214
8104620,0,0,0,76,10,0,86,155,31,272
8104621,0,0,0,60,26,0,86,168,18,272
8104622,0,0,0,69,12,3,84,145,13,242
8104623,0,0,0,103,30,0,133,270,20,423
8104624,0,0,0,0,0,0,0,0,0,0
8104625,0,3,3,83,17,6,106,179,21,306
8104701,0,0,0,42,21,0,63,160,6,229
8104702,3,0,3,48,36,4,88,211,15,314
8104703,0,0,0,98,28,8,134,235,11,380
8104704,4,0,4,54,15,4,73,119,15,207
8104705,3,0,3,76,24,7,107,219,12,338
8104706,0,0,0,69,22,0,91,166,18,275
8104707,0,0,0,45,9,3,57,96,6,159
8104708,3,0,3,61,28,0,89,155,9,253
8104709,4,0,4,33,30,0,63,146,4,213
8104710,3,0,3,87,18,6,111,232,9,352
8104711,0,0,0,117,25,9,151,219,14,384
8104712,0,0,0,48,15,0,63,139,18,220
8104713,0,0,0,90,31,3,124,205,6,335
8104714,0,0,0,0,0,0,0,0,0,0
8104715,0,0,0,48,27,0,75,171,6,252
8104716,0,0,0,74,37,3,114,191,21,326
8104717,0,0,0,99,34,0,133,241,12,386
8104718,0,0,0,97,31,0,128,211,16,355
8104719,3,0,3,81,33,7,121,243,4,368
8104801,0,0,0,78,11,0,89,162,7,258
8104802,6,0,6,115,37,0,152,228,15,395
8104803,0,0,0,54,26,3,83,180,6,269
8104804,0,0,3,73,18,0,91,214,18,323
8104805,0,0,0,81,9,10,100,283,36,419
8104806,0,0,0,65,15,3,83,169,5,257
8104807,3,0,3,54,17,4,75,162,15,252
8104808,3,0,3,61,12,4,77,216,12,305
8104809,3,0,3,71,39,13,123,264,13,400
8104810,4,0,4,52,17,4,73,155,15,243
8104811,0,0,0,72,24,7,103,202,4,309
8104812,0,3,3,98,26,11,135,282,15,432
8104813,0,0,0,50,10,0,60,148,8,216
8104814,0,0,0,96,22,0,118,302,12,432
8104901,0,0,0,9,36,0,45,1761,146,1952
8104902,0,0,0,0,0,0,0,0,0,0
8104903,0,0,0,0,0,0,0,0,0,0
8105001,8,3,11,65,24,0,89,251,29,369
8105002,15,3,18,52,17,3,72,177,8,257
8105003,0,0,0,0,0,0,0,0,0,0
8105004,0,0,0,34,15,0,49,150,5,204
8105005,4,9,13,80,32,5,117,255,22,394
8105006,7,0,10,46,12,0,58,277,26,361
8105007,0,0,3,48,16,9,73,167,3,243
8105008,0,0,0,33,20,0,53,127,18,198
8105009,77,48,125,35,22,0,57,346,121,524
8105010,8,3,11,69,17,0,86,207,18,311
8105011,7,0,7,95,26,11,132,293,14,439
8105012,0,0,0,84,25,5,114,202,17,333
8105013,3,0,3,95,30,9,134,253,17,404
8105014,4,0,4,43,17,3,63,143,11,217
8105101,3,0,3,63,9,0,72,260,102,434
8105102,9,0,9,37,24,3,64,313,51,428
8105103,8,3,11,58,31,0,89,585,51,725
8105104,0,0,0,0,0,0,0,3,6,9
8105105,0,0,0,14,12,0,26,267,70,363
8105106,0,0,0,26,4,0,30,292,104,426
8105107,6,0,6,18,26,0,44,417,50,511
8105108,0,0,0,21,13,0,34,826,43,903
8105109,0,0,3,35,24,3,62,397,27,486
8105201,8,6,14,55,19,0,74,321,65,460
8105202,3,3,6,41,15,9,65,226,28,319
8105203,8,0,8,65,23,0,88,247,17,352
8105204,0,0,0,110,28,8,146,1354,82,1582
8105205,11,0,11,67,26,5,98,229,13,340
8105206,14,0,14,87,39,4,130,349,15,494
8105207,8,0,8,51,12,0,63,262,16,341
8105208,41,4,45,44,28,9,81,350,20,451
8105209,0,0,0,0,0,0,0,0,0,0
8105301,3,4,7,22,20,0,42,269,62,373
8105302,0,0,0,17,18,4,39,333,38,410
8105303,0,0,0,0,20,0,20,1271,133,1424
8105304,0,0,0,30,28,3,61,417,84,562
8105401,8,0,8,59,8,0,67,352,33,452
8105402,14,3,17,111,35,10,156,366,31,553
8105403,0,0,0,59,15,4,78,386,37,501
8105404,4,4,8,61,21,6,88,222,19,329
8105501,6,0,6,66,20,6,92,253,19,364
8105502,8,0,8,52,15,3,70,179,3,252
8105503,12,3,15,61,13,12,86,199,25,310
8105504,7,0,7,51,19,4,74,210,23,307
8105505,0,0,0,40,9,6,55,177,18,250
8105506,4,0,4,58,26,5,89,221,24,334
8105507,9,0,12,81,30,0,111,210,25,346
8105508,6,0,6,71,36,7,114,344,34,492
8105509,6,0,6,48,14,8,70,216,12,298
8105601,11,0,11,89,38,0,127,277,12,416
8105602,10,0,10,95,30,4,129,260,19,408
8105603,3,4,10,75,28,0,103,268,13,384
8105604,6,0,6,61,30,0,91,189,18,298
8105605,5,0,5,87,37,3,127,220,17,364
8105606,0,0,0,38,18,3,59,125,0,184
8105607,9,0,9,73,34,3,110,187,6,303
8105701,8,0,8,44,34,0,78,261,12,351
8105702,6,0,6,46,10,0,56,144,9,209
8105703,6,0,6,45,14,0,59,177,15,251
8105704,6,0,6,23,24,0,47,195,31,273
8105705,3,3,6,42,47,0,89,298,60,447
8105706,69,36,108,20,10,0,30,341,122,493
8105707,6,7,13,91,37,15,143,324,26,493
8105708,7,0,7,71,30,9,110,246,33,389
8105709,3,0,3,45,24,3,72,297,30,399
8105710,4,0,4,32,16,0,48,275,84,407
8105711,0,0,0,27,14,0,41,230,14,285
8105801,6,0,6,122,22,5,149,242,21,412
8105802,12,3,15,72,27,3,102,242,33,377
8105803,0,3,3,28,6,3,37,168,18,223
8105804,9,3,12,54,9,4,67,192,27,286
8105805,8,0,8,40,12,3,55,137,12,204
8105806,4,0,4,39,15,3,57,174,18,249
8105807,11,0,11,95,22,6,123,296,23,442
8105808,6,0,9,91,42,8,141,301,18,460
8105809,3,0,3,61,14,6,81,187,11,279
8105810,4,0,4,53,12,0,65,173,18,256
8105811,9,6,15,68,18,6,92,298,19,409
8105812,0,3,3,58,20,6,84,228,12,324
8105813,0,4,4,56,16,0,72,345,32,449
8105814,0,0,0,0,0,0,0,0,0,0
8105901,6,3,9,32,10,0,42,217,66,325
8105902,5,0,5,47,18,9,74,367,72,513
8105903,13,3,16,44,20,6,70,241,16,327
8105904,3,3,6,44,21,3,68,159,15,242
8106001,10,0,10,59,9,0,68,264,21,353
8106002,3,0,6,24,30,0,54,521,57,632
8106003,3,0,3,39,19,4,62,374,12,448
8106004,3,0,3,21,30,0,51,503,46,600
8106005,0,0,0,37,10,0,47,429,135,611
8106006,6,3,9,66,25,6,97,253,35,385
8106007,3,0,3,46,19,3,68,225,9,302
8106101,3,0,3,66,12,6,84,238,30,352
8106102,11,0,11,57,5,13,75,188,15,278
8106103,0,0,0,59,18,0,77,261,6,344
8106104,0,0,0,146,35,7,188,352,28,568
8106105,0,0,0,0,3,0,3,6,0,9
8106106,0,0,0,39,0,5,44,143,6,193
8106107,6,0,6,49,15,3,67,175,16,258
8106108,6,0,6,77,24,7,108,285,27,420
8106109,9,0,9,76,21,6,103,183,18,304
8106110,9,0,9,52,22,10,84,170,18,272
8106111,8,3,11,51,21,6,78,148,21,247
8106112,4,0,4,57,15,0,72,128,27,227
8106113,0,0,0,35,18,3,56,181,15,252
8106114,0,0,0,33,18,3,54,441,18,513
8106201,57,8,65,32,19,0,51,272,26,349
8106202,10,3,13,65,34,0,99,282,21,402
8106203,0,3,3,0,0,0,0,3,3,6
8106204,4,0,4,54,23,0,77,173,15,265
8106205,15,0,15,73,16,4,93,230,36,359
8106206,6,0,9,57,21,0,78,110,10,198
8106207,9,0,9,55,22,3,80,173,24,277
8106208,3,3,6,60,15,0,75,125,6,206
8106209,12,0,12,41,13,0,54,161,10,225
8106301,9,0,9,45,28,0,73,380,63,516
8106302,3,0,3,47,22,0,69,128,6,203
8106303,4,0,4,57,31,0,88,223,21,332
8106304,7,0,7,49,18,0,67,140,3,210
8106401,6,3,9,14,8,0,22,221,36,279
8106402,13,0,13,81,43,12,136,285,16,437
8106403,9,0,9,34,6,6,46,125,6,177
8106404,0,0,0,34,6,3,43,224,12,279
8106405,13,0,13,66,29,3,98,313,5,416
8106406,23,0,23,84,44,9,137,338,27,502
8106407,7,0,7,52,11,0,63,115,0,178
8106408,0,0,0,11,6,0,17,151,54,222
8106409,0,0,0,3,0,0,3,0,0,3
8106410,0,0,0,16,4,0,20,143,5,168
8106411,3,3,6,21,15,0,36,327,37,400
8106412,6,3,9,54,35,6,95,209,17,321
8106501,3,0,3,19,10,0,29,134,10,173
8106502,3,0,3,77,34,4,115,474,106,695
8106503,0,3,3,21,13,0,34,319,41,394
8106504,7,3,10,69,21,4,94,418,32,544
8106505,0,0,0,36,6,3,45,309,47,401
8106506,7,3,10,23,19,0,42,191,30,263
8106507,19,0,19,37,20,0,57,350,22,429
8106508,4,0,4,28,23,0,51,309,46,406
8106509,3,0,3,39,17,3,59,119,13,191
8106510,0,0,0,16,26,0,42,236,68,346
8106601,0,0,0,0,0,0,0,0,0,0
8106701,12,3,15,74,15,3,92,180,16,288
8106702,9,0,9,39,13,3,55,109,4,168
8106703,5,4,9,55,19,0,74,143,7,224
8106704,3,0,3,48,12,0,60,186,33,279
8106705,5,0,5,41,16,3,60,195,11,266
8106706,4,0,4,50,10,0,60,232,14,306
8106707,0,0,0,20,10,0,30,161,12,203
8106708,9,0,9,85,22,3,110,192,15,317
8106709,3,3,6,56,15,0,71,142,25,238
8106710,4,0,4,67,11,4,82,144,18,244
8106711,118,6,124,49,19,3,71,512,13,596
8106712,7,0,7,77,22,3,102,181,23,306
8106713,12,3,15,58,13,6,77,196,3,276
8106714,9,4,13,49,10,0,59,142,10,211
8106715,10,0,10,73,13,0,86,241,13,340
8106716,14,0,14,41,6,0,47,120,3,170
8106717,4,0,4,42,11,0,53,167,24,244
8106801,0,0,0,0,0,0,0,0,3,3
8106901,6,0,6,72,7,3,82,125,6,213
8106902,0,0,0,32,17,0,49,177,17,243
8106903,0,0,0,61,27,0,88,189,8,285
8106904,0,0,0,59,33,3,95,193,27,315
8106905,15,4,19,93,20,3,116,322,21,459
8106906,54,0,54,101,13,6,120,317,24,461
8106907,55,0,55,48,22,3,73,295,10,378
8106908,0,0,0,0,0,0,0,0,0,0
8106909,10,3,13,65,26,0,91,171,14,276
8107001,3,0,3,50,25,0,75,193,12,280
8107002,11,3,14,67,27,6,100,250,13,363
8107003,7,0,7,69,47,0,116,229,17,362
8107004,13,3,16,33,28,0,61,177,16,254
8107005,8,0,8,73,28,3,104,272,18,394
8107006,9,3,12,29,36,0,65,178,3,246
8107007,8,0,8,67,29,4,100,248,24,372
8107008,0,0,0,58,12,0,70,116,7,193
8107101,0,0,0,0,0,0,0,0,0,0
8107102,0,0,0,120,19,14,153,213,3,369
8107103,3,0,3,142,28,0,170,236,44,450
8107104,0,0,0,50,9,3,62,145,9,216
8107105,0,0,0,84,30,9,123,196,19,338
8107106,3,0,3,69,21,5,95,140,12,247
8107107,0,0,0,69,21,0,90,163,34,287
8107108,3,0,3,111,20,3,134,225,70,429
8107109,0,0,0,85,24,0,109,174,6,289
8107110,6,0,6,141,36,6,183,336,16,535
8107111,0,0,0,44,20,4,68,114,9,191
8107112,3,3,6,125,27,7,159,231,29,419
8107201,0,0,0,100,47,5,152,321,5,478
8107202,3,0,3,47,30,0,77,196,7,280
8107203,3,0,3,77,23,3,103,195,11,309
8107204,3,6,9,90,22,3,115,252,16,383
8107205,0,0,0,100,29,6,135,264,12,411
8107206,0,0,0,76,21,4,101,318,15,434
8107207,0,0,0,71,30,9,110,218,14,342
8107208,7,0,7,114,30,4,148,246,33,427
8107209,0,0,0,0,0,0,0,0,0,0
8107301,3,0,3,85,32,0,117,211,30,358
8107302,3,0,3,95,19,5,119,255,12,386
8107303,6,0,6,98,41,10,149,262,14,425
8107304,0,0,0,60,25,7,92,168,15,275
8107305,8,0,8,73,29,7,109,203,6,318
8107306,0,0,0,106,28,11,145,256,13,414
8107307,4,0,4,76,26,6,108,242,9,359
8107308,0,0,3,51,28,4,83,179,0,262
8107309,0,0,0,108,23,4,135,270,17,422
8107310,3,0,3,65,32,0,97,222,12,331
8107311,0,0,0,123,52,3,178,273,25,476
8107312,3,0,3,58,21,9,88,204,3,295
8107313,0,0,0,57,13,6,76,184,12,272
8107401,3,0,3,80,25,0,105,236,16,357
8107402,0,3,3,98,18,6,122,276,16,414
8107403,0,0,0,55,24,0,79,173,3,255
8107404,0,0,0,68,13,0,81,155,20,256
8107405,3,0,3,84,28,8,120,205,5,330
8107406,6,0,6,74,16,9,99,256,21,376
8107407,0,0,0,104,37,12,153,261,18,432
8107408,0,0,0,39,15,0,54,146,11,211
8107409,0,0,0,80,27,4,111,243,9,363
8107410,0,0,0,72,16,7,95,157,3,255
8107411,0,0,0,97,20,3,120,268,10,398
8107412,0,0,0,40,15,0,55,140,17,212
8107413,0,3,3,59,22,0,81,170,18,269
8107501,6,3,9,101,27,0,128,331,22,481
8107502,0,0,0,87,16,0,103,152,16,271
8107503,3,0,3,74,14,9,97,187,21,305
8107504,3,0,3,65,22,6,93,229,20,342
8107505,4,0,4,86,24,3,113,246,27,386
8107506,0,0,0,105,23,3,131,198,5,334
8107507,0,0,0,86,27,6,119,195,12,326
8107508,0,0,0,69,13,3,85,153,3,241
8107509,0,0,0,49,21,6,76,113,3,192
8107510,0,0,0,135,26,13,174,224,24,422
8107511,0,0,0,74,15,3,92,171,6,269
8107512,0,0,0,60,31,3,94,132,21,247
8107513,3,0,3,61,22,3,86,158,21,265
8107601,0,0,0,45,24,3,72,229,3,304
8107602,0,0,0,67,33,6,106,229,6,341
8107603,13,0,13,68,33,0,101,221,3,325
8107604,0,0,0,59,30,6,95,212,18,325
8107605,6,0,6,60,21,0,81,223,14,318
8107606,3,3,6,83,29,3,115,243,9,367
8107607,0,0,0,0,0,0,0,0,0,0
8107608,3,0,3,63,38,0,101,234,21,356
8107609,0,0,0,23,26,0,49,158,4,211
8107701,0,0,0,101,34,4,139,336,19,494
8107702,0,0,0,71,37,6,114,177,18,309
8107703,0,0,0,51,14,13,78,157,18,253
8107704,3,0,3,59,17,0,76,167,6,249
8107705,0,0,0,81,19,5,105,229,9,343
8107706,0,0,0,66,26,3,95,151,4,250
8107707,0,0,0,62,14,8,84,228,18,330
8107708,0,0,0,0,0,0,0,3,0,3
8107801,3,0,3,84,22,3,109,232,24,365
8107802,0,0,0,39,13,0,52,128,8,188
8107803,0,0,0,87,14,3,104,172,26,302
8107804,0,0,0,63,12,8,83,129,21,233
8107805,0,0,0,75,20,3,98,178,32,308
8107806,0,0,0,88,9,5,102,205,13,320
8107807,7,0,7,34,7,0,41,148,17,206
8107808,3,0,3,76,28,10,114,184,24,322
8107809,0,0,0,56,18,0,74,137,20,231
8107810,6,0,6,87,30,0,117,214,30,361
8107811,6,0,6,96,25,14,135,256,29,420
8107812,0,0,0,54,20,7,81,177,16,274
8107813,0,0,0,77,17,3,97,162,6,265
8107814,0,0,0,88,9,6,103,280,21,404
8107815,0,0,3,62,21,3,86,151,27,264
8107816,0,0,0,47,28,3,78,137,4,219
8107817,0,0,0,42,13,6,61,146,3,210
8107818,0,4,4,81,36,6,123,207,10,340
8107819,3,3,6,47,7,5,59,120,12,191
8107820,7,0,7,86,27,8,121,203,4,328
8107821,0,0,0,90,22,6,118,220,4,342
8107901,0,0,0,42,20,3,65,164,3,232
8107902,0,0,0,56,22,4,82,186,29,297
8107903,3,0,3,85,39,0,124,246,25,395
8107904,6,0,6,68,22,0,90,199,8,297
8107905,3,0,3,45,45,4,94,203,10,307
8107906,3,0,3,53,20,3,76,199,11,286
8107907,0,0,0,50,27,0,77,135,13,225
8107908,3,0,3,54,6,3,63,160,5,228
8107909,0,0,0,50,23,3,76,119,14,209
8108001,0,0,0,0,0,0,0,0,0,0
8108002,7,0,7,59,26,0,85,240,15,340
8108003,6,0,6,61,49,6,116,336,9,461
8108004,0,0,0,50,30,0,80,391,24,495
8108101,0,3,3,74,13,8,95,199,22,316
8108102,0,0,0,67,15,0,82,174,0,256
8108103,0,0,0,84,31,7,122,254,19,395
8108104,0,0,0,68,13,0,81,175,0,256
8108105,0,0,0,76,24,3,103,174,13,290
8108106,0,0,0,67,21,0,88,223,33,344
8108107,0,0,0,59,12,9,80,153,6,239
8108108,3,0,3,99,28,0,127,209,21,357
8108109,3,3,6,86,19,0,105,157,6,268
8108110,4,0,4,91,38,7,136,241,30,407
8108111,0,0,0,63,18,3,84,154,15,253
8108201,0,0,0,69,19,7,95,149,0,244
8108202,3,3,6,41,14,5,60,109,9,178
8108203,6,0,6,54,38,6,98,227,13,338
8108204,3,0,3,56,30,4,90,180,9,279
8108205,6,0,6,47,38,3,88,179,17,284
8108206,0,0,0,56,13,6,75,135,9,219
8108207,3,0,3,81,39,12,132,265,25,422
8108208,0,0,0,35,17,5,57,110,6,173
8108209,0,0,0,45,31,0,76,144,3,223
8108210,3,0,3,81,38,3,122,249,15,386
8108211,0,0,0,57,33,0,90,169,3,262
8108212,3,0,3,78,29,6,113,201,14,328
8108213,6,0,6,78,44,4,126,291,13,430
8108214,0,0,3,34,28,0,62,123,12,197
8108215,0,0,0,79,26,0,105,300,38,443
8108216,3,0,3,74,31,0,105,220,9,334
8108217,0,4,4,68,35,3,106,225,15,346
8108218,0,0,0,51,51,0,102,201,8,311
8108219,0,0,0,105,47,10,162,271,15,448
8108220,3,0,3,56,34,9,99,227,10,336
8108221,3,0,3,73,24,0,97,166,0,263
8108222,3,0,3,70,41,0,111,194,8,313
8108223,3,0,3,48,14,11,73,114,15,202
8108224,0,0,0,67,26,0,93,217,25,335
8108225,0,4,4,43,25,5,73,138,16,227
8108226,10,6,16,53,20,0,73,280,18,371
8108227,0,0,0,58,31,0,89,217,9,315
8108228,0,0,0,23,16,3,42,110,0,152
8108229,3,0,3,73,45,0,118,294,10,422
8108230,0,0,0,57,34,6,97,199,6,302
8108231,0,0,0,55,25,3,83,184,7,274
8108232,3,0,3,62,10,0,72,181,24,277
8108233,0,0,0,32,23,3,58,178,3,239
8108234,0,0,0,42,21,15,78,156,18,252
8108235,6,0,6,101,48,16,165,252,23,440
8108236,3,0,6,107,62,6,175,253,11,439
8108237,0,0,0,75,30,7,112,247,4,363
8108238,0,0,0,67,17,3,87,199,18,304
8108239,3,0,3,66,26,5,97,131,5,233
8108240,3,0,3,36,20,3,59,120,11,190
8108241,3,3,6,74,38,8,120,233,9,362
8108301,0,0,0,94,37,12,143,288,3,434
8108302,4,0,4,75,23,3,101,217,6,324
8108303,4,0,4,80,33,4,117,301,13,431
8108401,4,0,4,39,15,0,54,107,4,165
8108402,3,0,3,37,15,6,58,131,12,201
8108403,0,0,0,53,17,4,74,173,4,251
8108404,3,0,3,69,9,0,78,208,6,292
8108405,4,0,4,51,21,6,78,258,8,344
8108406,0,0,0,35,27,6,68,146,9,223
8108407,0,0,0,47,20,3,70,160,9,239
8108408,10,0,10,63,29,3,95,232,9,336
8108409,3,0,3,42,17,3,62,155,15,232
8108410,3,0,3,46,12,3,61,127,3,191
8108411,3,3,6,53,18,8,79,257,18,354
8108412,9,0,9,47,27,3,77,220,25,322
8108413,0,0,0,30,25,0,55,132,3,190
8108414,3,0,3,32,11,9,52,163,3,218
8108415,0,0,0,65,20,7,92,201,17,310
8108416,13,6,22,3,9,0,12,107,15,134
8108417,66,6,72,49,14,0,63,241,18,322
8108418,6,0,6,32,16,0,48,132,9,189
8108501,0,0,0,0,0,0,0,4,0,4
8108601,0,0,0,55,28,0,83,174,7,264
8108602,0,0,0,43,9,6,58,152,3,213
8108603,0,0,0,68,20,8,96,263,15,374
8108604,0,0,0,42,25,3,70,133,3,206
8108605,0,0,0,64,25,9,98,277,9,384
8108701,0,0,0,87,42,3,132,211,10,353
8108702,0,0,0,77,23,4,104,218,4,326
8108703,0,0,0,99,35,0,134,308,35,477
8108704,3,0,3,41,12,0,53,136,31,220
8108705,0,0,0,93,19,0,112,231,28,371
8108706,0,0,0,101,25,0,126,327,27,480
8108707,0,0,0,34,22,3,59,161,12,232
8108801,0,0,0,112,21,6,139,274,17,430
8108802,0,0,0,54,22,0,76,164,5,245
8108803,0,0,0,77,18,4,99,213,4,316
8108804,0,0,0,77,28,6,111,207,21,339
8108805,0,3,3,70,13,6,89,153,24,266
8108806,3,0,3,41,14,6,61,175,11,247
8108807,0,0,0,96,25,3,124,230,16,370
8108808,0,0,0,54,21,6,81,177,3,261
8108809,4,0,4,111,31,6,148,276,15,439
8108810,3,3,6,32,6,7,45,119,15,179
8108901,0,0,0,7,0,0,7,20,0,27
8109001,3,0,3,38,12,0,50,111,15,176
8109002,0,0,0,32,28,0,60,99,4,163
8109003,3,0,3,85,34,6,125,254,15,394
8109004,5,0,5,73,41,9,123,316,22,461
8109005,3,0,3,58,16,4,78,223,10,311
8109006,3,0,3,55,23,6,84,197,18,299
8109007,4,3,7,44,18,6,68,283,29,380
8109008,3,0,3,87,37,7,131,227,27,385
8109009,0,0,0,58,27,7,92,154,6,252
8109010,0,0,0,65,37,8,110,296,18,424
8109011,0,0,0,76,51,3,130,286,16,432
8109012,3,0,3,53,25,0,78,135,0,213
8109013,7,0,7,57,21,0,78,182,3,263
8109014,7,3,10,79,35,0,114,279,24,417
8109015,3,3,6,58,24,9,91,121,16,228
8109016,0,0,3,70,28,12,110,257,16,383
8109017,0,0,0,28,20,0,48,104,10,162
8109018,0,0,0,51,32,6,89,194,18,301
8109019,3,0,3,90,47,0,137,256,18,411
8109020,0,0,0,59,27,4,90,132,7,229
8109101,3,0,3,37,15,0,52,138,7,197
8109102,3,0,3,42,24,0,66,195,6,267
8109103,9,0,9,59,16,3,78,166,13,257
8109104,6,0,6,34,26,6,66,153,6,225
8109105,3,0,3,46,30,3,79,181,15,275
8109106,0,0,0,65,46,3,114,238,6,358
8109107,0,0,0,69,30,4,103,174,7,284
8109108,4,0,4,90,45,0,135,219,4,358
8109201,14,0,14,99,24,4,127,252,9,388
8109202,4,0,4,83,24,4,111,226,8,345
8109203,0,0,0,79,23,3,105,184,7,296
8109204,0,0,0,52,25,3,80,161,12,253
8109205,0,0,0,64,17,9,90,152,3,245
8109206,3,0,3,76,32,3,111,141,7,259
8109207,6,0,6,80,22,3,105,156,6,267
8109208,6,0,6,80,36,9,125,226,17,368
8109209,0,0,0,27,3,3,33,26,6,65
8109210,0,0,0,0,0,0,0,0,0,0
8109301,41,4,45,58,35,0,93,296,24,413
8109302,0,0,0,50,12,3,65,113,14,192
8109303,8,6,14,65,35,7,107,256,9,372
8109304,0,0,0,118,52,0,170,381,19,570
8109305,4,0,4,94,43,10,147,282,6,435
8109306,4,0,4,106,42,3,151,304,13,468
8109401,5,0,5,72,44,0,116,207,8,331
8109402,0,0,0,0,0,0,0,0,0,0
8109403,0,0,0,54,19,0,73,109,8,190
8109404,15,3,18,74,58,8,140,357,30,527
8109405,4,3,7,106,52,16,174,248,19,441
8109406,4,0,4,80,41,3,124,250,21,395
8109407,7,0,7,72,33,0,105,208,15,328
8109501,3,0,3,46,22,7,75,133,10,218
8109502,3,3,6,68,23,7,98,160,3,261
8109503,0,0,0,32,20,3,55,140,15,210
8109504,3,6,9,47,27,0,74,185,21,280
8109505,0,6,6,72,41,3,116,210,18,344
8109506,3,0,3,58,9,4,71,143,18,232
8109507,3,0,3,50,29,0,79,206,16,301
8109508,0,0,0,93,28,0,121,234,18,373
8109509,3,0,3,71,20,6,97,170,28,295
8109601,6,0,6,45,39,9,93,216,9,318
8109602,3,3,6,52,32,6,90,201,15,306
8109603,7,0,7,94,58,6,158,293,11,462
8109604,29,0,29,68,25,0,93,234,12,339
8109605,0,0,0,59,23,7,89,164,10,263
8109701,18,4,22,60,29,6,95,268,26,389
8109702,3,0,3,87,38,5,130,190,14,334
8109703,8,0,8,56,32,0,88,256,14,358
8109704,3,0,3,48,16,6,70,157,12,239
8109705,5,0,5,42,15,0,57,161,14,232
8109706,0,0,0,40,23,4,67,166,19,252
8109707,11,0,11,77,23,7,107,184,9,300
8109801,54,5,59,50,17,0,67,237,5,309
8109802,0,0,0,57,27,3,87,166,6,259
8109803,0,0,0,0,0,0,0,0,0,0
8109804,0,0,0,31,32,4,67,137,7,211
8109805,3,3,6,139,25,6,170,282,24,476
8109806,8,3,11,22,27,0,49,232,10,291
8109807,56,3,59,33,18,3,54,268,32,354
8109808,6,0,6,94,45,0,139,223,3,365
8109809,3,0,3,91,48,0,139,274,15,428
8109901,5,0,5,133,38,6,177,383,22,582
8109902,3,3,6,91,20,6,117,324,33,474
8109903,4,0,4,82,18,6,106,146,9,261
8109904,5,0,5,53,28,4,85,240,7,332
8109905,10,0,10,56,35,6,97,245,17,359
8110001,6,0,6,88,49,6,143,236,15,394
8110002,6,0,6,79,23,6,108,187,6,301
8110003,63,0,63,57,21,7,85,206,3,294
8110004,9,3,12,88,35,3,126,318,12,456
8110005,7,0,7,107,29,7,143,277,16,436
8110006,7,3,10,72,13,6,91,219,22,332
8110007,6,0,6,41,14,0,55,151,3,209
8110008,8,0,8,85,31,6,122,353,29,504
8110009,0,0,0,51,12,0,63,282,17,362
8110010,11,0,11,91,29,7,127,230,14,371
8110011,3,0,3,46,21,0,67,104,12,183
8110012,7,0,7,80,25,0,105,235,21,361
8110101,0,0,0,42,16,3,61,141,3,205
8110102,3,3,6,66,18,6,90,222,3,315
8110103,5,0,5,98,41,10,149,366,11,526
8110104,0,0,3,66,33,0,99,172,21,292
8110105,8,3,11,52,28,6,86,202,15,303
8110106,63,6,69,42,22,0,64,230,25,319
8110107,9,0,9,95,41,10,146,212,17,375
8110108,13,0,13,67,43,4,114,289,24,427
8110201,0,0,0,0,0,0,0,0,0,0
8110202,25,36,61,85,39,0,124,327,80,531
8110203,11,0,11,69,23,6,98,229,6,333
8110204,3,0,3,56,33,6,95,160,7,262
8110205,6,0,6,45,21,7,73,142,3,218
8110206,3,3,6,32,15,4,51,120,9,180
8110207,9,3,12,82,26,6,114,432,21,567
8110208,6,3,9,69,21,4,94,217,25,336
8110209,4,3,7,50,22,3,75,144,9,228
8110301,4,0,4,55,17,0,72,235,15,322
8110302,11,0,11,68,20,4,92,165,30,287
8110303,3,0,6,56,20,3,79,178,9,266
8110304,15,0,15,82,28,3,113,214,3,330
8110305,7,0,7,29,26,3,58,141,3,202
8110306,119,7,126,69,16,5,90,351,16,457
8110307,5,3,8,84,29,6,119,192,41,352
8110308,6,3,9,39,5,0,44,120,15,179
8110401,6,0,6,74,43,3,120,438,23,581
8110402,11,3,14,62,29,0,91,146,15,252
8110403,5,0,5,53,44,0,97,256,15,368
8110404,5,0,5,62,44,0,106,247,3,356
8110405,20,0,20,46,42,3,91,364,15,470
8110406,0,0,0,0,0,0,0,0,0,0
8110501,0,0,0,0,0,0,0,0,0,0
8110502,8,0,8,99,38,11,148,286,17,451
8110503,4,0,4,38,23,0,61,225,14,300
8110504,11,0,11,19,13,0,32,207,14,253
8110505,8,0,8,68,34,3,105,199,6,310
8110506,9,0,9,88,29,4,121,274,23,418
8110507,7,3,10,63,21,0,84,392,77,553
8110601,0,0,0,67,27,3,97,234,19,350
8110602,0,0,0,66,40,0,106,252,15,373
8110603,0,0,3,76,36,0,112,248,24,384
8110604,8,0,8,29,7,0,36,169,24,229
8110605,0,0,0,48,13,0,61,331,37,429
8110606,18,0,18,42,47,0,89,283,14,386
8110607,14,0,14,81,32,4,117,243,12,372
8110701,10,0,10,46,21,0,67,213,12,292
8110702,5,0,5,107,29,3,139,273,12,424
8110801,0,0,0,0,0,0,0,4,0,4
8110802,4,0,4,52,8,0,60,127,6,193
8110803,10,3,13,87,41,0,128,309,25,462
8110804,9,3,12,56,38,3,97,276,22,395
8110805,6,0,9,84,29,0,113,217,15,345
8110806,4,0,4,77,18,4,99,177,9,285
8110807,14,3,17,68,39,4,111,291,16,418
8110901,6,0,6,24,6,0,30,163,13,206
8110902,7,0,7,55,41,0,96,444,15,555
8110903,0,0,0,0,0,0,0,0,0,0
8110904,0,0,0,0,0,0,0,0,0,0
8110905,4,0,4,17,4,0,21,141,8,170
8110906,0,0,0,58,5,4,67,262,18,347
8110907,3,3,6,39,3,0,42,210,22,274
8110908,0,0,0,34,11,0,45,248,25,318
8110909,0,0,0,3,0,0,3,3,0,6
8111001,6,3,9,85,35,3,123,236,24,383
8111002,6,0,6,91,22,3,116,247,21,384
8111003,0,0,0,50,17,0,67,143,9,219
8111004,8,0,8,73,30,3,106,205,15,326
8111005,7,0,7,57,23,0,80,156,11,247
8111006,6,3,9,57,11,6,74,152,15,241
8949999,3,3,6,61,37,3,101,404,68,573
8979991,0,0,0,0,0,0,0,0,0,0
9100101,0,0,0,0,0,0,0,0,707,707
9100102,0,0,0,0,0,0,0,15,0,15
9100103,0,0,0,54,3,0,57,158,47,262
9100104,0,0,0,81,9,0,90,353,48,491
9100105,0,0,0,81,7,0,88,209,36,333
9100201,4,0,4,50,15,7,72,227,27,326
9100202,0,0,0,21,0,6,27,68,3,98
9100203,0,0,0,0,0,0,0,0,0,0
9100301,0,0,0,21,15,0,36,85,15,136
9100302,0,0,0,20,21,0,41,88,3,132
9100303,0,0,0,0,0,0,0,3,0,3
9100304,0,0,0,0,0,0,0,0,0,0
9949999,0,0,0,0,3,0,3,21,0,24
9979993,0,0,0,0,0,0,0,3,0,3
